Date,HomeTeam,AwayTeam,FTHG,FTAG,FTR,HomeOVA,AwayOVA,OVA_diff
2019-08-09,Liverpool,Norwich,4,1,H,85,74,11
2019-08-10,West Ham,Man City,0,5,A,78,85,-7
2019-08-10,Bournemouth,Sheffield United,1,1,D,76,75,1
2019-08-10,Burnley,Southampton,3,0,H,76,76,0
2019-08-10,Crystal Palace,Everton,0,0,D,77,78,-1
2019-08-10,Watford,Brighton,0,3,A,77,76,1
2019-08-10,Tottenham,Aston Villa,3,1,H,82,76,6
2019-08-11,Leicester,Wolves,0,0,D,79,78,1
2019-08-11,Newcastle,Arsenal,0,1,A,77,80,-3
2019-08-11,Man United,Chelsea,4,0,H,81,81,0
2019-08-17,Arsenal,Burnley,2,1,H,80,76,4
2019-08-17,Aston Villa,Bournemouth,1,2,A,76,76,0
2019-08-17,Brighton,West Ham,1,1,D,76,78,-2
2019-08-17,Everton,Watford,1,0,H,78,77,1
2019-08-17,Norwich,Newcastle,3,1,H,74,77,-3
2019-08-17,Southampton,Liverpool,1,2,A,76,85,-9
2019-08-17,Man City,Tottenham,2,2,D,85,82,3
2019-08-18,Sheffield United,Crystal Palace,1,0,H,75,77,-2
2019-08-18,Chelsea,Leicester,1,1,D,81,79,2
2019-08-19,Wolves,Man United,1,1,D,78,81,-3
2019-08-23,Aston Villa,Everton,2,0,H,76,78,-2
2019-08-24,Norwich,Chelsea,2,3,A,74,81,-7
2019-08-24,Brighton,Southampton,0,2,A,76,76,0
2019-08-24,Man United,Crystal Palace,1,2,A,81,77,4
2019-08-24,Sheffield United,Leicester,1,2,A,75,79,-4
2019-08-24,Watford,West Ham,1,3,A,77,78,-1
2019-08-24,Liverpool,Arsenal,3,1,H,85,80,5
2019-08-25,Bournemouth,Man City,1,3,A,76,85,-9
2019-08-25,Tottenham,Newcastle,0,1,A,82,77,5
2019-08-25,Wolves,Burnley,1,1,D,78,76,2
2019-08-31,Southampton,Man United,1,1,D,76,81,-5
2019-08-31,Chelsea,Sheffield United,2,2,D,81,75,6
2019-08-31,Crystal Palace,Aston Villa,1,0,H,77,76,1
2019-08-31,Leicester,Bournemouth,3,1,H,79,76,3
2019-08-31,Man City,Brighton,4,0,H,85,76,9
2019-08-31,Newcastle,Watford,1,1,D,77,77,0
2019-08-31,West Ham,Norwich,2,0,H,78,74,4
2019-08-31,Burnley,Liverpool,0,3,A,76,85,-9
2019-09-01,Everton,Wolves,3,2,H,78,78,0
2019-09-01,Arsenal,Tottenham,2,2,D,80,82,-2
2019-09-14,Liverpool,Newcastle,3,1,H,85,77,8
2019-09-14,Brighton,Burnley,1,1,D,76,76,0
2019-09-14,Man United,Leicester,1,0,H,81,79,2
2019-09-14,Sheffield United,Southampton,0,1,A,75,76,-1
2019-09-14,Tottenham,Crystal Palace,4,0,H,82,77,5
2019-09-14,Wolves,Chelsea,2,5,A,78,81,-3
2019-09-14,Norwich,Man City,3,2,H,74,85,-11
2019-09-15,Bournemouth,Everton,3,1,H,76,78,-2
2019-09-15,Watford,Arsenal,2,2,D,77,80,-3
2019-09-16,Aston Villa,West Ham,0,0,D,76,78,-2
2019-09-20,Southampton,Bournemouth,1,3,A,76,76,0
2019-09-21,Leicester,Tottenham,2,1,H,79,82,-3
2019-09-21,Burnley,Norwich,2,0,H,76,74,2
2019-09-21,Everton,Sheffield United,0,2,A,78,75,3
2019-09-21,Man City,Watford,8,0,H,85,77,8
2019-09-21,Newcastle,Brighton,0,0,D,77,76,1
2019-09-22,Crystal Palace,Wolves,1,1,D,77,78,-1
2019-09-22,West Ham,Man United,2,0,H,78,81,-3
2019-09-22,Arsenal,Aston Villa,3,2,H,80,76,4
2019-09-22,Chelsea,Liverpool,1,2,A,81,85,-4
2019-09-28,Sheffield United,Liverpool,0,1,A,75,85,-10
2019-09-28,Aston Villa,Burnley,2,2,D,76,76,0
2019-09-28,Bournemouth,West Ham,2,2,D,76,78,-2
2019-09-28,Chelsea,Brighton,2,0,H,81,76,5
2019-09-28,Crystal Palace,Norwich,2,0,H,77,74,3
2019-09-28,Tottenham,Southampton,2,1,H,82,76,6
2019-09-28,Wolves,Watford,2,0,H,78,77,1
2019-09-28,Everton,Man City,1,3,A,78,85,-7
2019-09-29,Leicester,Newcastle,5,0,H,79,77,2
2019-09-30,Man United,Arsenal,1,1,D,81,80,1
2019-10-05,Brighton,Tottenham,3,0,H,76,82,-6
2019-10-05,Burnley,Everton,1,0,H,76,78,-2
2019-10-05,Liverpool,Leicester,2,1,H,85,79,6
2019-10-05,Norwich,Aston Villa,1,5,A,74,76,-2
2019-10-05,Watford,Sheffield United,0,0,D,77,75,2
2019-10-05,West Ham,Crystal Palace,1,2,A,78,77,1
2019-10-06,Arsenal,Bournemouth,1,0,H,80,76,4
2019-10-06,Man City,Wolves,0,2,A,85,78,7
2019-10-06,Southampton,Chelsea,1,4,A,76,81,-5
2019-10-06,Newcastle,Man United,1,0,H,77,81,-4
2019-10-19,Everton,West Ham,2,0,H,78,78,0
2019-10-19,Aston Villa,Brighton,2,1,H,76,76,0
2019-10-19,Bournemouth,Norwich,0,0,D,76,74,2
2019-10-19,Chelsea,Newcastle,1,0,H,81,77,4
2019-10-19,Leicester,Burnley,2,1,H,79,76,3
2019-10-19,Tottenham,Watford,1,1,D,82,77,5
2019-10-19,Wolves,Southampton,1,1,D,78,76,2
2019-10-19,Crystal Palace,Man City,0,2,A,77,85,-8
2019-10-20,Man United,Liverpool,1,1,D,81,85,-4
2019-10-21,Sheffield United,Arsenal,1,0,H,75,80,-5
2019-10-25,Southampton,Leicester,0,9,A,76,79,-3
2019-10-26,Man City,Aston Villa,3,0,H,85,76,9
2019-10-26,Brighton,Everton,3,2,H,76,78,-2
2019-10-26,Watford,Bournemouth,0,0,D,77,76,1
2019-10-26,West Ham,Sheffield United,1,1,D,78,75,3
2019-10-26,Burnley,Chelsea,2,4,A,76,81,-5
2019-10-27,Newcastle,Wolves,1,1,D,77,78,-1
2019-10-27,Arsenal,Crystal Palace,2,2,D,80,77,3
2019-10-27,Liverpool,Tottenham,2,1,H,85,82,3
2019-10-27,Norwich,Man United,1,3,A,74,81,-7
2019-11-02,Bournemouth,Man United,1,0,H,76,81,-5
2019-11-02,Arsenal,Wolves,1,1,D,80,78,2
2019-11-02,Aston Villa,Liverpool,1,2,A,76,85,-9
2019-11-02,Brighton,Norwich,2,0,H,76,74,2
2019-11-02,Man City,Southampton,2,1,H,85,76,9
2019-11-02,Sheffield United,Burnley,3,0,H,75,76,-1
2019-11-02,West Ham,Newcastle,2,3,A,78,77,1
2019-11-02,Watford,Chelsea,1,2,A,77,81,-4
2019-11-03,Crystal Palace,Leicester,0,2,A,77,79,-2
2019-11-03,Everton,Tottenham,1,1,D,78,82,-4
2019-11-08,Norwich,Watford,0,2,A,74,77,-3
2019-11-09,Chelsea,Crystal Palace,2,0,H,81,77,4
2019-11-09,Burnley,West Ham,3,0,H,76,78,-2
2019-11-09,Newcastle,Bournemouth,2,1,H,77,76,1
2019-11-09,Southampton,Everton,1,2,A,76,78,-2
2019-11-09,Tottenham,Sheffield United,1,1,D,82,75,7
2019-11-09,Leicester,Arsenal,2,0,H,79,80,-1
2019-11-10,Man United,Brighton,3,1,H,81,76,5
2019-11-10,Wolves,Aston Villa,2,1,H,78,76,2
2019-11-10,Liverpool,Man City,3,1,H,85,85,0
2019-11-23,West Ham,Tottenham,2,3,A,78,82,-4
2019-11-23,Arsenal,Southampton,2,2,D,80,76,4
2019-11-23,Bournemouth,Wolves,1,2,A,76,78,-2
2019-11-23,Brighton,Leicester,0,2,A,76,79,-3
2019-11-23,Crystal Palace,Liverpool,1,2,A,77,85,-8
2019-11-23,Everton,Norwich,0,2,A,78,74,4
2019-11-23,Watford,Burnley,0,3,A,77,76,1
2019-11-23,Man City,Chelsea,2,1,H,85,81,4
2019-11-24,Sheffield United,Man United,3,3,D,75,81,-6
2019-11-25,Aston Villa,Newcastle,2,0,H,76,77,-1
2019-11-30,Newcastle,Man City,2,2,D,77,85,-8
2019-11-30,Burnley,Crystal Palace,0,2,A,76,77,-1
2019-11-30,Chelsea,West Ham,0,1,A,81,78,3
2019-11-30,Liverpool,Brighton,2,1,H,85,76,9
2019-11-30,Tottenham,Bournemouth,3,2,H,82,76,6
2019-11-30,Southampton,Watford,2,1,H,76,77,-1
2019-12-01,Norwich,Arsenal,2,2,D,74,80,-6
2019-12-01,Wolves,Sheffield United,1,1,D,78,75,3
2019-12-01,Leicester,Everton,2,1,H,79,78,1
2019-12-01,Man United,Aston Villa,2,2,D,81,76,5
2019-12-03,Crystal Palace,Bournemouth,1,0,H,77,76,1
2019-12-03,Burnley,Man City,1,4,A,76,85,-9
2019-12-04,Chelsea,Aston Villa,2,1,H,81,76,5
2019-12-04,Leicester,Watford,2,0,H,79,77,2
2019-12-04,Man United,Tottenham,2,1,H,81,82,-1
2019-12-04,Southampton,Norwich,2,1,H,76,74,2
2019-12-04,Wolves,West Ham,2,0,H,78,78,0
2019-12-04,Liverpool,Everton,5,2,H,85,78,7
2019-12-05,Sheffield United,Newcastle,0,2,A,75,77,-2
2019-12-05,Arsenal,Brighton,1,2,A,80,76,4
2019-12-07,Everton,Chelsea,3,1,H,78,81,-3
2019-12-07,Bournemouth,Liverpool,0,3,A,76,85,-9
2019-12-07,Tottenham,Burnley,5,0,H,82,76,6
2019-12-07,Watford,Crystal Palace,0,0,D,77,77,0
2019-12-07,Man City,Man United,1,2,A,85,81,4
2019-12-08,Aston Villa,Leicester,1,4,A,76,79,-3
2019-12-08,Newcastle,Southampton,2,1,H,77,76,1
2019-12-08,Norwich,Sheffield United,1,2,A,74,75,-1
2019-12-08,Brighton,Wolves,2,2,D,76,78,-2
2019-12-09,West Ham,Arsenal,1,3,A,78,80,-2
2019-12-14,Liverpool,Watford,2,0,H,85,77,8
2019-12-14,Burnley,Newcastle,1,0,H,76,77,-1
2019-12-14,Chelsea,Bournemouth,0,1,A,81,76,5
2019-12-14,Leicester,Norwich,1,1,D,79,74,5
2019-12-14,Sheffield United,Aston Villa,2,0,H,75,76,-1
2019-12-14,Southampton,West Ham,0,1,A,76,78,-2
2019-12-15,Man United,Everton,1,1,D,81,78,3
2019-12-15,Wolves,Tottenham,1,2,A,78,82,-4
2019-12-15,Arsenal,Man City,0,3,A,80,85,-5
2019-12-16,Crystal Palace,Brighton,1,1,D,77,76,1
2019-12-21,Everton,Arsenal,0,0,D,78,80,-2
2019-12-21,Aston Villa,Southampton,1,3,A,76,76,0
2019-12-21,Bournemouth,Burnley,0,1,A,76,76,0
2019-12-21,Brighton,Sheffield United,0,1,A,76,75,1
2019-12-21,Newcastle,Crystal Palace,1,0,H,77,77,0
2019-12-21,Norwich,Wolves,1,2,A,74,78,-4
2019-12-21,Man City,Leicester,3,1,H,85,79,6
2019-12-22,Watford,Man United,2,0,H,77,81,-4
2019-12-22,Tottenham,Chelsea,0,2,A,82,81,1
2019-12-26,Tottenham,Brighton,2,1,H,82,76,6
2019-12-26,Aston Villa,Norwich,1,0,H,76,74,2
2019-12-26,Bournemouth,Arsenal,1,1,D,76,80,-4
2019-12-26,Chelsea,Southampton,0,2,A,81,76,5
2019-12-26,Crystal Palace,West Ham,2,1,H,77,78,-1
2019-12-26,Everton,Burnley,1,0,H,78,76,2
2019-12-26,Sheffield United,Watford,1,1,D,75,77,-2
2019-12-26,Man United,Newcastle,4,1,H,81,77,4
2019-12-26,Leicester,Liverpool,0,4,A,79,85,-6
2019-12-27,Wolves,Man City,3,2,H,78,85,-7
2019-12-28,Brighton,Bournemouth,2,0,H,76,76,0
2019-12-28,Newcastle,Everton,1,2,A,77,78,-1
2019-12-28,Southampton,Crystal Palace,1,1,D,76,77,-1
2019-12-28,Watford,Aston Villa,3,0,H,77,76,1
2019-12-28,Norwich,Tottenham,2,2,D,74,82,-8
2019-12-28,West Ham,Leicester,1,2,A,78,79,-1
2019-12-28,Burnley,Man United,0,2,A,76,81,-5
2019-12-29,Arsenal,Chelsea,1,2,A,80,81,-1
2019-12-29,Liverpool,Wolves,1,0,H,85,78,7
2019-12-29,Man City,Sheffield United,2,0,H,85,75,10
2020-01-01,Brighton,Chelsea,1,1,D,76,81,-5
2020-01-01,Burnley,Aston Villa,1,2,A,76,76,0
2020-01-01,Newcastle,Leicester,0,3,A,77,79,-2
2020-01-01,Southampton,Tottenham,1,0,H,76,82,-6
2020-01-01,Watford,Wolves,2,1,H,77,78,-1
2020-01-01,Man City,Everton,2,1,H,85,78,7
2020-01-01,Norwich,Crystal Palace,1,1,D,74,77,-3
2020-01-01,West Ham,Bournemouth,4,0,H,78,76,2
2020-01-01,Arsenal,Man United,2,0,H,80,81,-1
2020-01-02,Liverpool,Sheffield United,2,0,H,85,75,10
2020-01-10,Sheffield United,West Ham,1,0,H,75,78,-3
2020-01-11,Crystal Palace,Arsenal,1,1,D,77,80,-3
2020-01-11,Chelsea,Burnley,3,0,H,81,76,5
2020-01-11,Everton,Brighton,1,0,H,78,76,2
2020-01-11,Leicester,Southampton,1,2,A,79,76,3
2020-01-11,Man United,Norwich,4,0,H,81,74,7
2020-01-11,Wolves,Newcastle,1,1,D,78,77,1
2020-01-11,Tottenham,Liverpool,0,1,A,82,85,-3
2020-01-12,Bournemouth,Watford,0,3,A,76,77,-1
2020-01-12,Aston Villa,Man City,1,6,A,76,85,-9
2020-01-18,Watford,Tottenham,0,0,D,77,82,-5
2020-01-18,Arsenal,Sheffield United,1,1,D,80,75,5
2020-01-18,Brighton,Aston Villa,1,1,D,76,76,0
2020-01-18,Man City,Crystal Palace,2,2,D,85,77,8
2020-01-18,Norwich,Bournemouth,1,0,H,74,76,-2
2020-01-18,Southampton,Wolves,2,3,A,76,78,-2
2020-01-18,West Ham,Everton,1,1,D,78,78,0
2020-01-18,Newcastle,Chelsea,1,0,H,77,81,-4
2020-01-19,Burnley,Leicester,2,1,H,76,79,-3
2020-01-19,Liverpool,Man United,2,0,H,85,81,4
2020-01-21,Aston Villa,Watford,2,1,H,76,77,-1
2020-01-21,Bournemouth,Brighton,3,1,H,76,76,0
2020-01-21,Crystal Palace,Southampton,0,2,A,77,76,1
2020-01-21,Everton,Newcastle,2,2,D,78,77,1
2020-01-21,Sheffield United,Man City,0,1,A,75,85,-10
2020-01-21,Chelsea,Arsenal,2,2,D,81,80,1
2020-01-22,Leicester,West Ham,4,1,H,79,78,1
2020-01-22,Tottenham,Norwich,2,1,H,82,74,8
2020-01-22,Man United,Burnley,0,2,A,81,76,5
2020-01-23,Wolves,Liverpool,1,2,A,78,85,-7
2020-01-29,West Ham,Liverpool,0,2,A,78,85,-7
2020-02-01,Leicester,Chelsea,2,2,D,79,81,-2
2020-02-01,Bournemouth,Aston Villa,2,1,H,76,76,0
2020-02-01,Crystal Palace,Sheffield United,0,1,A,77,75,2
2020-02-01,Liverpool,Southampton,4,0,H,85,76,9
2020-02-01,Newcastle,Norwich,0,0,D,77,74,3
2020-02-01,Watford,Everton,2,3,A,77,78,-1
2020-02-01,West Ham,Brighton,3,3,D,78,76,2
2020-02-01,Man United,Wolves,0,0,D,81,78,3
2020-02-02,Burnley,Arsenal,0,0,D,76,80,-4
2020-02-02,Tottenham,Man City,2,0,H,82,85,-3
2020-02-08,Everton,Crystal Palace,3,1,H,78,77,1
2020-02-08,Brighton,Watford,1,1,D,76,77,-1
2020-02-09,Sheffield United,Bournemouth,2,1,H,75,76,-1
2020-02-14,Wolves,Leicester,0,0,D,78,79,-1
2020-02-15,Southampton,Burnley,1,2,A,76,76,0
2020-02-15,Norwich,Liverpool,0,1,A,74,85,-11
2020-02-16,Aston Villa,Tottenham,2,3,A,76,82,-6
2020-02-16,Arsenal,Newcastle,4,0,H,80,77,3
2020-02-17,Chelsea,Man United,0,2,A,81,81,0
2020-02-19,Man City,West Ham,2,0,H,85,78,7
2020-02-22,Chelsea,Tottenham,2,1,H,81,82,-1
2020-02-22,Burnley,Bournemouth,3,0,H,76,76,0
2020-02-22,Crystal Palace,Newcastle,1,0,H,77,77,0
2020-02-22,Sheffield United,Brighton,1,1,D,75,76,-1
2020-02-22,Southampton,Aston Villa,2,0,H,76,76,0
2020-02-22,Leicester,Man City,0,1,A,79,85,-6
2020-02-23,Man United,Watford,3,0,H,81,77,4
2020-02-23,Wolves,Norwich,3,0,H,78,74,4
2020-02-23,Arsenal,Everton,3,2,H,80,78,2
2020-02-24,Liverpool,West Ham,3,2,H,85,78,7
2020-02-28,Norwich,Leicester,1,0,H,74,79,-5
2020-02-29,Brighton,Crystal Palace,0,1,A,76,77,-1
2020-02-29,Bournemouth,Chelsea,2,2,D,76,81,-5
2020-02-29,Newcastle,Burnley,0,0,D,77,76,1
2020-02-29,West Ham,Southampton,3,1,H,78,76,2
2020-02-29,Watford,Liverpool,3,0,H,77,85,-8
2020-03-01,Everton,Man United,1,1,D,78,81,-3
2020-03-01,Tottenham,Wolves,2,3,A,82,78,4
2020-03-07,Liverpool,Bournemouth,2,1,H,85,76,9
2020-03-07,Arsenal,West Ham,1,0,H,80,78,2
2020-03-07,Crystal Palace,Watford,1,0,H,77,77,0
2020-03-07,Sheffield United,Norwich,1,0,H,75,74,1
2020-03-07,Southampton,Newcastle,0,1,A,76,77,-1
2020-03-07,Wolves,Brighton,0,0,D,78,76,2
2020-03-07,Burnley,Tottenham,1,1,D,76,82,-6
2020-03-08,Chelsea,Everton,4,0,H,81,78,3
2020-03-08,Man United,Man City,2,0,H,81,85,-4
2020-03-09,Leicester,Aston Villa,4,0,H,79,76,3
2020-06-17,Aston Villa,Sheffield United,0,0,D,76,75,1
2020-06-17,Man City,Arsenal,3,0,H,85,80,5
2020-06-19,Norwich,Southampton,0,3,A,74,76,-2
2020-06-19,Tottenham,Man United,1,1,D,82,81,1
2020-06-20,Watford,Leicester,1,1,D,77,79,-2
2020-06-20,Brighton,Arsenal,2,1,H,76,80,-4
2020-06-20,West Ham,Wolves,0,2,A,78,78,0
2020-06-20,Bournemouth,Crystal Palace,0,2,A,76,77,-1
2020-06-21,Newcastle,Sheffield United,3,0,H,77,75,2
2020-06-21,Aston Villa,Chelsea,1,2,A,76,81,-5
2020-06-21,Everton,Liverpool,0,0,D,78,85,-7
2020-06-22,Man City,Burnley,5,0,H,85,76,9
2020-06-23,Leicester,Brighton,0,0,D,79,76,3
2020-06-23,Tottenham,West Ham,2,0,H,82,78,4
2020-06-24,Man United,Sheffield United,3,0,H,81,75,6
2020-06-24,Newcastle,Aston Villa,1,1,D,77,76,1
2020-06-24,Norwich,Everton,0,1,A,74,78,-4
2020-06-24,Wolves,Bournemouth,1,0,H,78,76,2
2020-06-24,Liverpool,Crystal Palace,4,0,H,85,77,8
2020-06-25,Burnley,Watford,1,0,H,76,77,-1
2020-06-25,Southampton,Arsenal,0,2,A,76,80,-4
2020-06-25,Chelsea,Man City,2,1,H,81,85,-4
2020-06-27,Aston Villa,Wolves,0,1,A,76,78,-2
2020-06-28,Watford,Southampton,1,3,A,77,76,1
2020-06-29,Crystal Palace,Burnley,0,1,A,77,76,1
2020-06-30,Brighton,Man United,0,3,A,76,81,-5
2020-07-01,Arsenal,Norwich,4,0,H,80,74,6
2020-07-01,Bournemouth,Newcastle,1,4,A,76,77,-1
2020-07-01,Everton,Leicester,2,1,H,78,79,-1
2020-07-01,West Ham,Chelsea,3,2,H,78,81,-3
2020-07-02,Sheffield United,Tottenham,3,1,H,75,82,-7
2020-07-02,Man City,Liverpool,4,0,H,85,85,0
2020-07-04,Norwich,Brighton,0,1,A,74,76,-2
2020-07-04,Leicester,Crystal Palace,3,0,H,79,77,2
2020-07-04,Man United,Bournemouth,5,2,H,81,76,5
2020-07-04,Wolves,Arsenal,0,2,A,78,80,-2
2020-07-04,Chelsea,Watford,3,0,H,81,77,4
2020-07-05,Burnley,Sheffield United,1,1,D,76,75,1
2020-07-05,Newcastle,West Ham,2,2,D,77,78,-1
2020-07-05,Liverpool,Aston Villa,2,0,H,85,76,9
2020-07-05,Southampton,Man City,1,0,H,76,85,-9
2020-07-06,Tottenham,Everton,1,0,H,82,78,4
2020-07-07,Crystal Palace,Chelsea,2,3,A,77,81,-4
2020-07-07,Watford,Norwich,2,1,H,77,74,3
2020-07-07,Arsenal,Leicester,1,1,D,80,79,1
2020-07-08,Man City,Newcastle,5,0,H,85,77,8
2020-07-08,Sheffield United,Wolves,1,0,H,75,78,-3
2020-07-08,West Ham,Burnley,0,1,A,78,76,2
2020-07-08,Brighton,Liverpool,1,3,A,76,85,-9
2020-07-09,Bournemouth,Tottenham,0,0,D,76,82,-6
2020-07-09,Everton,Southampton,1,1,D,78,76,2
2020-07-09,Aston Villa,Man United,0,3,A,76,81,-5
2020-07-11,Norwich,West Ham,0,4,A,74,78,-4
2020-07-11,Watford,Newcastle,2,1,H,77,77,0
2020-07-11,Liverpool,Burnley,1,1,D,85,76,9
2020-07-11,Sheffield United,Chelsea,3,0,H,75,81,-6
2020-07-11,Brighton,Man City,0,5,A,76,85,-9
2020-07-12,Wolves,Everton,3,0,H,78,78,0
2020-07-12,Aston Villa,Crystal Palace,2,0,H,76,77,-1
2020-07-12,Tottenham,Arsenal,2,1,H,82,80,2
2020-07-12,Bournemouth,Leicester,4,1,H,76,79,-3
2020-07-13,Man United,Southampton,2,2,D,81,76,5
2020-07-14,Chelsea,Norwich,1,0,H,81,74,7
2020-07-15,Burnley,Wolves,1,1,D,76,78,-2
2020-07-15,Man City,Bournemouth,2,1,H,85,76,9
2020-07-15,Newcastle,Tottenham,1,3,A,77,82,-5
2020-07-15,Arsenal,Liverpool,2,1,H,80,85,-5
2020-07-16,Everton,Aston Villa,1,1,D,78,76,2
2020-07-16,Leicester,Sheffield United,2,0,H,79,75,4
2020-07-16,Crystal Palace,Man United,0,2,A,77,81,-4
2020-07-16,Southampton,Brighton,1,1,D,76,76,0
2020-07-17,West Ham,Watford,3,1,H,78,77,1
2020-07-18,Norwich,Burnley,0,2,A,74,76,-2
2020-07-19,Bournemouth,Southampton,0,2,A,76,76,0
2020-07-19,Tottenham,Leicester,3,0,H,82,79,3
2020-07-20,Brighton,Newcastle,0,0,D,76,77,-1
2020-07-20,Sheffield United,Everton,0,1,A,75,78,-3
2020-07-20,Wolves,Crystal Palace,2,0,H,78,77,1
2020-07-21,Watford,Man City,0,4,A,77,85,-8
2020-07-21,Aston Villa,Arsenal,1,0,H,76,80,-4
2020-07-22,Man United,West Ham,1,1,D,81,78,3
2020-07-22,Liverpool,Chelsea,5,3,H,85,81,4
2020-07-26,Arsenal,Watford,3,2,H,80,77,3
2020-07-26,Burnley,Brighton,1,2,A,76,76,0
2020-07-26,Chelsea,Wolves,2,0,H,81,78,3
2020-07-26,Crystal Palace,Tottenham,1,1,D,77,82,-5
2020-07-26,Everton,Bournemouth,1,3,A,78,76,2
2020-07-26,Leicester,Man United,0,2,A,79,81,-2
2020-07-26,Man City,Norwich,5,0,H,85,74,11
2020-07-26,Newcastle,Liverpool,1,3,A,77,85,-8
2020-07-26,Southampton,Sheffield United,3,1,H,76,75,1
2020-07-26,West Ham,Aston Villa,1,1,D,78,76,2
