Date,HomeTeam,AwayTeam,FTHG,FTAG,FTR,HT_match_played,HT_current_standing,HT_past_standing,HT_past_goal_diff,HT_past_win_rate,HT_goal_for,HT_goal_against,HT_goal_diff,HT_win_rate_season,AT_match_played,AT_current_standing,AT_past_standing,AT_past_goal_diff,AT_past_win_rate,AT_goal_for,AT_goal_against,AT_goal_diff,AT_win_rate_season,HT_3_win_streak,HT_5_win_streak,HT_3_lose_Streak,HT_5_lose_Streak,AT_3_win_streak,AT_5_win_streak,AT_3_lose_Streak,AT_5_lose_Streak,HT_5_win_rate,AT_5_win_rate,current_standing_diff,past_standing_diff,past_goal_diff_diff,past_win_rate_diff,win_rate_season_diff,goal_diff_diff
1993-08-14,Arsenal,Coventry,0,3,A,0,0,-1,-1,0,0,0,0,,0,0,-1,-1,0,0,0,0,,0,0,0,0,0,0,0,0,,,0,0,0,0,,0
1993-08-14,Aston Villa,QPR,4,1,H,0,0,-1,-1,0,0,0,0,,0,0,-1,-1,0,0,0,0,,0,0,0,0,0,0,0,0,,,0,0,0,0,,0
1993-08-14,Chelsea,Blackburn,1,2,A,0,0,-1,-1,0,0,0,0,,0,0,-1,-1,0,0,0,0,,0,0,0,0,0,0,0,0,,,0,0,0,0,,0
1993-08-14,Liverpool,Sheffield Weds,2,0,H,0,0,-1,-1,0,0,0,0,,0,0,-1,-1,0,0,0,0,,0,0,0,0,0,0,0,0,,,0,0,0,0,,0
1993-08-14,Man City,Leeds,1,1,D,0,0,-1,-1,0,0,0,0,,0,0,-1,-1,0,0,0,0,,0,0,0,0,0,0,0,0,,,0,0,0,0,,0
1993-08-14,Newcastle,Tottenham,0,1,A,0,0,-1,-1,0,0,0,0,,0,0,-1,-1,0,0,0,0,,0,0,0,0,0,0,0,0,,,0,0,0,0,,0
1993-08-14,Oldham,Ipswich,0,3,A,0,0,-1,-1,0,0,0,0,,0,0,-1,-1,0,0,0,0,,0,0,0,0,0,0,0,0,,,0,0,0,0,,0
1993-08-14,Sheffield United,Swindon,3,1,H,0,0,-1,-1,0,0,0,0,,0,0,-1,-1,0,0,0,0,,0,0,0,0,0,0,0,0,,,0,0,0,0,,0
1993-08-14,Southampton,Everton,0,2,A,0,0,-1,-1,0,0,0,0,,0,0,-1,-1,0,0,0,0,,0,0,0,0,0,0,0,0,,,0,0,0,0,,0
1993-08-14,West Ham,Wimbledon,0,2,A,0,0,-1,-1,0,0,0,0,,0,0,-1,-1,0,0,0,0,,0,0,0,0,0,0,0,0,,,0,0,0,0,,0
1993-08-15,Norwich,Man United,0,2,A,0,0,-1,-1,0,0,0,0,,0,0,-1,-1,0,0,0,0,,0,0,0,0,0,0,0,0,,,0,0,0,0,,0
1993-08-16,Tottenham,Arsenal,0,1,A,1,3,-1,-1,0,1,0,1,1.0,1,0,-1,-1,0,0,3,-3,0.0,0,0,0,0,0,0,0,0,,,3,0,0,0,1.0,4
1993-08-17,Everton,Man City,1,0,H,1,3,-1,-1,0,2,0,2,1.0,1,1,-1,-1,0,1,1,0,0.0,0,0,0,0,0,0,0,0,,,2,0,0,0,1.0,2
1993-08-17,Ipswich,Southampton,1,0,H,1,3,-1,-1,0,3,0,3,1.0,1,0,-1,-1,0,0,2,-2,0.0,0,0,0,0,0,0,0,0,,,3,0,0,0,1.0,5
1993-08-17,Leeds,West Ham,1,0,H,1,1,-1,-1,0,1,1,0,0.0,1,0,-1,-1,0,0,2,-2,0.0,0,0,0,0,0,0,0,0,,,1,0,0,0,0.0,2
1993-08-17,Wimbledon,Chelsea,1,1,D,1,3,-1,-1,0,2,0,2,1.0,1,0,-1,-1,0,1,2,-1,0.0,0,0,0,0,0,0,0,0,,,3,0,0,0,1.0,3
1993-08-18,Blackburn,Norwich,2,3,A,1,3,-1,-1,0,2,1,1,1.0,1,0,-1,-1,0,0,2,-2,0.0,0,0,0,0,0,0,0,0,,,3,0,0,0,1.0,3
1993-08-18,Coventry,Newcastle,2,1,H,1,3,-1,-1,0,3,0,3,1.0,1,0,-1,-1,0,0,1,-1,0.0,0,0,0,0,0,0,0,0,,,3,0,0,0,1.0,4
1993-08-18,Man United,Sheffield United,3,0,H,1,3,-1,-1,0,2,0,2,1.0,1,3,-1,-1,0,3,1,2,1.0,0,0,0,0,0,0,0,0,,,0,0,0,0,0.0,0
1993-08-18,QPR,Liverpool,1,3,A,1,0,-1,-1,0,1,4,-3,0.0,1,3,-1,-1,0,2,0,2,1.0,0,0,0,0,0,0,0,0,,,-3,0,0,0,-1.0,-5
1993-08-18,Sheffield Weds,Aston Villa,0,0,D,1,0,-1,-1,0,0,2,-2,0.0,1,3,-1,-1,0,4,1,3,1.0,0,0,0,0,0,0,0,0,,,-3,0,0,0,-1.0,-5
1993-08-18,Swindon,Oldham,0,1,A,1,0,-1,-1,0,1,3,-2,0.0,1,0,-1,-1,0,0,3,-3,0.0,0,0,0,0,0,0,0,0,,,0,0,0,0,0.0,1
1993-08-21,Blackburn,Oldham,1,0,H,2,3,-1,-1,0,4,4,0,0.5,2,3,-1,-1,0,1,3,-2,0.5,0,0,0,0,0,0,0,0,,,0,0,0,0,0.0,2
1993-08-21,Coventry,West Ham,1,1,D,2,6,-1,-1,0,5,1,4,1.0,2,0,-1,-1,0,0,3,-3,0.0,0,0,0,0,0,0,0,0,,,6,0,0,0,1.0,7
1993-08-21,Everton,Sheffield United,4,2,H,2,6,-1,-1,0,3,0,3,1.0,2,3,-1,-1,0,3,4,-1,0.5,0,0,0,0,0,0,0,0,,,3,0,0,0,0.5,4
1993-08-21,Ipswich,Chelsea,1,0,H,2,6,-1,-1,0,4,0,4,1.0,2,1,-1,-1,0,2,3,-1,0.0,0,0,0,0,0,0,0,0,,,5,0,0,0,1.0,5
1993-08-21,Leeds,Norwich,0,4,A,2,4,-1,-1,0,2,1,1,0.5,2,3,-1,-1,0,3,4,-1,0.5,0,0,0,0,0,0,0,0,,,1,0,0,0,0.0,2
1993-08-21,Man United,Newcastle,1,1,D,2,6,-1,-1,0,5,0,5,1.0,2,0,-1,-1,0,1,3,-2,0.0,0,0,0,0,0,0,0,0,,,6,0,0,0,1.0,7
1993-08-21,QPR,Southampton,2,1,H,2,0,-1,-1,0,2,7,-5,0.0,2,0,-1,-1,0,0,3,-3,0.0,0,0,0,0,0,0,0,0,,,0,0,0,0,0.0,-2
1993-08-21,Sheffield Weds,Arsenal,0,1,A,2,1,-1,-1,0,0,2,-2,0.0,2,3,-1,-1,0,1,3,-2,0.5,0,0,0,0,0,0,0,0,,,-2,0,0,0,-0.5,0
1993-08-21,Tottenham,Man City,1,0,H,2,3,-1,-1,0,1,1,0,0.5,2,1,-1,-1,0,1,2,-1,0.0,0,0,0,0,0,0,0,0,,,2,0,0,0,0.5,1
1993-08-21,Wimbledon,Aston Villa,2,2,D,2,4,-1,-1,0,3,1,2,0.5,2,4,-1,-1,0,4,1,3,0.5,0,0,0,0,0,0,0,0,,,0,0,0,0,0.0,-1
1993-08-22,Swindon,Liverpool,0,5,A,2,0,-1,-1,0,1,4,-3,0.0,2,6,-1,-1,0,5,1,4,1.0,0,0,0,0,0,0,0,0,,,-6,0,0,0,-1.0,-7
1993-08-23,Aston Villa,Man United,1,2,A,3,5,-1,-1,0,6,3,3,0.3333333333333333,3,7,-1,-1,0,6,1,5,0.6666666666666666,0,0,0,0,0,0,0,0,,,-2,0,0,0,-0.3333333333333333,-2
1993-08-24,Arsenal,Leeds,2,1,H,3,6,-1,-1,0,2,3,-1,0.6666666666666666,3,4,-1,-1,0,2,5,-3,0.3333333333333333,0,0,0,0,0,0,0,0,,,2,0,0,0,0.3333333333333333,2
1993-08-24,Man City,Blackburn,0,2,A,3,1,-1,-1,0,1,3,-2,0.0,3,6,-1,-1,0,5,4,1,0.6666666666666666,0,0,0,0,0,0,0,0,,,-5,0,0,0,-0.6666666666666666,-3
1993-08-24,Oldham,Coventry,3,3,D,3,3,-1,-1,0,1,4,-3,0.3333333333333333,3,7,-1,-1,0,6,2,4,0.6666666666666666,0,0,0,0,0,0,0,0,,,-4,0,0,0,-0.3333333333333333,-7
1993-08-24,Sheffield United,Wimbledon,2,1,H,3,3,-1,-1,0,5,8,-3,0.3333333333333333,3,5,-1,-1,0,5,3,2,0.3333333333333333,0,0,0,0,0,0,0,0,,,-2,0,0,0,0.0,-5
1993-08-25,Chelsea,QPR,2,0,H,3,1,-1,-1,0,2,4,-2,0.0,3,3,-1,-1,0,4,8,-4,0.3333333333333333,0,0,0,0,0,0,0,0,,,-2,0,0,0,-0.3333333333333333,2
1993-08-25,Liverpool,Tottenham,1,2,A,3,9,-1,-1,0,10,1,9,1.0,3,6,-1,-1,0,2,1,1,0.6666666666666666,0,0,0,0,0,0,0,0,,,3,0,0,0,0.33333333333333337,8
1993-08-25,Newcastle,Everton,1,0,H,3,1,-1,-1,0,2,4,-2,0.0,3,9,-1,-1,0,7,2,5,1.0,0,0,0,0,0,0,0,0,,,-8,0,0,0,-1.0,-7
1993-08-25,Norwich,Ipswich,1,0,H,3,6,-1,-1,0,7,4,3,0.6666666666666666,3,9,-1,-1,0,5,0,5,1.0,0,0,0,0,0,0,0,0,,,-3,0,0,0,-0.33333333333333337,-2
1993-08-25,Southampton,Swindon,5,1,H,3,0,-1,-1,0,1,5,-4,0.0,3,0,-1,-1,0,1,9,-8,0.0,0,0,0,0,0,0,0,0,,,0,0,0,0,0.0,4
1993-08-25,West Ham,Sheffield Weds,2,0,H,3,1,-1,-1,0,1,4,-3,0.0,3,1,-1,-1,0,0,3,-3,0.0,0,0,0,0,0,0,0,0,,,0,0,0,0,0.0,0
1993-08-27,Man City,Coventry,1,1,D,4,1,-1,-1,0,1,5,-4,0.0,4,8,-1,-1,0,9,5,4,0.5,0,0,1,0,0,0,0,0,,,-7,0,0,0,-0.5,-8
1993-08-28,Arsenal,Everton,2,0,H,4,9,-1,-1,0,4,4,0,0.75,4,9,-1,-1,0,7,3,4,0.75,1,0,0,0,0,0,0,0,,,0,0,0,0,0.0,-4
1993-08-28,Aston Villa,Tottenham,1,0,H,4,5,-1,-1,0,7,5,2,0.25,4,9,-1,-1,0,4,2,2,0.75,0,0,0,0,0,0,0,0,,,-4,0,0,0,-0.5,0
1993-08-28,Chelsea,Sheffield Weds,1,1,D,4,4,-1,-1,0,4,4,0,0.25,4,1,-1,-1,0,0,5,-5,0.0,0,0,0,0,0,0,0,0,,,3,0,0,0,0.25,5
1993-08-28,Liverpool,Leeds,2,0,H,4,9,-1,-1,0,11,3,8,0.75,4,4,-1,-1,0,3,7,-4,0.25,0,0,0,0,0,0,0,0,,,5,0,0,0,0.5,12
1993-08-28,Norwich,Swindon,0,0,D,4,9,-1,-1,0,8,4,4,0.75,4,0,-1,-1,0,2,14,-12,0.0,1,0,0,0,0,0,1,0,,,9,0,0,0,0.75,16
1993-08-28,Oldham,Wimbledon,1,1,D,4,4,-1,-1,0,4,7,-3,0.25,4,5,-1,-1,0,6,5,1,0.25,0,0,0,0,0,0,0,0,,,-1,0,0,0,0.0,-4
1993-08-28,Sheffield United,Ipswich,1,1,D,4,6,-1,-1,0,7,9,-2,0.5,4,9,-1,-1,0,5,1,4,0.75,0,0,0,0,0,0,0,0,,,-3,0,0,0,-0.25,-6
1993-08-28,Southampton,Man United,1,3,A,4,3,-1,-1,0,6,6,0,0.25,4,10,-1,-1,0,8,2,6,0.75,0,0,0,0,0,0,0,0,,,-7,0,0,0,-0.5,-6
1993-08-28,West Ham,QPR,0,4,A,4,4,-1,-1,0,3,4,-1,0.25,4,3,-1,-1,0,4,10,-6,0.25,0,0,0,0,0,0,0,0,,,1,0,0,0,0.0,5
1993-08-29,Newcastle,Blackburn,1,1,D,4,4,-1,-1,0,3,4,-1,0.25,4,9,-1,-1,0,7,4,3,0.75,0,0,0,0,0,0,0,0,,,-5,0,0,0,-0.5,-4
1993-08-30,Leeds,Oldham,1,0,H,5,4,-1,-1,0,3,9,-6,0.2,5,5,-1,-1,0,5,8,-3,0.2,0,0,1,0,0,0,0,0,0.2,0.2,-1,0,0,0,0.0,-3
1993-08-31,Everton,Aston Villa,0,1,A,5,9,-1,-1,0,7,5,2,0.6,5,8,-1,-1,0,8,5,3,0.4,0,0,0,0,0,0,0,0,0.6,0.4,1,0,0,0,0.19999999999999996,-1
1993-08-31,Ipswich,Newcastle,1,1,D,5,10,-1,-1,0,6,2,4,0.6,5,5,-1,-1,0,4,5,-1,0.2,0,0,0,0,0,0,0,0,0.6,0.2,5,0,0,0,0.39999999999999997,5
1993-08-31,Wimbledon,Southampton,1,0,H,5,6,-1,-1,0,7,6,1,0.2,5,3,-1,-1,0,7,9,-2,0.2,0,0,0,0,0,0,0,0,0.2,0.2,3,0,0,0,0.0,3
1993-09-01,Blackburn,Arsenal,1,1,D,5,10,-1,-1,0,8,5,3,0.6,5,12,-1,-1,0,6,4,2,0.8,0,0,0,0,1,0,0,0,0.6,0.8,-2,0,0,0,-0.20000000000000007,1
1993-09-01,Coventry,Liverpool,1,0,H,5,9,-1,-1,0,10,6,4,0.4,5,12,-1,-1,0,13,3,10,0.8,0,0,0,0,0,0,0,0,0.4,0.8,-3,0,0,0,-0.4,-6
1993-09-01,Man United,West Ham,3,0,H,5,13,-1,-1,0,11,3,8,0.8,5,4,-1,-1,0,3,8,-5,0.2,0,0,0,0,0,0,0,0,0.8,0.2,9,0,0,0,0.6000000000000001,13
1993-09-01,QPR,Sheffield United,2,1,H,5,6,-1,-1,0,8,10,-2,0.4,5,7,-1,-1,0,8,10,-2,0.4,0,0,0,0,0,0,0,0,0.4,0.4,-1,0,0,0,0.0,0
1993-09-01,Sheffield Weds,Norwich,3,3,D,5,2,-1,-1,0,1,6,-5,0.0,5,10,-1,-1,0,8,4,4,0.6,0,0,0,0,0,0,0,0,0.0,0.6,-8,0,0,0,-0.6,-9
1993-09-01,Swindon,Man City,1,3,A,5,1,-1,-1,0,2,14,-12,0.0,5,2,-1,-1,0,2,6,-4,0.0,0,0,0,0,0,0,0,0,0.0,0.0,-1,0,0,0,0.0,-8
1993-09-01,Tottenham,Chelsea,1,1,D,5,9,-1,-1,0,4,3,1,0.6,5,5,-1,-1,0,5,5,0,0.2,0,0,0,0,0,0,0,0,0.6,0.2,4,0,0,0,0.39999999999999997,1
1993-09-11,Arsenal,Ipswich,4,0,H,6,13,-1,-1,0,7,5,2,0.6666666666666666,6,11,-1,-1,0,7,3,4,0.5,0,0,0,0,0,0,0,0,0.8,0.4,2,0,0,0,0.16666666666666663,-2
1993-09-11,Aston Villa,Coventry,0,0,D,6,11,-1,-1,0,9,5,4,0.5,6,12,-1,-1,0,11,6,5,0.5,0,0,0,0,0,0,0,0,0.4,0.4,-1,0,0,0,0.0,-1
1993-09-11,Chelsea,Man United,1,0,H,6,6,-1,-1,0,6,6,0,0.16666666666666666,6,16,-1,-1,0,14,3,11,0.8333333333333334,0,0,0,0,1,0,0,0,0.2,0.8,-10,0,0,0,-0.6666666666666667,-11
1993-09-11,Man City,QPR,3,0,H,6,5,-1,-1,0,5,7,-2,0.16666666666666666,6,9,-1,-1,0,10,11,-1,0.5,0,0,0,0,0,0,0,0,0.2,0.6,-4,0,0,0,-0.33333333333333337,-1
1993-09-11,Norwich,Wimbledon,0,1,A,6,11,-1,-1,0,11,7,4,0.5,6,9,-1,-1,0,8,6,2,0.3333333333333333,0,0,0,0,0,0,0,0,0.6,0.2,2,0,0,0,0.16666666666666669,2
1993-09-11,Oldham,Everton,0,1,A,6,5,-1,-1,0,5,9,-4,0.16666666666666666,6,9,-1,-1,0,7,6,1,0.5,0,0,0,0,0,0,1,0,0.2,0.4,-4,0,0,0,-0.33333333333333337,-5
1993-09-11,Sheffield United,Tottenham,2,2,D,6,7,-1,-1,0,9,12,-3,0.3333333333333333,6,10,-1,-1,0,5,4,1,0.5,0,0,0,0,0,0,0,0,0.2,0.4,-3,0,0,0,-0.16666666666666669,-4
1993-09-11,Southampton,Leeds,0,2,A,6,3,-1,-1,0,7,10,-3,0.16666666666666666,6,7,-1,-1,0,4,9,-5,0.3333333333333333,0,0,0,0,0,0,0,0,0.2,0.4,-4,0,0,0,-0.16666666666666666,2
1993-09-11,West Ham,Swindon,0,0,D,6,4,-1,-1,0,3,11,-8,0.16666666666666666,6,1,-1,-1,0,3,17,-14,0.0,0,0,0,0,0,0,0,0,0.2,0.0,3,0,0,0,0.16666666666666666,6
1993-09-12,Liverpool,Blackburn,0,1,A,6,12,-1,-1,0,13,4,9,0.6666666666666666,6,11,-1,-1,0,9,6,3,0.5,0,0,0,0,0,0,0,0,0.6,0.4,1,0,0,0,0.16666666666666663,6
1993-09-13,Newcastle,Sheffield Weds,4,2,H,6,6,-1,-1,0,5,6,-1,0.16666666666666666,6,3,-1,-1,0,4,9,-5,0.0,0,0,0,0,0,0,0,0,0.2,0.0,3,0,0,0,0.16666666666666666,4
1993-09-18,Blackburn,West Ham,0,2,A,7,14,-1,-1,0,10,6,4,0.5714285714285714,7,5,-1,-1,0,3,11,-8,0.14285714285714285,0,0,0,0,0,0,0,0,0.6,0.2,9,0,0,0,0.42857142857142855,12
1993-09-18,Coventry,Chelsea,1,1,D,7,13,-1,-1,0,11,6,5,0.42857142857142855,7,9,-1,-1,0,7,6,1,0.2857142857142857,0,0,0,0,0,0,0,0,0.2,0.4,4,0,0,0,0.14285714285714285,4
1993-09-18,Everton,Liverpool,2,0,H,7,12,-1,-1,0,8,6,2,0.5714285714285714,7,12,-1,-1,0,13,5,8,0.5714285714285714,0,0,0,0,0,0,0,0,0.4,0.4,0,0,0,0,0.0,-6
1993-09-18,Ipswich,Aston Villa,1,2,A,7,11,-1,-1,0,7,7,0,0.42857142857142855,7,12,-1,-1,0,9,5,4,0.42857142857142855,0,0,0,0,0,0,0,0,0.2,0.4,-1,0,0,0,0.0,-4
1993-09-18,Leeds,Sheffield United,2,1,H,7,10,-1,-1,0,6,9,-3,0.42857142857142855,7,8,-1,-1,0,11,14,-3,0.2857142857142857,0,0,0,0,0,0,0,0,0.4,0.2,2,0,0,0,0.14285714285714285,0
1993-09-18,QPR,Norwich,2,2,D,7,9,-1,-1,0,10,14,-4,0.42857142857142855,7,11,-1,-1,0,11,8,3,0.42857142857142855,0,0,0,0,0,0,0,0,0.6,0.4,-2,0,0,0,0.0,-7
1993-09-18,Sheffield Weds,Southampton,2,0,H,7,3,-1,-1,0,6,13,-7,0.0,7,3,-1,-1,0,7,12,-5,0.14285714285714285,0,0,0,0,0,0,1,0,0.0,0.2,0,0,0,0,-0.14285714285714285,-2
1993-09-18,Swindon,Newcastle,2,2,D,7,2,-1,-1,0,3,17,-14,0.0,7,9,-1,-1,0,9,8,1,0.2857142857142857,0,0,0,0,0,0,0,0,0.0,0.4,-7,0,0,0,-0.2857142857142857,-15
1993-09-18,Tottenham,Oldham,5,0,H,7,11,-1,-1,0,7,6,1,0.42857142857142855,7,5,-1,-1,0,5,10,-5,0.14285714285714285,0,0,0,0,0,0,0,0,0.4,0.0,6,0,0,0,0.2857142857142857,6
1993-09-19,Man United,Arsenal,1,0,H,7,16,-1,-1,0,14,4,10,0.7142857142857143,7,16,-1,-1,0,11,5,6,0.7142857142857143,0,0,0,0,0,0,0,0,0.6,0.8,0,0,0,0,0.0,4
1993-09-20,Wimbledon,Man City,1,0,H,7,12,-1,-1,0,9,6,3,0.42857142857142855,7,8,-1,-1,0,8,7,1,0.2857142857142857,0,0,0,0,0,0,0,0,0.4,0.4,4,0,0,0,0.14285714285714285,2
1993-09-25,Arsenal,Southampton,1,0,H,8,16,-1,-1,0,11,6,5,0.625,8,3,-1,-1,0,7,14,-7,0.125,0,0,0,0,0,0,1,0,0.6,0.2,13,0,0,0,0.5,12
1993-09-25,Blackburn,Sheffield Weds,1,1,D,8,14,-1,-1,0,10,8,2,0.5,8,6,-1,-1,0,8,13,-5,0.125,0,0,0,0,0,0,0,0,0.4,0.2,8,0,0,0,0.375,7
1993-09-25,Chelsea,Liverpool,1,0,H,8,10,-1,-1,0,8,7,1,0.25,8,12,-1,-1,0,13,7,6,0.5,0,0,0,0,0,0,1,0,0.4,0.2,-2,0,0,0,-0.25,-5
1993-09-25,Coventry,Leeds,0,2,A,8,14,-1,-1,0,12,7,5,0.375,8,13,-1,-1,0,8,10,-2,0.5,0,0,0,0,1,0,0,0,0.2,0.6,1,0,0,0,-0.125,7
1993-09-25,Everton,Norwich,1,5,A,8,15,-1,-1,0,10,6,4,0.625,8,12,-1,-1,0,13,10,3,0.375,0,0,0,0,0,0,0,0,0.4,0.2,3,0,0,0,0.25,1
1993-09-25,Man United,Swindon,4,2,H,8,19,-1,-1,0,15,4,11,0.75,8,3,-1,-1,0,5,19,-14,0.0,0,0,0,0,0,0,0,0,0.8,0.0,16,0,0,0,0.75,25
1993-09-25,Newcastle,West Ham,2,0,H,8,10,-1,-1,0,11,10,1,0.25,8,8,-1,-1,0,5,11,-6,0.25,0,0,0,0,0,0,0,0,0.4,0.4,2,0,0,0,0.0,7
1993-09-25,Oldham,Aston Villa,1,1,D,8,5,-1,-1,0,5,15,-10,0.125,8,15,-1,-1,0,11,6,5,0.5,0,0,1,0,0,0,0,0,0.0,0.6,-10,0,0,0,-0.375,-15
1993-09-25,Sheffield United,Man City,0,1,A,8,8,-1,-1,0,12,16,-4,0.25,8,8,-1,-1,0,8,8,0,0.25,0,0,0,0,0,0,0,0,0.2,0.4,0,0,0,0,0.0,-4
1993-09-26,Ipswich,Tottenham,2,2,D,8,11,-1,-1,0,8,9,-1,0.375,8,14,-1,-1,0,12,6,6,0.5,0,0,0,0,0,0,0,0,0.0,0.4,-3,0,0,0,-0.125,-7
1993-09-27,Wimbledon,QPR,1,1,D,8,15,-1,-1,0,10,6,4,0.5,8,10,-1,-1,0,12,16,-4,0.375,1,0,0,0,0,0,0,0,0.6,0.4,5,0,0,0,0.125,8
1993-10-02,Aston Villa,Newcastle,0,2,A,9,16,-1,-1,0,12,7,5,0.4444444444444444,9,13,-1,-1,0,13,10,3,0.3333333333333333,0,0,0,0,0,0,0,0,0.6,0.4,3,0,0,0,0.1111111111111111,2
1993-10-02,Leeds,Wimbledon,4,0,H,9,16,-1,-1,0,10,10,0,0.5555555555555556,9,16,-1,-1,0,11,7,4,0.4444444444444444,1,0,0,0,0,0,0,0,0.8,0.6,0,0,0,0,0.11111111111111116,-4
1993-10-02,Liverpool,Arsenal,0,0,D,9,12,-1,-1,0,13,8,5,0.4444444444444444,9,19,-1,-1,0,12,6,6,0.6666666666666666,0,0,1,0,0,0,0,0,0.2,0.6,-7,0,0,0,-0.2222222222222222,-1
1993-10-02,Norwich,Coventry,1,0,H,9,15,-1,-1,0,18,11,7,0.4444444444444444,9,14,-1,-1,0,12,9,3,0.3333333333333333,0,0,0,0,0,0,0,0,0.2,0.2,1,0,0,0,0.1111111111111111,4
1993-10-02,QPR,Ipswich,3,0,H,9,11,-1,-1,0,13,17,-4,0.3333333333333333,9,12,-1,-1,0,10,11,-1,0.3333333333333333,0,0,0,0,0,0,0,0,0.4,0.0,-1,0,0,0,0.0,-3
1993-10-02,Sheffield Weds,Man United,2,3,A,9,7,-1,-1,0,9,14,-5,0.1111111111111111,9,22,-1,-1,0,19,6,13,0.7777777777777778,0,0,0,0,0,0,0,0,0.2,0.8,-15,0,0,0,-0.6666666666666667,-18
1993-10-02,Southampton,Sheffield United,3,3,D,9,3,-1,-1,0,7,15,-8,0.1111111111111111,9,8,-1,-1,0,12,17,-5,0.2222222222222222,0,0,1,1,0,0,0,0,0.0,0.0,-5,0,0,0,-0.1111111111111111,-3
1993-10-02,Swindon,Blackburn,1,3,A,9,3,-1,-1,0,7,23,-16,0.0,9,15,-1,-1,0,11,9,2,0.4444444444444444,0,0,0,0,0,0,0,0,0.0,0.2,-12,0,0,0,-0.4444444444444444,-18
1993-10-02,West Ham,Chelsea,1,0,H,9,8,-1,-1,0,5,13,-8,0.2222222222222222,9,13,-1,-1,0,9,7,2,0.3333333333333333,0,0,0,0,0,0,0,0,0.2,0.4,-5,0,0,0,-0.1111111111111111,-10
1993-10-03,Tottenham,Everton,3,2,H,9,15,-1,-1,0,14,8,6,0.4444444444444444,9,15,-1,-1,0,11,11,0,0.5555555555555556,0,0,0,0,0,0,0,0,0.2,0.4,0,0,0,0,-0.11111111111111116,6
1993-10-04,Man City,Oldham,1,1,D,9,11,-1,-1,0,9,8,1,0.3333333333333333,9,6,-1,-1,0,6,16,-10,0.1111111111111111,0,0,0,0,0,0,0,0,0.6,0.0,5,0,0,0,0.2222222222222222,11
1993-10-16,Arsenal,Man City,0,0,D,10,20,-1,-1,0,12,6,6,0.6,10,12,-1,-1,0,10,9,1,0.3,0,0,0,0,0,0,0,0,0.4,0.6,8,0,0,0,0.3,5
1993-10-16,Chelsea,Norwich,1,2,A,10,13,-1,-1,0,9,8,1,0.3,10,18,-1,-1,0,19,11,8,0.5,0,0,0,0,0,0,0,0,0.4,0.4,-5,0,0,0,-0.2,-7
1993-10-16,Coventry,Southampton,1,1,D,10,14,-1,-1,0,12,10,2,0.3,10,4,-1,-1,0,10,18,-8,0.1,0,0,0,0,0,0,0,0,0.2,0.0,10,0,0,0,0.19999999999999998,10
1993-10-16,Liverpool,Oldham,2,1,H,10,13,-1,-1,0,13,8,5,0.4,10,7,-1,-1,0,7,17,-10,0.1,0,0,0,0,0,0,0,0,0.0,0.0,6,0,0,0,0.30000000000000004,15
1993-10-16,Man United,Tottenham,2,1,H,10,25,-1,-1,0,22,8,14,0.8,10,18,-1,-1,0,17,10,7,0.5,1,0,0,0,0,0,0,0,0.8,0.4,7,0,0,0,0.30000000000000004,7
1993-10-16,Newcastle,QPR,1,2,A,10,16,-1,-1,0,15,10,5,0.4,10,14,-1,-1,0,16,17,-1,0.4,0,0,0,0,0,0,0,0,0.6,0.4,2,0,0,0,0.0,6
1993-10-16,Sheffield Weds,Wimbledon,2,2,D,10,7,-1,-1,0,11,17,-6,0.1,10,16,-1,-1,0,11,11,0,0.4,0,0,0,0,0,0,0,0,0.2,0.6,-9,0,0,0,-0.30000000000000004,-6
1993-10-16,Swindon,Everton,1,1,D,10,3,-1,-1,0,8,26,-18,0.0,10,15,-1,-1,0,13,14,-1,0.5,0,0,0,0,0,0,0,0,0.0,0.4,-12,0,0,0,-0.5,-17
1993-10-16,West Ham,Aston Villa,0,0,D,10,11,-1,-1,0,6,13,-7,0.3,10,16,-1,-1,0,12,9,3,0.4,0,0,0,0,0,0,0,0,0.4,0.4,-5,0,0,0,-0.10000000000000003,-10
1993-10-17,Ipswich,Leeds,0,0,D,10,12,-1,-1,0,10,14,-4,0.3,10,19,-1,-1,0,14,10,4,0.6,0,0,0,0,1,1,0,0,0.0,1.0,-7,0,0,0,-0.3,-8
1993-10-18,Blackburn,Sheffield United,0,0,D,10,18,-1,-1,0,14,10,4,0.5,10,9,-1,-1,0,15,20,-5,0.2,0,0,0,0,0,0,0,0,0.4,0.0,9,0,0,0,0.3,9
1993-10-23,Aston Villa,Chelsea,1,0,H,11,17,-1,-1,0,12,9,3,0.36363636363636365,11,13,-1,-1,0,10,10,0,0.2727272727272727,0,0,0,0,0,0,0,0,0.2,0.4,4,0,0,0,0.09090909090909094,3
1993-10-23,Everton,Man United,0,1,A,11,16,-1,-1,0,14,15,-1,0.45454545454545453,11,28,-1,-1,0,24,9,15,0.8181818181818182,0,0,0,0,1,0,0,0,0.4,0.8,-12,0,0,0,-0.3636363636363637,-16
1993-10-23,Leeds,Blackburn,3,3,D,11,20,-1,-1,0,14,10,4,0.5454545454545454,11,19,-1,-1,0,14,10,4,0.45454545454545453,0,0,0,0,0,0,0,0,0.8,0.4,1,0,0,0,0.09090909090909088,0
1993-10-23,Man City,Liverpool,1,1,D,11,13,-1,-1,0,10,9,1,0.2727272727272727,11,16,-1,-1,0,15,9,6,0.45454545454545453,0,0,0,0,0,0,0,0,0.4,0.2,-3,0,0,0,-0.18181818181818182,-5
1993-10-23,Norwich,West Ham,0,0,D,11,21,-1,-1,0,21,12,9,0.5454545454545454,11,12,-1,-1,0,6,13,-7,0.2727272727272727,1,0,0,0,0,0,0,0,0.6,0.4,9,0,0,0,0.2727272727272727,16
1993-10-23,Oldham,Arsenal,0,0,D,11,7,-1,-1,0,8,19,-11,0.09090909090909091,11,21,-1,-1,0,12,6,6,0.5454545454545454,0,0,0,0,0,0,0,0,0.0,0.4,-14,0,0,0,-0.4545454545454545,-17
1993-10-23,QPR,Coventry,5,1,H,11,17,-1,-1,0,18,18,0,0.45454545454545453,11,15,-1,-1,0,13,11,2,0.2727272727272727,0,0,0,0,0,0,0,0,0.4,0.0,2,0,0,0,0.18181818181818182,-2
1993-10-23,Sheffield United,Sheffield Weds,1,1,D,11,10,-1,-1,0,15,20,-5,0.18181818181818182,11,8,-1,-1,0,13,19,-6,0.09090909090909091,0,0,0,0,0,0,0,0,0.0,0.2,2,0,0,0,0.09090909090909091,1
1993-10-23,Tottenham,Swindon,1,1,D,11,18,-1,-1,0,18,12,6,0.45454545454545453,11,4,-1,-1,0,9,27,-18,0.0,0,0,0,0,0,0,0,0,0.4,0.0,14,0,0,0,0.45454545454545453,24
1993-10-24,Southampton,Newcastle,2,1,H,11,5,-1,-1,0,11,19,-8,0.09090909090909091,11,16,-1,-1,0,16,12,4,0.36363636363636365,0,0,0,0,0,0,0,0,0.0,0.6,-11,0,0,0,-0.2727272727272727,-12
1993-10-25,Wimbledon,Ipswich,0,2,A,11,17,-1,-1,0,13,13,0,0.36363636363636365,11,13,-1,-1,0,10,14,-4,0.2727272727272727,0,0,0,0,0,0,0,0,0.4,0.0,4,0,0,0,0.09090909090909094,4
1993-10-30,Arsenal,Norwich,0,0,D,12,22,-1,-1,0,12,6,6,0.5,12,22,-1,-1,0,21,12,9,0.5,0,0,0,0,0,0,0,0,0.2,0.6,0,0,0,0,0.0,-3
1993-10-30,Blackburn,Tottenham,1,0,H,12,20,-1,-1,0,17,13,4,0.4166666666666667,12,19,-1,-1,0,19,13,6,0.4166666666666667,0,0,0,0,0,0,0,0,0.2,0.4,1,0,0,0,0.0,-2
1993-10-30,Chelsea,Oldham,0,1,A,12,13,-1,-1,0,10,11,-1,0.25,12,8,-1,-1,0,8,19,-11,0.08333333333333333,0,0,1,0,0,0,0,0,0.2,0.0,5,0,0,0,0.16666666666666669,10
1993-10-30,Ipswich,Everton,0,2,A,12,16,-1,-1,0,12,14,-2,0.3333333333333333,12,16,-1,-1,0,14,16,-2,0.4166666666666667,0,0,0,0,0,0,0,0,0.2,0.2,0,0,0,0,-0.08333333333333337,0
1993-10-30,Liverpool,Southampton,4,2,H,12,17,-1,-1,0,16,10,6,0.4166666666666667,12,8,-1,-1,0,13,20,-7,0.16666666666666666,0,0,0,0,0,0,0,0,0.2,0.2,9,0,0,0,0.25,13
1993-10-30,Man United,QPR,2,1,H,12,31,-1,-1,0,25,9,16,0.8333333333333334,12,20,-1,-1,0,23,19,4,0.5,1,1,0,0,1,0,0,0,1.0,0.6,11,0,0,0,0.33333333333333337,12
1993-10-30,Newcastle,Wimbledon,4,0,H,12,16,-1,-1,0,17,14,3,0.3333333333333333,12,17,-1,-1,0,13,15,-2,0.3333333333333333,0,0,0,0,0,0,0,0,0.4,0.2,-1,0,0,0,0.0,5
1993-10-30,Sheffield Weds,Leeds,3,3,D,12,9,-1,-1,0,14,20,-6,0.08333333333333333,12,21,-1,-1,0,17,13,4,0.5,0,0,0,0,0,0,0,0,0.2,0.6,-12,0,0,0,-0.4166666666666667,-10
1993-10-30,Swindon,Aston Villa,1,2,A,12,5,-1,-1,0,10,28,-18,0.0,12,20,-1,-1,0,13,9,4,0.4166666666666667,0,0,0,0,0,0,0,0,0.0,0.4,-15,0,0,0,-0.4166666666666667,-22
1993-10-31,Coventry,Sheffield United,0,0,D,12,15,-1,-1,0,14,16,-2,0.25,12,11,-1,-1,0,16,21,-5,0.16666666666666666,0,0,0,0,0,0,0,0,0.0,0.0,4,0,0,0,0.08333333333333334,3
1993-11-01,West Ham,Man City,3,1,H,12,13,-1,-1,0,6,13,-7,0.25,12,14,-1,-1,0,11,10,1,0.25,0,0,0,0,0,0,0,0,0.4,0.2,-1,0,0,0,0.0,-8
1993-11-06,Arsenal,Aston Villa,1,2,A,13,23,-1,-1,0,12,6,6,0.46153846153846156,13,23,-1,-1,0,15,10,5,0.46153846153846156,0,0,0,0,0,0,0,0,0.2,0.4,0,0,0,0,0.0,1
1993-11-06,Coventry,Everton,2,1,H,13,16,-1,-1,0,14,16,-2,0.23076923076923078,13,19,-1,-1,0,16,16,0,0.46153846153846156,0,0,0,0,0,0,0,0,0.0,0.2,-3,0,0,0,-0.23076923076923078,-2
1993-11-06,Ipswich,Sheffield Weds,1,4,A,13,16,-1,-1,0,12,16,-4,0.3076923076923077,13,10,-1,-1,0,17,23,-6,0.07692307692307693,0,0,0,0,0,0,0,0,0.2,0.0,6,0,0,0,0.23076923076923078,2
1993-11-06,Leeds,Chelsea,4,1,H,13,22,-1,-1,0,20,16,4,0.46153846153846156,13,13,-1,-1,0,10,12,-2,0.23076923076923078,0,0,0,0,0,0,1,0,0.4,0.2,9,0,0,0,0.23076923076923078,6
1993-11-06,Liverpool,West Ham,2,0,H,13,20,-1,-1,0,20,12,8,0.46153846153846156,13,16,-1,-1,0,9,14,-5,0.3076923076923077,0,0,0,0,0,0,0,0,0.4,0.4,4,0,0,0,0.15384615384615385,13
1993-11-06,QPR,Blackburn,1,0,H,13,20,-1,-1,0,24,21,3,0.46153846153846156,13,23,-1,-1,0,18,13,5,0.46153846153846156,0,0,0,0,0,0,0,0,0.6,0.4,-3,0,0,0,0.0,-2
1993-11-06,Sheffield United,Norwich,1,2,A,13,12,-1,-1,0,16,21,-5,0.15384615384615385,13,23,-1,-1,0,21,12,9,0.46153846153846156,0,0,0,0,0,0,0,0,0.0,0.6,-11,0,0,0,-0.3076923076923077,-14
1993-11-06,Southampton,Tottenham,1,0,H,13,8,-1,-1,0,15,24,-9,0.15384615384615385,13,19,-1,-1,0,19,14,5,0.38461538461538464,0,0,0,0,0,0,0,0,0.2,0.2,-11,0,0,0,-0.23076923076923078,-14
1993-11-06,Wimbledon,Swindon,3,0,H,13,17,-1,-1,0,13,19,-6,0.3076923076923077,13,5,-1,-1,0,11,30,-19,0.0,0,0,0,0,0,0,0,0,0.0,0.0,12,0,0,0,0.3076923076923077,13
1993-11-07,Man City,Man United,2,3,A,13,14,-1,-1,0,12,13,-1,0.23076923076923078,13,34,-1,-1,0,27,10,17,0.8461538461538461,0,0,0,0,1,1,0,0,0.2,1.0,-20,0,0,0,-0.6153846153846154,-18
1993-11-08,Oldham,Newcastle,1,3,A,13,11,-1,-1,0,9,19,-10,0.15384615384615385,13,19,-1,-1,0,21,14,7,0.38461538461538464,0,0,0,0,0,0,0,0,0.2,0.6,-8,0,0,0,-0.23076923076923078,-17
1993-11-20,Aston Villa,Sheffield United,1,0,H,14,26,-1,-1,0,17,11,6,0.5,14,12,-1,-1,0,17,23,-6,0.14285714285714285,1,0,0,0,0,0,0,0,0.6,0.0,14,0,0,0,0.35714285714285715,12
1993-11-20,Blackburn,Southampton,2,0,H,14,23,-1,-1,0,18,14,4,0.42857142857142855,14,11,-1,-1,0,16,24,-8,0.21428571428571427,0,0,0,0,0,0,0,0,0.4,0.4,12,0,0,0,0.21428571428571427,12
1993-11-20,Chelsea,Arsenal,0,2,A,14,13,-1,-1,0,11,16,-5,0.21428571428571427,14,23,-1,-1,0,13,8,5,0.42857142857142855,0,0,1,1,0,0,0,0,0.0,0.0,-10,0,0,0,-0.21428571428571427,-10
1993-11-20,Everton,QPR,0,3,A,14,19,-1,-1,0,17,18,-1,0.42857142857142855,14,23,-1,-1,0,25,21,4,0.5,0,0,0,0,0,0,0,0,0.2,0.8,-4,0,0,0,-0.07142857142857145,-5
1993-11-20,Man United,Wimbledon,3,1,H,14,37,-1,-1,0,30,12,18,0.8571428571428571,14,20,-1,-1,0,16,19,-3,0.35714285714285715,1,1,0,0,0,0,0,0,1.0,0.2,17,0,0,0,0.49999999999999994,21
1993-11-20,Norwich,Man City,1,1,D,14,26,-1,-1,0,23,13,10,0.5,14,14,-1,-1,0,14,16,-2,0.21428571428571427,0,0,0,0,0,0,0,0,0.6,0.0,12,0,0,0,0.2857142857142857,12
1993-11-20,Sheffield Weds,Coventry,0,0,D,14,13,-1,-1,0,21,24,-3,0.14285714285714285,14,19,-1,-1,0,16,17,-1,0.2857142857142857,0,0,0,0,0,0,0,0,0.2,0.2,-6,0,0,0,-0.14285714285714285,-2
1993-11-20,Swindon,Ipswich,2,2,D,14,5,-1,-1,0,11,33,-22,0.0,14,16,-1,-1,0,13,20,-7,0.2857142857142857,0,0,0,0,0,0,0,0,0.0,0.2,-11,0,0,0,-0.2857142857142857,-15
1993-11-20,Tottenham,Leeds,1,1,D,14,19,-1,-1,0,19,15,4,0.35714285714285715,14,25,-1,-1,0,24,17,7,0.5,0,0,0,0,0,0,0,0,0.2,0.4,-6,0,0,0,-0.14285714285714285,-3
1993-11-20,West Ham,Oldham,2,0,H,14,16,-1,-1,0,9,16,-7,0.2857142857142857,14,11,-1,-1,0,10,22,-12,0.14285714285714285,0,0,0,0,0,0,0,0,0.4,0.2,5,0,0,0,0.14285714285714285,5
1993-11-21,Newcastle,Liverpool,3,0,H,14,22,-1,-1,0,24,15,9,0.42857142857142855,14,23,-1,-1,0,22,12,10,0.5,0,0,0,0,0,0,0,0,0.6,0.6,-1,0,0,0,-0.07142857142857145,-1
1993-11-22,Chelsea,Man City,0,0,D,15,13,-1,-1,0,11,18,-7,0.2,15,15,-1,-1,0,15,17,-2,0.2,0,0,1,1,0,0,0,0,0.0,0.0,-2,0,0,0,0.0,-5
1993-11-23,Blackburn,Coventry,2,1,H,15,26,-1,-1,0,20,14,6,0.4666666666666667,15,20,-1,-1,0,16,17,-1,0.26666666666666666,0,0,0,0,0,0,0,0,0.4,0.2,6,0,0,0,0.2,7
1993-11-23,Everton,Leeds,1,1,D,15,19,-1,-1,0,17,21,-4,0.4,15,26,-1,-1,0,25,18,7,0.4666666666666667,0,0,0,0,0,0,0,0,0.2,0.2,-7,0,0,0,-0.06666666666666665,-11
1993-11-24,Aston Villa,Southampton,0,2,A,15,29,-1,-1,0,18,11,7,0.5333333333333333,15,11,-1,-1,0,16,26,-10,0.2,1,0,0,0,0,0,0,0,0.8,0.4,18,0,0,0,0.3333333333333333,17
1993-11-24,Man United,Ipswich,0,0,D,15,40,-1,-1,0,33,13,20,0.8666666666666667,15,17,-1,-1,0,15,22,-7,0.26666666666666666,1,1,0,0,0,0,0,0,1.0,0.2,23,0,0,0,0.6000000000000001,27
1993-11-24,Newcastle,Sheffield United,4,0,H,15,25,-1,-1,0,27,15,12,0.4666666666666667,15,12,-1,-1,0,17,24,-7,0.13333333333333333,1,0,0,0,0,0,0,0,0.6,0.0,13,0,0,0,0.33333333333333337,19
1993-11-24,Sheffield Weds,Oldham,3,0,H,15,14,-1,-1,0,21,24,-3,0.13333333333333333,15,11,-1,-1,0,10,24,-14,0.13333333333333333,0,0,0,0,0,0,0,0,0.2,0.2,3,0,0,0,0.0,11
1993-11-24,Swindon,QPR,1,0,H,15,6,-1,-1,0,13,35,-22,0.0,15,26,-1,-1,0,28,21,7,0.5333333333333333,0,0,0,0,0,0,0,0,0.0,0.8,-20,0,0,0,-0.5333333333333333,-29
1993-11-24,Tottenham,Wimbledon,1,1,D,15,20,-1,-1,0,20,16,4,0.3333333333333333,15,20,-1,-1,0,17,22,-5,0.3333333333333333,0,0,0,0,0,0,0,0,0.0,0.2,0,0,0,0,0.0,9
1993-11-24,West Ham,Arsenal,0,0,D,15,19,-1,-1,0,11,16,-5,0.3333333333333333,15,26,-1,-1,0,15,8,7,0.4666666666666667,0,0,0,0,0,0,0,0,0.4,0.2,-7,0,0,0,-0.13333333333333336,-12
1993-11-27,Arsenal,Newcastle,2,1,H,16,27,-1,-1,0,15,8,7,0.4375,16,28,-1,-1,0,31,15,16,0.5,0,0,0,0,1,0,0,0,0.2,0.8,-1,0,0,0,-0.0625,-9
1993-11-27,Coventry,Man United,0,1,A,16,20,-1,-1,0,17,19,-2,0.25,16,41,-1,-1,0,33,13,20,0.8125,0,0,0,0,0,0,0,0,0.2,0.8,-21,0,0,0,-0.5625,-22
1993-11-27,Ipswich,Blackburn,1,0,H,16,18,-1,-1,0,15,22,-7,0.25,16,29,-1,-1,0,22,15,7,0.5,0,0,0,0,0,0,0,0,0.2,0.6,-11,0,0,0,-0.25,-14
1993-11-27,Leeds,Swindon,3,0,H,16,27,-1,-1,0,26,19,7,0.4375,16,9,-1,-1,0,14,35,-21,0.0625,0,0,0,0,0,0,0,0,0.2,0.2,18,0,0,0,0.375,28
1993-11-27,Man City,Sheffield Weds,1,3,A,16,16,-1,-1,0,15,17,-2,0.1875,16,17,-1,-1,0,24,24,0,0.1875,0,0,0,0,0,0,0,0,0.0,0.4,-1,0,0,0,0.0,-2
1993-11-27,Oldham,Norwich,2,1,H,16,11,-1,-1,0,10,27,-17,0.125,15,27,-1,-1,0,24,14,10,0.4666666666666667,0,0,1,0,0,0,0,0,0.2,0.4,-16,0,0,0,-0.3416666666666667,-27
1993-11-27,QPR,Tottenham,1,1,D,16,26,-1,-1,0,28,22,6,0.5,16,21,-1,-1,0,21,17,4,0.3125,0,0,0,0,0,0,0,0,0.6,0.0,5,0,0,0,0.1875,2
1993-11-27,Sheffield United,Chelsea,1,0,H,16,12,-1,-1,0,17,28,-11,0.125,16,14,-1,-1,0,11,18,-7,0.1875,0,0,1,0,0,0,0,0,0.0,0.0,-2,0,0,0,-0.0625,-4
1993-11-27,Wimbledon,Everton,1,1,D,16,21,-1,-1,0,18,23,-5,0.3125,16,20,-1,-1,0,18,22,-4,0.375,0,0,0,0,0,0,0,0,0.2,0.2,1,0,0,0,-0.0625,-1
1993-11-28,Liverpool,Aston Villa,2,1,H,15,23,-1,-1,0,22,15,7,0.4666666666666667,16,29,-1,-1,0,18,13,5,0.5,0,0,0,0,0,0,0,0,0.6,0.8,-6,0,0,0,-0.033333333333333326,2
1993-11-29,Southampton,West Ham,0,2,A,16,14,-1,-1,0,18,26,-8,0.25,16,20,-1,-1,0,11,16,-5,0.3125,0,0,0,0,0,0,0,0,0.6,0.4,-6,0,0,0,-0.0625,-3
1993-12-04,Coventry,Arsenal,1,0,H,17,20,-1,-1,0,17,20,-3,0.23529411764705882,17,30,-1,-1,0,17,9,8,0.47058823529411764,0,0,0,0,0,0,0,0,0.2,0.4,-10,0,0,0,-0.23529411764705882,-11
1993-12-04,Everton,Southampton,1,0,H,17,21,-1,-1,0,19,23,-4,0.35294117647058826,17,14,-1,-1,0,18,28,-10,0.23529411764705882,0,0,0,0,0,0,0,0,0.2,0.4,7,0,0,0,0.11764705882352944,6
1993-12-04,Ipswich,Oldham,0,0,D,17,21,-1,-1,0,16,22,-6,0.29411764705882354,17,14,-1,-1,0,12,28,-16,0.17647058823529413,0,0,0,0,0,0,0,0,0.2,0.4,7,0,0,0,0.11764705882352941,10
1993-12-04,Leeds,Man City,3,2,H,17,30,-1,-1,0,29,19,10,0.47058823529411764,17,16,-1,-1,0,16,20,-4,0.17647058823529413,0,0,0,0,0,0,0,0,0.4,0.0,14,0,0,0,0.2941176470588235,14
1993-12-04,Man United,Norwich,2,2,D,17,44,-1,-1,0,34,13,21,0.8235294117647058,16,27,-1,-1,0,25,16,9,0.4375,0,0,0,0,0,0,0,0,0.8,0.2,17,0,0,0,0.38602941176470584,12
1993-12-04,QPR,Aston Villa,2,2,D,17,27,-1,-1,0,29,23,6,0.47058823529411764,17,29,-1,-1,0,19,15,4,0.47058823529411764,0,0,0,0,0,0,0,0,0.4,0.6,-2,0,0,0,0.0,2
1993-12-04,Sheffield Weds,Liverpool,3,1,H,17,20,-1,-1,0,27,25,2,0.23529411764705882,16,26,-1,-1,0,24,16,8,0.5,0,0,0,0,0,0,0,0,0.6,0.6,-6,0,0,0,-0.2647058823529412,-6
1993-12-04,Swindon,Sheffield United,0,0,D,17,9,-1,-1,0,14,38,-24,0.058823529411764705,17,15,-1,-1,0,18,28,-10,0.17647058823529413,0,0,0,0,0,0,0,0,0.2,0.2,-6,0,0,0,-0.11764705882352942,-14
1993-12-04,Tottenham,Newcastle,1,2,A,17,22,-1,-1,0,22,18,4,0.29411764705882354,17,28,-1,-1,0,32,17,15,0.47058823529411764,0,0,0,0,0,0,0,0,0.0,0.8,-6,0,0,0,-0.1764705882352941,-11
1993-12-04,Wimbledon,West Ham,1,2,A,17,22,-1,-1,0,19,24,-5,0.29411764705882354,17,23,-1,-1,0,13,16,-3,0.35294117647058826,0,0,0,0,0,0,0,0,0.2,0.6,-1,0,0,0,-0.05882352941176472,-2
1993-12-05,Blackburn,Chelsea,2,0,H,17,29,-1,-1,0,22,16,6,0.47058823529411764,17,14,-1,-1,0,11,19,-8,0.17647058823529413,0,0,0,0,0,0,0,0,0.6,0.0,15,0,0,0,0.2941176470588235,14
1993-12-06,Arsenal,Tottenham,1,1,D,18,30,-1,-1,0,17,10,7,0.4444444444444444,18,22,-1,-1,0,23,20,3,0.2777777777777778,0,0,0,0,0,0,0,0,0.4,0.0,8,0,0,0,0.16666666666666663,4
1993-12-07,Oldham,Swindon,2,1,H,18,15,-1,-1,0,12,28,-16,0.16666666666666666,18,10,-1,-1,0,14,38,-24,0.05555555555555555,0,0,0,0,0,0,0,0,0.2,0.2,5,0,0,0,0.1111111111111111,8
1993-12-07,Sheffield United,Man United,0,3,A,18,16,-1,-1,0,18,28,-10,0.16666666666666666,18,45,-1,-1,0,36,15,21,0.7777777777777778,0,0,0,0,0,0,0,0,0.2,0.6,-29,0,0,0,-0.6111111111111112,-31
1993-12-08,Aston Villa,Sheffield Weds,2,2,D,18,30,-1,-1,0,21,17,4,0.4444444444444444,18,23,-1,-1,0,30,26,4,0.2777777777777778,0,0,0,0,1,0,0,0,0.4,0.8,7,0,0,0,0.16666666666666663,0
1993-12-08,Liverpool,QPR,3,2,H,17,26,-1,-1,0,25,19,6,0.47058823529411764,18,28,-1,-1,0,31,25,6,0.4444444444444444,0,0,0,0,0,0,0,0,0.6,0.4,-2,0,0,0,0.02614379084967322,0
1993-12-08,Man City,Everton,1,0,H,18,16,-1,-1,0,18,23,-5,0.16666666666666666,18,24,-1,-1,0,20,23,-3,0.3888888888888889,0,0,0,0,0,0,0,0,0.0,0.2,-8,0,0,0,-0.22222222222222224,-2
1993-12-08,Southampton,Ipswich,0,1,A,18,14,-1,-1,0,18,29,-11,0.2222222222222222,18,22,-1,-1,0,16,22,-6,0.2777777777777778,0,0,0,0,0,0,0,0,0.4,0.2,-8,0,0,0,-0.05555555555555558,-5
1993-12-08,West Ham,Leeds,0,1,A,18,26,-1,-1,0,15,17,-2,0.3888888888888889,18,33,-1,-1,0,32,21,11,0.5,0,0,0,0,0,0,0,0,0.6,0.6,-7,0,0,0,-0.1111111111111111,-13
1993-12-11,Aston Villa,Wimbledon,0,1,A,19,31,-1,-1,0,23,19,4,0.42105263157894735,18,22,-1,-1,0,20,26,-6,0.2777777777777778,0,0,0,0,0,0,0,0,0.2,0.2,9,0,0,0,0.14327485380116955,10
1993-12-11,Chelsea,Ipswich,1,1,D,18,14,-1,-1,0,11,21,-10,0.16666666666666666,19,25,-1,-1,0,17,22,-5,0.3157894736842105,0,0,0,0,0,0,0,0,0.0,0.4,-11,0,0,0,-0.14912280701754385,-5
1993-12-11,Liverpool,Swindon,2,2,D,18,29,-1,-1,0,28,21,7,0.5,19,10,-1,-1,0,15,40,-25,0.05263157894736842,0,0,0,0,0,0,0,0,0.6,0.2,19,0,0,0,0.4473684210526316,32
1993-12-11,Man City,Tottenham,0,2,A,19,19,-1,-1,0,19,23,-4,0.21052631578947367,19,23,-1,-1,0,24,21,3,0.2631578947368421,0,0,0,0,0,0,0,0,0.2,0.0,-4,0,0,0,-0.05263157894736842,-7
1993-12-11,Newcastle,Man United,1,1,D,18,31,-1,-1,0,34,18,16,0.5,19,48,-1,-1,0,39,15,24,0.7894736842105263,0,0,0,0,0,0,0,0,0.8,0.6,-17,0,0,0,-0.2894736842105263,-8
1993-12-11,Oldham,Blackburn,1,2,A,19,18,-1,-1,0,14,29,-15,0.21052631578947367,18,32,-1,-1,0,24,16,8,0.5,0,0,0,0,0,0,0,0,0.4,0.6,-14,0,0,0,-0.2894736842105263,-23
1993-12-11,Sheffield United,Everton,0,0,D,19,16,-1,-1,0,18,31,-13,0.15789473684210525,19,24,-1,-1,0,20,24,-4,0.3684210526315789,0,0,0,0,0,0,0,0,0.2,0.2,-8,0,0,0,-0.21052631578947367,-9
1993-12-11,Southampton,QPR,0,1,A,19,14,-1,-1,0,18,30,-12,0.21052631578947367,19,28,-1,-1,0,33,28,5,0.42105263157894735,0,0,1,0,0,0,0,0,0.2,0.2,-14,0,0,0,-0.21052631578947367,-17
1993-12-11,West Ham,Coventry,3,2,H,19,26,-1,-1,0,15,18,-3,0.3684210526315789,18,23,-1,-1,0,18,20,-2,0.2777777777777778,0,0,0,0,0,0,0,0,0.6,0.4,3,0,0,0,0.09064327485380114,-1
1993-12-12,Arsenal,Sheffield Weds,1,0,H,19,31,-1,-1,0,18,11,7,0.42105263157894735,19,24,-1,-1,0,32,28,4,0.2631578947368421,0,0,0,0,0,0,0,0,0.4,0.6,7,0,0,0,0.15789473684210525,3
1993-12-13,Norwich,Leeds,2,1,H,17,28,-1,-1,0,27,18,9,0.4117647058823529,19,36,-1,-1,0,33,21,12,0.5263157894736842,0,0,0,0,1,0,0,0,0.2,0.6,-8,0,0,0,-0.11455108359133126,-3
1993-12-18,Blackburn,Man City,2,0,H,19,35,-1,-1,0,26,17,9,0.5263157894736842,20,19,-1,-1,0,19,25,-6,0.2,0,0,0,0,0,0,0,0,0.8,0.2,16,0,0,0,0.32631578947368417,15
1993-12-18,Coventry,Oldham,1,1,D,19,23,-1,-1,0,20,23,-3,0.2631578947368421,20,18,-1,-1,0,15,31,-16,0.2,0,0,0,0,0,0,0,0,0.2,0.4,5,0,0,0,0.06315789473684208,13
1993-12-18,Everton,Newcastle,0,2,A,20,25,-1,-1,0,20,24,-4,0.35,19,32,-1,-1,0,35,19,16,0.47368421052631576,0,0,0,0,0,0,0,0,0.2,0.6,-7,0,0,0,-0.12368421052631579,-20
1993-12-18,Ipswich,Norwich,2,1,H,20,26,-1,-1,0,18,23,-5,0.3,18,31,-1,-1,0,29,19,10,0.4444444444444444,0,0,0,0,0,0,0,0,0.4,0.4,-5,0,0,0,-0.14444444444444443,-15
1993-12-18,Leeds,Arsenal,2,1,H,20,36,-1,-1,0,34,23,11,0.5,20,34,-1,-1,0,19,11,8,0.45,0,0,0,0,0,0,0,0,0.6,0.4,2,0,0,0,0.04999999999999999,3
1993-12-18,Sheffield Weds,West Ham,5,0,H,20,24,-1,-1,0,32,29,3,0.25,20,29,-1,-1,0,18,20,-2,0.4,0,0,0,0,0,0,0,0,0.6,0.6,-5,0,0,0,-0.15000000000000002,5
1993-12-18,Swindon,Southampton,2,1,H,20,11,-1,-1,0,17,42,-25,0.05,20,14,-1,-1,0,18,31,-13,0.2,0,0,0,0,0,0,1,0,0.2,0.2,-3,0,0,0,-0.15000000000000002,-12
1993-12-18,Tottenham,Liverpool,3,3,D,20,26,-1,-1,0,26,21,5,0.3,19,30,-1,-1,0,30,23,7,0.47368421052631576,0,0,0,0,0,0,0,0,0.2,0.4,-4,0,0,0,-0.17368421052631577,-2
1993-12-18,Wimbledon,Sheffield United,2,0,H,19,25,-1,-1,0,21,26,-5,0.3157894736842105,20,17,-1,-1,0,18,31,-13,0.15,0,0,0,0,0,0,0,0,0.2,0.2,8,0,0,0,0.16578947368421051,8
1993-12-19,Man United,Aston Villa,3,1,H,20,49,-1,-1,0,40,16,24,0.75,20,31,-1,-1,0,23,20,3,0.4,0,0,0,0,0,0,0,0,0.4,0.0,18,0,0,0,0.35,21
1993-12-22,Newcastle,Leeds,1,1,D,20,35,-1,-1,0,37,19,18,0.5,21,39,-1,-1,0,36,24,12,0.5238095238095238,0,0,0,0,0,0,0,0,0.6,0.8,-4,0,0,0,-0.023809523809523836,6
1993-12-26,Man United,Blackburn,1,1,D,21,52,-1,-1,0,43,17,26,0.7619047619047619,20,38,-1,-1,0,28,17,11,0.55,0,0,0,0,1,0,0,0,0.6,0.8,14,0,0,0,0.21190476190476182,15
1993-12-26,Sheffield United,Liverpool,0,0,D,21,17,-1,-1,0,18,33,-15,0.14285714285714285,20,31,-1,-1,0,33,26,7,0.45,0,0,0,0,0,0,0,0,0.2,0.4,-14,0,0,0,-0.30714285714285716,-22
1993-12-26,Wimbledon,Coventry,1,2,A,20,28,-1,-1,0,23,26,-3,0.35,20,24,-1,-1,0,21,24,-3,0.25,0,0,0,0,0,0,0,0,0.4,0.2,4,0,0,0,0.09999999999999998,0
1993-12-27,Everton,Sheffield Weds,0,2,A,21,25,-1,-1,0,20,26,-6,0.3333333333333333,21,27,-1,-1,0,37,29,8,0.2857142857142857,0,0,0,0,0,0,0,0,0.2,0.6,-2,0,0,0,0.047619047619047616,-14
1993-12-27,Ipswich,West Ham,1,1,D,21,29,-1,-1,0,20,24,-4,0.3333333333333333,21,29,-1,-1,0,18,25,-7,0.38095238095238093,0,0,0,0,0,0,0,0,0.6,0.6,0,0,0,0,-0.047619047619047616,3
1993-12-27,QPR,Oldham,2,0,H,20,31,-1,-1,0,34,28,6,0.45,21,19,-1,-1,0,16,32,-16,0.19047619047619047,0,0,0,0,0,0,0,0,0.2,0.4,12,0,0,0,0.25952380952380955,22
1993-12-27,Southampton,Chelsea,3,1,H,21,14,-1,-1,0,19,33,-14,0.19047619047619047,19,15,-1,-1,0,12,22,-10,0.15789473684210525,0,0,1,1,0,0,0,0,0.0,0.0,-1,0,0,0,0.03258145363408521,-4
1993-12-27,Swindon,Arsenal,0,4,A,21,14,-1,-1,0,19,43,-24,0.09523809523809523,21,34,-1,-1,0,20,13,7,0.42857142857142855,0,0,0,0,0,0,0,0,0.2,0.4,-20,0,0,0,-0.3333333333333333,-31
1993-12-27,Tottenham,Norwich,1,3,A,21,27,-1,-1,0,29,24,5,0.2857142857142857,19,31,-1,-1,0,30,21,9,0.42105263157894735,0,0,0,0,0,0,0,0,0.2,0.2,-4,0,0,0,-0.13533834586466165,-4
1993-12-28,Chelsea,Newcastle,1,0,H,20,15,-1,-1,0,13,25,-12,0.15,21,36,-1,-1,0,38,20,18,0.47619047619047616,0,0,0,0,0,0,0,0,0.0,0.4,-21,0,0,0,-0.32619047619047614,-30
1993-12-28,Liverpool,Wimbledon,1,1,D,21,32,-1,-1,0,33,26,7,0.42857142857142855,21,28,-1,-1,0,24,28,-4,0.3333333333333333,0,0,0,0,0,0,0,0,0.2,0.4,4,0,0,0,0.09523809523809523,11
1993-12-28,Man City,Southampton,1,1,D,21,19,-1,-1,0,19,27,-8,0.19047619047619047,22,17,-1,-1,0,22,34,-12,0.22727272727272727,0,0,0,0,0,0,0,0,0.2,0.2,2,0,0,0,-0.0367965367965368,4
1993-12-28,West Ham,Tottenham,1,3,A,22,30,-1,-1,0,19,26,-7,0.36363636363636365,22,27,-1,-1,0,30,27,3,0.2727272727272727,0,0,0,0,0,0,0,0,0.4,0.2,3,0,0,0,0.09090909090909094,-10
1993-12-29,Arsenal,Sheffield United,3,0,H,22,37,-1,-1,0,24,13,11,0.45454545454545453,22,18,-1,-1,0,18,33,-15,0.13636363636363635,0,0,0,0,0,0,0,0,0.4,0.0,19,0,0,0,0.3181818181818182,26
1993-12-29,Blackburn,Everton,2,0,H,21,39,-1,-1,0,29,18,11,0.5238095238095238,22,25,-1,-1,0,20,28,-8,0.3181818181818182,0,0,0,0,0,0,0,0,0.6,0.2,14,0,0,0,0.20562770562770566,19
1993-12-29,Leeds,QPR,1,1,D,22,40,-1,-1,0,37,25,12,0.5,21,34,-1,-1,0,36,28,8,0.47619047619047616,0,0,0,0,0,0,0,0,0.6,0.4,6,0,0,0,0.023809523809523836,4
1993-12-29,Norwich,Aston Villa,1,2,A,20,34,-1,-1,0,33,22,11,0.45,21,31,-1,-1,0,24,23,1,0.38095238095238093,0,0,0,0,0,0,0,0,0.4,0.0,3,0,0,0,0.06904761904761908,10
1993-12-29,Oldham,Man United,2,5,A,22,19,-1,-1,0,16,34,-18,0.18181818181818182,22,53,-1,-1,0,44,18,26,0.7272727272727273,0,0,0,0,0,0,0,0,0.2,0.4,-34,0,0,0,-0.5454545454545454,-44
1993-12-29,Sheffield Weds,Swindon,3,3,D,22,30,-1,-1,0,39,29,10,0.3181818181818182,22,14,-1,-1,0,19,47,-28,0.09090909090909091,0,0,0,0,0,0,0,0,0.6,0.2,16,0,0,0,0.22727272727272727,38
1994-01-01,Aston Villa,Blackburn,0,1,A,22,34,-1,-1,0,26,24,2,0.4090909090909091,22,42,-1,-1,0,31,18,13,0.5454545454545454,0,0,0,0,0,0,0,0,0.2,0.8,-8,0,0,0,-0.1363636363636363,-11
1994-01-01,Everton,West Ham,0,1,A,23,25,-1,-1,0,20,30,-10,0.30434782608695654,23,30,-1,-1,0,20,29,-9,0.34782608695652173,0,0,1,0,0,0,0,0,0.0,0.2,-5,0,0,0,-0.04347826086956519,-1
1994-01-01,Ipswich,Liverpool,1,2,A,22,30,-1,-1,0,21,25,-4,0.3181818181818182,22,33,-1,-1,0,34,27,7,0.4090909090909091,0,0,0,0,0,0,0,0,0.4,0.2,-3,0,0,0,-0.09090909090909094,-11
1994-01-01,Man United,Leeds,0,0,D,23,56,-1,-1,0,49,20,29,0.7391304347826086,23,41,-1,-1,0,38,26,12,0.4782608695652174,0,0,0,0,0,0,0,0,0.6,0.4,15,0,0,0,0.26086956521739124,17
1994-01-01,Newcastle,Man City,2,0,H,22,36,-1,-1,0,38,21,17,0.45454545454545453,22,20,-1,-1,0,20,28,-8,0.18181818181818182,0,0,0,0,0,0,0,0,0.4,0.2,16,0,0,0,0.2727272727272727,25
1994-01-01,QPR,Sheffield Weds,1,2,A,22,35,-1,-1,0,37,29,8,0.45454545454545453,23,31,-1,-1,0,42,32,10,0.30434782608695654,0,0,0,0,0,0,0,0,0.4,0.4,4,0,0,0,0.150197628458498,-2
1994-01-01,Sheffield United,Oldham,2,1,H,23,18,-1,-1,0,18,36,-18,0.13043478260869565,23,19,-1,-1,0,18,39,-21,0.17391304347826086,0,0,0,0,0,0,0,0,0.0,0.2,-1,0,0,0,-0.043478260869565216,3
1994-01-01,Southampton,Norwich,0,1,A,23,18,-1,-1,0,23,35,-12,0.21739130434782608,21,34,-1,-1,0,34,24,10,0.42857142857142855,0,0,0,0,0,0,0,0,0.2,0.4,-16,0,0,0,-0.21118012422360247,-22
1994-01-01,Swindon,Chelsea,1,3,A,23,15,-1,-1,0,22,50,-28,0.08695652173913043,21,18,-1,-1,0,14,25,-11,0.19047619047619047,0,0,0,0,0,0,0,0,0.2,0.2,-3,0,0,0,-0.10351966873706003,-17
1994-01-01,Tottenham,Coventry,1,2,A,23,30,-1,-1,0,33,28,5,0.30434782608695654,21,27,-1,-1,0,23,25,-2,0.2857142857142857,0,0,0,0,0,0,0,0,0.4,0.4,3,0,0,0,0.018633540372670843,7
1994-01-01,Wimbledon,Arsenal,0,3,A,22,29,-1,-1,0,25,29,-4,0.3181818181818182,23,40,-1,-1,0,27,13,14,0.4782608695652174,0,0,0,0,0,0,0,0,0.4,0.6,-11,0,0,0,-0.16007905138339923,-18
1994-01-03,Arsenal,QPR,0,0,D,24,43,-1,-1,0,30,13,17,0.5,23,35,-1,-1,0,38,31,7,0.43478260869565216,1,0,0,0,0,0,0,0,0.8,0.4,8,0,0,0,0.06521739130434784,10
1994-01-03,Chelsea,Everton,4,2,H,22,21,-1,-1,0,17,26,-9,0.22727272727272727,24,25,-1,-1,0,20,31,-11,0.2916666666666667,0,0,0,0,0,0,1,0,0.4,0.0,-4,0,0,0,-0.06439393939393942,2
1994-01-03,Coventry,Swindon,1,1,D,22,30,-1,-1,0,25,26,-1,0.3181818181818182,24,15,-1,-1,0,23,53,-30,0.08333333333333333,0,0,0,0,0,0,0,0,0.6,0.2,15,0,0,0,0.23484848484848486,29
1994-01-03,Sheffield Weds,Tottenham,1,0,H,24,34,-1,-1,0,44,33,11,0.3333333333333333,24,30,-1,-1,0,34,30,4,0.2916666666666667,0,0,0,0,0,0,0,0,0.6,0.4,4,0,0,0,0.04166666666666663,7
1994-01-03,West Ham,Sheffield United,0,0,D,24,33,-1,-1,0,21,29,-8,0.375,24,21,-1,-1,0,20,37,-17,0.16666666666666666,0,0,0,0,0,0,0,0,0.4,0.2,12,0,0,0,0.20833333333333334,9
1994-01-04,Liverpool,Man United,3,3,D,23,36,-1,-1,0,36,28,8,0.43478260869565216,24,57,-1,-1,0,49,20,29,0.7083333333333334,0,0,0,0,0,0,0,0,0.2,0.4,-21,0,0,0,-0.2735507246376812,-21
1994-01-04,Norwich,Newcastle,1,2,A,22,37,-1,-1,0,35,24,11,0.45454545454545453,23,39,-1,-1,0,40,21,19,0.4782608695652174,0,0,0,0,0,0,0,0,0.6,0.4,-2,0,0,0,-0.023715415019762875,-8
1994-01-15,Aston Villa,West Ham,3,1,H,23,34,-1,-1,0,26,25,1,0.391304347826087,25,34,-1,-1,0,21,29,-8,0.36,0,0,0,0,0,0,0,0,0.2,0.2,0,0,0,0,0.03130434782608699,9
1994-01-15,Everton,Swindon,6,2,H,25,25,-1,-1,0,22,35,-13,0.28,25,16,-1,-1,0,24,54,-30,0.08,0,0,1,1,0,0,0,0,0.0,0.2,9,0,0,0,0.2,17
1994-01-15,Leeds,Ipswich,0,0,D,24,42,-1,-1,0,38,26,12,0.4583333333333333,23,30,-1,-1,0,22,27,-5,0.30434782608695654,0,0,0,0,0,0,0,0,0.2,0.4,12,0,0,0,0.15398550724637677,17
1994-01-15,Man City,Arsenal,0,0,D,23,20,-1,-1,0,20,30,-10,0.17391304347826086,25,44,-1,-1,0,30,13,17,0.48,0,0,0,0,0,0,0,0,0.2,0.6,-24,0,0,0,-0.3060869565217391,-27
1994-01-15,Norwich,Chelsea,1,1,D,23,37,-1,-1,0,36,26,10,0.43478260869565216,23,24,-1,-1,0,21,28,-7,0.2608695652173913,0,0,0,0,1,0,0,0,0.4,0.6,13,0,0,0,0.17391304347826086,17
1994-01-15,Oldham,Liverpool,0,3,A,24,19,-1,-1,0,19,41,-22,0.16666666666666666,24,37,-1,-1,0,39,31,8,0.4166666666666667,0,0,1,0,0,0,0,0,0.0,0.2,-18,0,0,0,-0.25,-30
1994-01-15,Sheffield United,Blackburn,1,2,A,25,22,-1,-1,0,20,37,-17,0.16,23,45,-1,-1,0,32,18,14,0.5652173913043478,0,0,0,0,0,0,0,0,0.2,0.8,-23,0,0,0,-0.40521739130434775,-31
1994-01-15,Southampton,Coventry,1,0,H,24,18,-1,-1,0,23,36,-13,0.20833333333333334,23,31,-1,-1,0,26,27,-1,0.30434782608695654,0,0,0,0,0,0,0,0,0.2,0.4,-13,0,0,0,-0.0960144927536232,-12
1994-01-15,Tottenham,Man United,0,1,A,25,30,-1,-1,0,34,31,3,0.28,25,58,-1,-1,0,52,23,29,0.68,0,0,0,0,0,0,0,0,0.2,0.4,-28,0,0,0,-0.4,-26
1994-01-15,Wimbledon,Sheffield Weds,2,1,H,23,29,-1,-1,0,25,32,-7,0.30434782608695654,25,37,-1,-1,0,45,33,12,0.36,0,0,0,0,0,0,0,0,0.4,0.8,-8,0,0,0,-0.055652173913043446,-19
1994-01-16,QPR,Newcastle,1,2,A,24,36,-1,-1,0,38,31,7,0.4166666666666667,24,42,-1,-1,0,42,22,20,0.5,0,0,0,0,0,0,0,0,0.4,0.6,-6,0,0,0,-0.08333333333333331,-13
1994-01-22,Arsenal,Oldham,1,1,D,26,45,-1,-1,0,30,13,17,0.46153846153846156,25,19,-1,-1,0,19,44,-25,0.16,0,0,0,0,0,0,1,0,0.6,0.0,26,0,0,0,0.30153846153846153,42
1994-01-22,Chelsea,Aston Villa,1,1,D,24,25,-1,-1,0,22,29,-7,0.25,24,37,-1,-1,0,29,26,3,0.4166666666666667,0,0,0,0,0,0,0,0,0.6,0.4,-12,0,0,0,-0.16666666666666669,-10
1994-01-22,Coventry,QPR,0,1,A,24,31,-1,-1,0,26,28,-2,0.2916666666666667,25,36,-1,-1,0,39,33,6,0.4,0,0,0,0,0,0,0,0,0.4,0.2,-5,0,0,0,-0.10833333333333334,-8
1994-01-22,Ipswich,Wimbledon,0,0,D,24,31,-1,-1,0,22,27,-5,0.2916666666666667,24,32,-1,-1,0,27,33,-6,0.3333333333333333,0,0,0,0,0,0,0,0,0.2,0.4,-1,0,0,0,-0.04166666666666663,1
1994-01-22,Liverpool,Man City,2,1,H,25,40,-1,-1,0,42,31,11,0.44,24,21,-1,-1,0,20,30,-10,0.16666666666666666,0,0,0,0,0,0,0,0,0.4,0.0,19,0,0,0,0.2733333333333333,21
1994-01-22,Man United,Everton,1,0,H,26,61,-1,-1,0,53,23,30,0.6923076923076923,26,28,-1,-1,0,28,37,-9,0.3076923076923077,0,0,0,0,0,0,0,0,0.4,0.2,33,0,0,0,0.3846153846153846,39
1994-01-22,Newcastle,Southampton,1,2,A,25,45,-1,-1,0,44,23,21,0.52,25,21,-1,-1,0,24,36,-12,0.24,1,0,0,0,0,0,0,0,0.6,0.4,24,0,0,0,0.28,33
1994-01-22,Sheffield Weds,Sheffield United,3,1,H,26,37,-1,-1,0,46,35,11,0.34615384615384615,26,22,-1,-1,0,21,39,-18,0.15384615384615385,0,0,0,0,0,0,0,0,0.6,0.2,15,0,0,0,0.1923076923076923,29
1994-01-22,Swindon,Tottenham,2,1,H,26,16,-1,-1,0,26,60,-34,0.07692307692307693,26,30,-1,-1,0,34,32,2,0.2692307692307692,0,0,0,0,0,0,1,0,0.0,0.2,-14,0,0,0,-0.1923076923076923,-36
1994-01-23,Blackburn,Leeds,2,1,H,24,48,-1,-1,0,34,19,15,0.5833333333333334,25,43,-1,-1,0,38,26,12,0.44,1,0,0,0,0,0,0,0,0.8,0.2,5,0,0,0,0.14333333333333337,3
1994-01-24,West Ham,Norwich,3,3,D,26,34,-1,-1,0,22,32,-10,0.34615384615384615,24,38,-1,-1,0,37,27,10,0.4166666666666667,0,0,0,0,0,0,0,0,0.2,0.4,-4,0,0,0,-0.07051282051282054,-20
1994-02-02,Coventry,Ipswich,1,0,H,25,31,-1,-1,0,26,29,-3,0.28,25,32,-1,-1,0,22,27,-5,0.28,0,0,0,0,0,0,0,0,0.4,0.2,-1,0,0,0,0.0,2
1994-02-05,Blackburn,Wimbledon,3,0,H,25,51,-1,-1,0,36,20,16,0.6,25,33,-1,-1,0,27,33,-6,0.32,1,0,0,0,0,0,0,0,0.8,0.2,18,0,0,0,0.27999999999999997,22
1994-02-05,Everton,Chelsea,4,2,H,27,28,-1,-1,0,28,38,-10,0.2962962962962963,25,26,-1,-1,0,23,30,-7,0.24,0,0,0,0,0,0,0,0,0.2,0.6,2,0,0,0,0.05629629629629629,-3
1994-02-05,Man City,Ipswich,2,1,H,25,21,-1,-1,0,21,32,-11,0.16,26,32,-1,-1,0,22,28,-6,0.2692307692307692,0,0,0,0,0,0,0,0,0.0,0.0,-11,0,0,0,-0.10923076923076921,-5
1994-02-05,Norwich,Liverpool,2,2,D,25,39,-1,-1,0,40,30,10,0.4,26,43,-1,-1,0,44,32,12,0.46153846153846156,0,0,0,0,0,0,0,0,0.2,0.6,-4,0,0,0,-0.06153846153846154,-2
1994-02-05,Oldham,Southampton,2,1,H,26,20,-1,-1,0,20,45,-25,0.15384615384615385,26,24,-1,-1,0,26,37,-11,0.2692307692307692,0,0,0,0,0,0,0,0,0.0,0.6,-4,0,0,0,-0.11538461538461536,-14
1994-02-05,QPR,Man United,2,3,A,26,39,-1,-1,0,40,33,7,0.4230769230769231,27,64,-1,-1,0,54,23,31,0.7037037037037037,0,0,0,0,0,0,0,0,0.2,0.6,-25,0,0,0,-0.28062678062678065,-24
1994-02-05,Swindon,Coventry,3,1,H,27,19,-1,-1,0,28,61,-33,0.1111111111111111,26,34,-1,-1,0,27,29,-2,0.3076923076923077,0,0,0,0,0,0,0,0,0.2,0.4,-15,0,0,0,-0.1965811965811966,-31
1994-02-05,Tottenham,Sheffield Weds,1,3,A,27,30,-1,-1,0,35,34,1,0.25925925925925924,27,40,-1,-1,0,49,36,13,0.37037037037037035,0,0,1,0,0,0,0,0,0.2,0.6,-10,0,0,0,-0.1111111111111111,-12
1994-02-06,Aston Villa,Leeds,1,0,H,25,38,-1,-1,0,30,27,3,0.4,26,43,-1,-1,0,39,28,11,0.4230769230769231,0,0,0,0,0,0,0,0,0.4,0.0,-5,0,0,0,-0.02307692307692305,-8
1994-02-12,Aston Villa,Swindon,5,0,H,26,41,-1,-1,0,31,27,4,0.4230769230769231,28,22,-1,-1,0,31,62,-31,0.14285714285714285,0,0,0,0,0,0,0,0,0.6,0.4,19,0,0,0,0.2802197802197802,35
1994-02-12,Everton,Ipswich,0,0,D,28,31,-1,-1,0,32,40,-8,0.32142857142857145,27,32,-1,-1,0,23,30,-7,0.25925925925925924,0,0,0,0,0,0,0,0,0.4,0.0,-1,0,0,0,0.06216931216931221,-1
1994-02-12,Man City,West Ham,0,0,D,26,24,-1,-1,0,23,33,-10,0.19230769230769232,27,35,-1,-1,0,25,35,-10,0.3333333333333333,0,0,0,0,0,0,0,0,0.2,0.2,-11,0,0,0,-0.141025641025641,0
1994-02-12,Oldham,Chelsea,2,1,H,27,23,-1,-1,0,22,46,-24,0.18518518518518517,26,26,-1,-1,0,25,34,-9,0.23076923076923078,0,0,0,0,0,0,0,0,0.2,0.4,-3,0,0,0,-0.04558404558404561,-15
1994-02-12,Sheffield United,Coventry,0,0,D,27,22,-1,-1,0,22,42,-20,0.14814814814814814,27,34,-1,-1,0,28,32,-4,0.2962962962962963,0,0,0,0,0,0,0,0,0.2,0.2,-12,0,0,0,-0.14814814814814814,-16
1994-02-12,Tottenham,Blackburn,0,2,A,28,30,-1,-1,0,36,37,-1,0.25,26,54,-1,-1,0,39,20,19,0.6153846153846154,0,0,1,1,1,1,0,0,0.0,1.0,-24,0,0,0,-0.3653846153846154,-20
1994-02-12,Wimbledon,Newcastle,4,2,H,26,33,-1,-1,0,27,36,-9,0.3076923076923077,26,45,-1,-1,0,45,25,20,0.5,0,0,0,0,0,0,0,0,0.2,0.6,-12,0,0,0,-0.1923076923076923,-29
1994-02-13,Norwich,Arsenal,1,1,D,26,40,-1,-1,0,42,32,10,0.38461538461538464,27,46,-1,-1,0,31,14,17,0.4444444444444444,0,0,0,0,0,0,0,0,0.2,0.4,-6,0,0,0,-0.05982905982905978,-7
1994-02-14,Southampton,Liverpool,4,2,H,27,24,-1,-1,0,27,39,-12,0.25925925925925924,27,44,-1,-1,0,46,34,12,0.4444444444444444,0,0,0,0,0,0,0,0,0.4,0.6,-20,0,0,0,-0.18518518518518517,-24
1994-02-19,Blackburn,Newcastle,1,0,H,27,57,-1,-1,0,41,20,21,0.6296296296296297,27,45,-1,-1,0,47,29,18,0.48148148148148145,1,1,0,0,0,0,0,0,1.0,0.6,12,0,0,0,0.1481481481481482,3
1994-02-19,Coventry,Man City,4,0,H,28,35,-1,-1,0,28,32,-4,0.2857142857142857,27,25,-1,-1,0,23,33,-10,0.18518518518518517,0,0,0,0,0,0,0,0,0.2,0.2,10,0,0,0,0.10052910052910052,6
1994-02-19,Everton,Arsenal,1,1,D,29,32,-1,-1,0,32,40,-8,0.3103448275862069,28,47,-1,-1,0,32,15,17,0.42857142857142855,0,0,0,0,0,0,0,0,0.4,0.2,-15,0,0,0,-0.11822660098522164,-25
1994-02-19,Leeds,Liverpool,2,0,H,27,43,-1,-1,0,39,29,10,0.4074074074074074,28,44,-1,-1,0,48,38,10,0.42857142857142855,0,0,0,0,0,0,0,0,0.0,0.4,-1,0,0,0,-0.021164021164021163,0
1994-02-19,Swindon,Norwich,3,3,D,29,22,-1,-1,0,31,67,-36,0.13793103448275862,27,41,-1,-1,0,43,33,10,0.37037037037037035,0,0,0,0,0,0,0,0,0.4,0.0,-19,0,0,0,-0.23243933588761173,-46
1994-02-22,Aston Villa,Man City,0,0,D,27,44,-1,-1,0,36,27,9,0.4444444444444444,28,25,-1,-1,0,23,37,-14,0.17857142857142858,0,0,0,0,0,0,0,0,0.6,0.2,19,0,0,0,0.2658730158730158,23
1994-02-22,Norwich,Blackburn,2,2,D,28,42,-1,-1,0,46,36,10,0.35714285714285715,28,60,-1,-1,0,42,20,22,0.6428571428571429,0,0,0,0,1,1,0,0,0.0,1.0,-18,0,0,0,-0.28571428571428575,-12
1994-02-23,Newcastle,Coventry,4,0,H,28,45,-1,-1,0,47,30,17,0.4642857142857143,29,38,-1,-1,0,32,32,0,0.3103448275862069,0,0,1,0,0,0,0,0,0.4,0.4,7,0,0,0,0.1539408866995074,17
1994-02-26,Arsenal,Blackburn,1,0,H,29,48,-1,-1,0,33,16,17,0.41379310344827586,29,61,-1,-1,0,44,22,22,0.6206896551724138,0,0,0,0,0,0,0,0,0.0,0.8,-13,0,0,0,-0.20689655172413796,-5
1994-02-26,Ipswich,Sheffield United,3,2,H,28,33,-1,-1,0,23,30,-7,0.25,28,23,-1,-1,0,22,42,-20,0.14285714285714285,0,0,0,0,0,0,0,0,0.0,0.2,10,0,0,0,0.10714285714285715,13
1994-02-26,Liverpool,Coventry,1,0,H,29,44,-1,-1,0,48,40,8,0.41379310344827586,30,38,-1,-1,0,32,36,-4,0.3,0,0,0,0,0,0,0,0,0.4,0.4,6,0,0,0,0.11379310344827587,12
1994-02-26,Man City,Swindon,2,1,H,29,26,-1,-1,0,23,37,-14,0.1724137931034483,30,23,-1,-1,0,34,70,-36,0.13333333333333333,0,0,0,0,0,0,0,0,0.2,0.4,3,0,0,0,0.039080459770114956,22
1994-02-26,Norwich,Sheffield Weds,1,1,D,29,43,-1,-1,0,48,38,10,0.3448275862068966,28,43,-1,-1,0,52,37,15,0.39285714285714285,0,0,0,0,0,0,0,0,0.0,0.8,0,0,0,0,-0.048029556650246275,-5
1994-02-26,Southampton,Wimbledon,1,0,H,28,27,-1,-1,0,31,41,-10,0.2857142857142857,27,36,-1,-1,0,31,38,-7,0.3333333333333333,0,0,0,0,0,0,0,0,0.6,0.4,-9,0,0,0,-0.047619047619047616,-3
1994-02-26,West Ham,Man United,2,2,D,28,36,-1,-1,0,25,35,-10,0.32142857142857145,28,67,-1,-1,0,57,25,32,0.7142857142857143,0,0,0,0,1,0,0,0,0.2,0.6,-31,0,0,0,-0.39285714285714285,-42
1994-02-27,Chelsea,Tottenham,4,3,H,27,26,-1,-1,0,26,36,-10,0.2222222222222222,29,30,-1,-1,0,36,39,-3,0.2413793103448276,0,0,0,0,0,0,1,1,0.2,0.0,-4,0,0,0,-0.019157088122605387,-7
1994-02-28,Oldham,Leeds,1,1,D,28,26,-1,-1,0,24,47,-23,0.21428571428571427,28,46,-1,-1,0,41,29,12,0.42857142857142855,0,0,0,0,0,0,0,0,0.4,0.2,-20,0,0,0,-0.21428571428571427,-35
1994-03-02,Tottenham,Aston Villa,1,1,D,30,30,-1,-1,0,39,43,-4,0.23333333333333334,28,45,-1,-1,0,36,27,9,0.42857142857142855,0,0,1,1,0,0,0,0,0.0,0.6,-15,0,0,0,-0.1952380952380952,-13
1994-03-05,Blackburn,Liverpool,2,0,H,30,61,-1,-1,0,44,23,21,0.6,30,47,-1,-1,0,49,40,9,0.43333333333333335,0,0,0,0,0,0,0,0,0.6,0.4,14,0,0,0,0.16666666666666663,12
1994-03-05,Everton,Oldham,2,1,H,30,33,-1,-1,0,33,41,-8,0.3,29,27,-1,-1,0,25,48,-23,0.20689655172413793,0,0,0,0,0,0,0,0,0.4,0.4,6,0,0,0,0.09310344827586206,15
1994-03-05,Ipswich,Arsenal,1,5,A,29,36,-1,-1,0,26,32,-6,0.27586206896551724,30,51,-1,-1,0,34,16,18,0.43333333333333335,0,0,0,0,0,0,0,0,0.2,0.2,-15,0,0,0,-0.1574712643678161,-24
1994-03-05,Leeds,Southampton,0,0,D,29,47,-1,-1,0,42,30,12,0.41379310344827586,29,30,-1,-1,0,32,41,-9,0.3103448275862069,0,0,0,0,0,0,0,0,0.2,0.8,17,0,0,0,0.10344827586206895,21
1994-03-05,Man United,Chelsea,0,1,A,29,68,-1,-1,0,59,27,32,0.6896551724137931,28,29,-1,-1,0,30,39,-9,0.25,0,0,0,0,0,0,0,0,0.6,0.2,39,0,0,0,0.43965517241379315,41
1994-03-05,QPR,Man City,1,1,D,27,39,-1,-1,0,42,36,6,0.4074074074074074,30,29,-1,-1,0,25,38,-13,0.2,0,0,0,0,0,0,0,0,0.2,0.4,10,0,0,0,0.20740740740740737,19
1994-03-05,Sheffield Weds,Newcastle,0,1,A,29,44,-1,-1,0,53,38,15,0.3793103448275862,29,48,-1,-1,0,51,30,21,0.4827586206896552,0,0,0,0,0,0,0,0,0.6,0.4,-4,0,0,0,-0.103448275862069,-6
1994-03-05,Swindon,West Ham,1,1,D,31,23,-1,-1,0,35,72,-37,0.12903225806451613,29,37,-1,-1,0,27,37,-10,0.3103448275862069,0,0,0,0,0,0,0,0,0.4,0.0,-14,0,0,0,-0.18131256952169078,-27
1994-03-05,Tottenham,Sheffield United,2,2,D,31,31,-1,-1,0,40,44,-4,0.22580645161290322,29,23,-1,-1,0,24,45,-21,0.13793103448275862,0,0,0,0,0,0,0,0,0.0,0.0,8,0,0,0,0.0878754171301446,17
1994-03-05,Wimbledon,Norwich,3,1,H,28,36,-1,-1,0,31,39,-8,0.32142857142857145,30,44,-1,-1,0,49,39,10,0.3333333333333333,0,0,0,0,0,0,0,0,0.4,0.0,-8,0,0,0,-0.011904761904761862,-18
1994-03-06,Coventry,Aston Villa,0,1,A,31,38,-1,-1,0,32,37,-5,0.2903225806451613,29,46,-1,-1,0,37,28,9,0.41379310344827586,0,0,0,0,0,0,0,0,0.2,0.4,-8,0,0,0,-0.12347052280311455,-14
1994-03-12,Aston Villa,Ipswich,0,1,A,30,49,-1,-1,0,38,28,10,0.43333333333333335,30,36,-1,-1,0,27,37,-10,0.26666666666666666,0,0,0,0,0,0,0,0,0.6,0.2,13,0,0,0,0.16666666666666669,20
1994-03-12,Man City,Wimbledon,0,1,A,31,30,-1,-1,0,26,39,-13,0.1935483870967742,29,39,-1,-1,0,34,40,-6,0.3448275862068966,0,0,0,0,0,0,0,0,0.2,0.4,-9,0,0,0,-0.1512791991101224,-7
1994-03-12,Newcastle,Swindon,7,1,H,30,51,-1,-1,0,52,30,22,0.5,32,24,-1,-1,0,36,73,-37,0.125,0,0,0,0,0,0,0,0,0.4,0.2,27,0,0,0,0.375,59
1994-03-12,Norwich,QPR,3,4,A,31,44,-1,-1,0,50,42,8,0.3225806451612903,28,40,-1,-1,0,43,37,6,0.39285714285714285,0,0,0,0,0,0,0,0,0.0,0.2,4,0,0,0,-0.07027649769585254,2
1994-03-12,Southampton,Sheffield Weds,1,1,D,30,31,-1,-1,0,32,41,-9,0.3,30,44,-1,-1,0,53,39,14,0.36666666666666664,0,0,0,0,0,0,0,0,0.6,0.4,-13,0,0,0,-0.06666666666666665,-23
1994-03-13,Liverpool,Everton,2,1,H,31,47,-1,-1,0,49,42,7,0.41935483870967744,31,36,-1,-1,0,35,42,-7,0.3225806451612903,0,0,0,0,0,0,0,0,0.2,0.4,11,0,0,0,0.09677419354838712,14
1994-03-13,Sheffield United,Leeds,2,2,D,30,24,-1,-1,0,26,47,-21,0.13333333333333333,30,48,-1,-1,0,42,30,12,0.4,0,0,0,0,0,0,0,0,0.0,0.2,-24,0,0,0,-0.2666666666666667,-33
1994-03-16,Chelsea,Wimbledon,2,0,H,29,32,-1,-1,0,31,39,-8,0.27586206896551724,30,42,-1,-1,0,35,40,-5,0.36666666666666664,0,0,0,0,0,0,0,0,0.4,0.6,-10,0,0,0,-0.0908045977011494,-3
1994-03-16,Leeds,Aston Villa,2,0,H,31,49,-1,-1,0,44,32,12,0.3870967741935484,31,49,-1,-1,0,38,29,9,0.41935483870967744,0,0,0,0,0,0,0,0,0.2,0.4,0,0,0,0,-0.03225806451612906,3
1994-03-16,Man United,Sheffield Weds,5,0,H,30,68,-1,-1,0,59,28,31,0.6666666666666666,31,45,-1,-1,0,54,40,14,0.3548387096774194,0,0,0,0,0,0,0,0,0.6,0.4,23,0,0,0,0.31182795698924726,17
1994-03-16,Sheffield United,QPR,1,1,D,31,25,-1,-1,0,28,49,-21,0.12903225806451613,29,43,-1,-1,0,47,40,7,0.41379310344827586,0,0,0,0,0,0,0,0,0.0,0.4,-18,0,0,0,-0.28476084538375973,-28
1994-03-19,Aston Villa,Oldham,1,2,A,32,49,-1,-1,0,38,31,7,0.40625,30,27,-1,-1,0,26,50,-24,0.2,0,0,0,0,0,0,0,0,0.2,0.4,22,0,0,0,0.20625,31
1994-03-19,Leeds,Coventry,1,0,H,32,52,-1,-1,0,46,32,14,0.40625,32,38,-1,-1,0,32,38,-6,0.28125,0,0,0,0,0,0,1,0,0.4,0.2,14,0,0,0,0.125,20
1994-03-19,Liverpool,Chelsea,2,1,H,32,50,-1,-1,0,51,43,8,0.4375,30,35,-1,-1,0,33,39,-6,0.3,0,0,0,0,1,0,0,0,0.4,0.6,15,0,0,0,0.1375,14
1994-03-19,Man City,Sheffield United,0,0,D,32,30,-1,-1,0,26,40,-14,0.1875,32,26,-1,-1,0,29,50,-21,0.125,0,0,0,0,0,0,0,0,0.2,0.0,4,0,0,0,0.0625,7
1994-03-19,QPR,Wimbledon,1,0,H,30,44,-1,-1,0,48,41,7,0.4,31,42,-1,-1,0,35,42,-7,0.3548387096774194,0,0,0,0,0,0,0,0,0.4,0.6,2,0,0,0,0.04516129032258065,14
1994-03-19,Southampton,Arsenal,0,4,A,31,32,-1,-1,0,33,42,-9,0.2903225806451613,31,54,-1,-1,0,39,17,22,0.45161290322580644,0,0,0,0,0,0,0,0,0.4,0.4,-22,0,0,0,-0.16129032258064513,-31
1994-03-19,Swindon,Man United,2,2,D,33,24,-1,-1,0,37,80,-43,0.12121212121212122,31,71,-1,-1,0,64,28,36,0.6774193548387096,0,0,0,0,0,0,0,0,0.0,0.6,-47,0,0,0,-0.5562072336265884,-79
1994-03-19,Tottenham,Ipswich,1,1,D,32,32,-1,-1,0,42,46,-4,0.21875,31,39,-1,-1,0,28,37,-9,0.2903225806451613,0,0,0,0,0,0,0,0,0.0,0.4,-7,0,0,0,-0.07157258064516131,5
1994-03-19,West Ham,Newcastle,2,4,A,30,38,-1,-1,0,28,38,-10,0.3,31,54,-1,-1,0,59,31,28,0.5161290322580645,0,0,0,0,1,0,0,0,0.0,0.6,-16,0,0,0,-0.2161290322580645,-38
1994-03-20,Sheffield Weds,Blackburn,1,2,A,32,45,-1,-1,0,54,45,9,0.34375,31,64,-1,-1,0,46,23,23,0.6129032258064516,0,0,0,0,0,0,0,0,0.2,0.6,-19,0,0,0,-0.2691532258064516,-14
1994-03-21,Norwich,Everton,3,0,H,32,44,-1,-1,0,53,46,7,0.3125,32,36,-1,-1,0,36,44,-8,0.3125,0,0,0,0,0,0,0,0,0.0,0.4,8,0,0,0,0.0,15
1994-03-22,Arsenal,Man United,2,2,D,32,57,-1,-1,0,43,17,26,0.46875,32,72,-1,-1,0,66,30,36,0.65625,1,0,0,0,0,0,0,0,0.6,0.4,-15,0,0,0,-0.1875,-10
1994-03-22,Newcastle,Ipswich,2,0,H,32,57,-1,-1,0,63,33,30,0.53125,32,40,-1,-1,0,29,38,-9,0.28125,1,0,0,0,0,0,0,0,0.8,0.4,17,0,0,0,0.25,39
1994-03-26,Arsenal,Liverpool,1,0,H,33,58,-1,-1,0,45,19,26,0.45454545454545453,33,53,-1,-1,0,53,44,9,0.45454545454545453,0,0,0,0,0,0,0,0,0.6,0.6,5,0,0,0,0.0,17
1994-03-26,Blackburn,Swindon,3,1,H,32,67,-1,-1,0,48,24,24,0.625,34,25,-1,-1,0,39,82,-43,0.11764705882352941,0,0,0,0,0,0,0,0,0.6,0.0,42,0,0,0,0.5073529411764706,67
1994-03-26,Chelsea,West Ham,2,0,H,31,35,-1,-1,0,34,41,-7,0.2903225806451613,31,38,-1,-1,0,30,42,-12,0.2903225806451613,0,0,0,0,0,0,0,0,0.6,0.0,-3,0,0,0,0.0,5
1994-03-26,Coventry,Norwich,2,1,H,33,38,-1,-1,0,32,39,-7,0.2727272727272727,33,47,-1,-1,0,56,46,10,0.3333333333333333,0,0,1,0,0,0,0,0,0.2,0.2,-9,0,0,0,-0.06060606060606061,-17
1994-03-26,Everton,Tottenham,0,1,A,33,36,-1,-1,0,36,47,-11,0.30303030303030304,33,33,-1,-1,0,43,47,-4,0.21212121212121213,0,0,0,0,0,0,0,0,0.2,0.0,3,0,0,0,0.09090909090909091,-7
1994-03-26,Ipswich,QPR,1,3,A,33,40,-1,-1,0,29,40,-11,0.2727272727272727,31,47,-1,-1,0,49,41,8,0.41935483870967744,0,0,0,0,0,0,0,0,0.4,0.4,-7,0,0,0,-0.14662756598240473,-19
1994-03-26,Oldham,Man City,0,0,D,31,30,-1,-1,0,28,51,-23,0.22580645161290322,33,31,-1,-1,0,26,40,-14,0.18181818181818182,0,0,0,0,0,0,0,0,0.6,0.2,-1,0,0,0,0.043988269794721396,-9
1994-03-26,Sheffield United,Southampton,0,0,D,33,27,-1,-1,0,29,50,-21,0.12121212121212122,32,32,-1,-1,0,33,46,-13,0.28125,0,0,0,0,0,0,0,0,0.0,0.4,-5,0,0,0,-0.16003787878787878,-8
1994-03-27,Wimbledon,Leeds,1,0,H,32,42,-1,-1,0,35,43,-8,0.34375,33,55,-1,-1,0,47,32,15,0.42424242424242425,0,0,0,0,0,0,0,0,0.4,0.4,-13,0,0,0,-0.08049242424242425,-23
1994-03-28,Sheffield United,West Ham,3,2,H,34,28,-1,-1,0,29,50,-21,0.11764705882352941,32,38,-1,-1,0,30,44,-14,0.28125,0,0,0,0,0,0,0,0,0.0,0.0,-10,0,0,0,-0.1636029411764706,-7
1994-03-29,Ipswich,Man City,2,2,D,34,40,-1,-1,0,30,43,-13,0.2647058823529412,34,32,-1,-1,0,26,40,-14,0.17647058823529413,0,0,0,0,0,0,0,0,0.2,0.2,8,0,0,0,0.08823529411764705,1
1994-03-29,Newcastle,Norwich,3,0,H,33,60,-1,-1,0,65,33,32,0.5454545454545454,34,47,-1,-1,0,57,48,9,0.3235294117647059,1,1,0,0,0,0,0,0,1.0,0.2,13,0,0,0,0.22192513368983952,23
1994-03-29,Wimbledon,Blackburn,4,1,H,33,45,-1,-1,0,36,43,-7,0.36363636363636365,33,70,-1,-1,0,51,25,26,0.6363636363636364,0,0,0,0,1,0,0,0,0.6,0.6,-25,0,0,0,-0.2727272727272727,-33
1994-03-30,Aston Villa,Everton,0,0,D,33,49,-1,-1,0,39,33,6,0.3939393939393939,34,36,-1,-1,0,36,48,-12,0.29411764705882354,0,0,1,0,0,0,1,0,0.2,0.2,13,0,0,0,0.09982174688057038,18
1994-03-30,Man United,Liverpool,1,0,H,33,73,-1,-1,0,68,32,36,0.6363636363636364,34,53,-1,-1,0,53,45,8,0.4411764705882353,0,0,0,0,0,0,0,0,0.2,0.6,20,0,0,0,0.19518716577540107,28
1994-03-30,Sheffield Weds,Chelsea,3,1,H,33,45,-1,-1,0,55,47,8,0.3333333333333333,32,38,-1,-1,0,36,41,-5,0.3125,0,0,0,0,0,0,0,0,0.0,0.8,7,0,0,0,0.020833333333333315,13
1994-03-30,Southampton,Oldham,1,3,A,33,33,-1,-1,0,33,46,-13,0.2727272727272727,32,31,-1,-1,0,28,51,-23,0.21875,0,0,0,0,0,0,0,0,0.2,0.4,2,0,0,0,0.05397727272727271,10
1994-04-01,Leeds,Newcastle,1,1,D,34,55,-1,-1,0,47,33,14,0.4117647058823529,34,63,-1,-1,0,68,33,35,0.5588235294117647,0,0,0,0,1,1,0,0,0.4,1.0,-8,0,0,0,-0.1470588235294118,-21
1994-04-02,Arsenal,Swindon,1,1,D,34,61,-1,-1,0,46,19,27,0.47058823529411764,35,25,-1,-1,0,40,85,-45,0.11428571428571428,0,0,0,0,0,0,0,0,0.8,0.0,36,0,0,0,0.3563025210084034,72
1994-04-02,Blackburn,Man United,2,0,H,34,70,-1,-1,0,52,29,23,0.6176470588235294,34,76,-1,-1,0,69,32,37,0.6470588235294118,0,0,0,0,0,0,0,0,0.6,0.4,-6,0,0,0,-0.02941176470588236,-14
1994-04-02,Chelsea,Southampton,2,0,H,33,38,-1,-1,0,37,44,-7,0.30303030303030304,34,33,-1,-1,0,34,49,-15,0.2647058823529412,0,0,0,0,0,0,0,0,0.6,0.0,5,0,0,0,0.03832442067736186,8
1994-04-02,Coventry,Wimbledon,1,2,A,34,41,-1,-1,0,34,40,-6,0.29411764705882354,34,48,-1,-1,0,40,44,-4,0.38235294117647056,0,0,0,0,0,0,0,0,0.2,0.6,-7,0,0,0,-0.08823529411764702,-2
1994-04-02,Liverpool,Sheffield United,1,2,A,35,53,-1,-1,0,53,46,7,0.42857142857142855,35,31,-1,-1,0,32,52,-20,0.14285714285714285,0,0,0,0,0,0,0,0,0.4,0.2,22,0,0,0,0.2857142857142857,27
1994-04-02,Man City,Aston Villa,3,0,H,35,33,-1,-1,0,28,42,-14,0.17142857142857143,34,50,-1,-1,0,39,33,6,0.38235294117647056,0,0,0,0,0,0,0,0,0.0,0.2,-17,0,0,0,-0.21092436974789913,-20
1994-04-02,Norwich,Tottenham,1,2,A,35,47,-1,-1,0,57,51,6,0.3142857142857143,34,36,-1,-1,0,44,47,-3,0.23529411764705882,0,0,0,0,0,0,0,0,0.2,0.2,11,0,0,0,0.07899159663865546,9
1994-04-02,Oldham,QPR,4,1,H,33,34,-1,-1,0,31,52,-21,0.24242424242424243,32,50,-1,-1,0,52,42,10,0.4375,0,0,0,0,0,0,0,0,0.4,0.6,-16,0,0,0,-0.19507575757575757,-31
1994-04-02,Sheffield Weds,Everton,5,1,H,34,48,-1,-1,0,58,48,10,0.35294117647058826,35,37,-1,-1,0,36,48,-12,0.2857142857142857,0,0,0,0,0,0,0,0,0.2,0.2,11,0,0,0,0.06722689075630256,22
1994-04-02,West Ham,Ipswich,2,1,H,33,38,-1,-1,0,32,47,-15,0.2727272727272727,35,41,-1,-1,0,32,45,-13,0.2571428571428571,0,0,1,0,0,0,0,0,0.0,0.2,-3,0,0,0,0.01558441558441559,-2
1994-04-04,Aston Villa,Norwich,0,0,D,35,50,-1,-1,0,39,36,3,0.37142857142857144,36,47,-1,-1,0,58,53,5,0.3055555555555556,0,0,0,0,0,0,1,0,0.0,0.2,3,0,0,0,0.06587301587301586,-2
1994-04-04,Everton,Blackburn,0,3,A,36,37,-1,-1,0,37,53,-16,0.2777777777777778,35,73,-1,-1,0,54,29,25,0.6285714285714286,0,0,0,0,0,0,0,0,0.0,0.8,-36,0,0,0,-0.35079365079365077,-41
1994-04-04,Ipswich,Coventry,0,2,A,36,41,-1,-1,0,33,47,-14,0.25,35,41,-1,-1,0,35,42,-7,0.2857142857142857,0,0,0,0,0,0,0,0,0.0,0.2,0,0,0,0,-0.0357142857142857,-7
1994-04-04,Man United,Oldham,3,2,H,35,76,-1,-1,0,69,34,35,0.6285714285714286,34,37,-1,-1,0,35,53,-18,0.2647058823529412,0,0,0,0,0,0,0,0,0.4,0.6,39,0,0,0,0.3638655462184874,53
1994-04-04,Newcastle,Chelsea,0,0,D,35,64,-1,-1,0,69,34,35,0.5428571428571428,34,41,-1,-1,0,39,44,-5,0.3235294117647059,0,0,0,0,0,0,0,0,0.8,0.6,23,0,0,0,0.21932773109243692,40
1994-04-04,QPR,Leeds,0,4,A,33,50,-1,-1,0,53,46,7,0.42424242424242425,35,56,-1,-1,0,48,34,14,0.4,0,0,0,0,0,0,0,0,0.6,0.4,-6,0,0,0,0.024242424242424232,-7
1994-04-04,Sheffield United,Arsenal,1,1,D,36,34,-1,-1,0,34,53,-19,0.16666666666666666,35,62,-1,-1,0,47,20,27,0.45714285714285713,0,0,0,0,0,0,0,0,0.4,0.6,-28,0,0,0,-0.29047619047619044,-46
1994-04-04,Southampton,Man City,0,1,A,35,33,-1,-1,0,34,51,-17,0.2571428571428571,36,36,-1,-1,0,31,42,-11,0.19444444444444445,0,0,0,0,0,0,0,0,0.0,0.2,-3,0,0,0,0.06269841269841267,-6
1994-04-04,Swindon,Sheffield Weds,0,1,A,36,26,-1,-1,0,41,86,-45,0.1111111111111111,35,51,-1,-1,0,63,49,14,0.37142857142857144,0,0,0,0,0,0,0,0,0.0,0.4,-25,0,0,0,-0.26031746031746034,-59
1994-04-04,Tottenham,West Ham,1,4,A,35,39,-1,-1,0,46,48,-2,0.2571428571428571,34,41,-1,-1,0,34,48,-14,0.29411764705882354,0,0,0,0,0,0,0,0,0.4,0.2,-2,0,0,0,-0.03697478991596642,12
1994-04-04,Wimbledon,Liverpool,1,1,D,35,51,-1,-1,0,42,45,-3,0.4,36,53,-1,-1,0,54,48,6,0.4166666666666667,1,0,0,0,0,0,1,0,0.6,0.4,-2,0,0,0,-0.016666666666666663,-9
1994-04-09,Coventry,Tottenham,1,0,H,36,44,-1,-1,0,37,42,-5,0.3055555555555556,36,39,-1,-1,0,47,52,-5,0.25,0,0,0,0,0,0,0,0,0.4,0.4,5,0,0,0,0.05555555555555558,0
1994-04-09,Liverpool,Ipswich,1,0,H,37,54,-1,-1,0,55,49,6,0.40540540540540543,37,41,-1,-1,0,33,49,-16,0.24324324324324326,0,0,0,0,0,0,0,0,0.2,0.0,13,0,0,0,0.16216216216216217,22
1994-04-09,Man City,Newcastle,2,1,H,37,39,-1,-1,0,32,42,-10,0.21621621621621623,36,65,-1,-1,0,69,34,35,0.5277777777777778,0,0,0,0,0,0,0,0,0.4,0.6,-26,0,0,0,-0.31156156156156156,-45
1994-04-09,Norwich,Southampton,4,5,A,37,48,-1,-1,0,58,53,5,0.2972972972972973,36,33,-1,-1,0,34,52,-18,0.25,0,0,0,0,0,0,1,0,0.2,0.0,15,0,0,0,0.047297297297297314,23
1994-04-09,Sheffield Weds,QPR,3,1,H,36,54,-1,-1,0,64,49,15,0.3888888888888889,34,50,-1,-1,0,53,50,3,0.4117647058823529,1,0,0,0,0,0,0,0,0.6,0.4,4,0,0,0,-0.022875816993464027,12
1994-04-09,West Ham,Everton,0,1,A,35,44,-1,-1,0,38,49,-11,0.3142857142857143,37,37,-1,-1,0,37,56,-19,0.2702702702702703,0,0,0,0,0,0,0,0,0.4,0.0,7,0,0,0,0.044015444015443994,8
1994-04-11,Blackburn,Aston Villa,1,0,H,36,76,-1,-1,0,57,29,28,0.6388888888888888,36,51,-1,-1,0,39,36,3,0.3611111111111111,0,0,0,0,0,0,0,0,0.8,0.0,25,0,0,0,0.27777777777777773,25
1994-04-13,QPR,Chelsea,1,1,D,35,50,-1,-1,0,54,53,1,0.4,35,42,-1,-1,0,39,44,-5,0.3142857142857143,0,0,1,0,0,0,0,0,0.4,0.4,8,0,0,0,0.08571428571428574,6
1994-04-16,Arsenal,Chelsea,1,0,H,36,63,-1,-1,0,48,21,27,0.4444444444444444,36,43,-1,-1,0,40,45,-5,0.3055555555555556,0,0,0,0,0,0,0,0,0.4,0.4,20,0,0,0,0.13888888888888884,32
1994-04-16,Coventry,Sheffield Weds,1,1,D,37,47,-1,-1,0,38,42,-4,0.32432432432432434,37,57,-1,-1,0,67,50,17,0.40540540540540543,0,0,0,0,1,0,0,0,0.6,0.8,-10,0,0,0,-0.08108108108108109,-21
1994-04-16,Ipswich,Swindon,1,1,D,38,41,-1,-1,0,33,50,-17,0.23684210526315788,37,26,-1,-1,0,41,87,-46,0.10810810810810811,0,0,1,0,0,0,0,0,0.0,0.0,15,0,0,0,0.12873399715504977,29
1994-04-16,Liverpool,Newcastle,0,2,A,38,57,-1,-1,0,56,49,7,0.42105263157894735,37,65,-1,-1,0,70,36,34,0.5135135135135135,0,0,0,0,0,0,0,0,0.2,0.4,-8,0,0,0,-0.09246088193456614,-27
1994-04-16,Man City,Norwich,1,1,D,38,42,-1,-1,0,34,43,-9,0.23684210526315788,38,48,-1,-1,0,62,58,4,0.2894736842105263,1,0,0,0,0,0,0,0,0.6,0.0,-6,0,0,0,-0.052631578947368446,-13
1994-04-16,Oldham,West Ham,1,2,A,35,37,-1,-1,0,37,56,-19,0.2571428571428571,36,44,-1,-1,0,38,50,-12,0.3055555555555556,0,0,0,0,0,0,0,0,0.6,0.4,-7,0,0,0,-0.04841269841269846,-7
1994-04-16,QPR,Everton,2,1,H,36,51,-1,-1,0,55,54,1,0.3888888888888889,38,40,-1,-1,0,38,56,-18,0.2894736842105263,0,0,0,0,0,0,0,0,0.2,0.2,11,0,0,0,0.09941520467836257,19
1994-04-16,Sheffield United,Aston Villa,1,2,A,37,35,-1,-1,0,35,54,-19,0.16216216216216217,37,51,-1,-1,0,39,37,2,0.35135135135135137,0,0,0,0,0,0,0,0,0.4,0.0,-16,0,0,0,-0.1891891891891892,-21
1994-04-16,Southampton,Blackburn,3,1,H,37,36,-1,-1,0,39,56,-17,0.2702702702702703,37,79,-1,-1,0,58,29,29,0.6486486486486487,0,0,0,0,1,0,0,0,0.2,0.8,-43,0,0,0,-0.3783783783783784,-46
1994-04-16,Wimbledon,Man United,1,0,H,36,52,-1,-1,0,43,46,-3,0.3888888888888889,36,79,-1,-1,0,72,36,36,0.6388888888888888,0,0,0,0,0,0,0,0,0.6,0.4,-27,0,0,0,-0.24999999999999994,-39
1994-04-17,Leeds,Tottenham,2,0,H,36,59,-1,-1,0,52,34,18,0.4166666666666667,37,39,-1,-1,0,47,53,-6,0.24324324324324326,0,0,0,0,0,0,0,0,0.6,0.4,20,0,0,0,0.17342342342342343,24
1994-04-19,Arsenal,Wimbledon,1,1,D,37,66,-1,-1,0,49,21,28,0.4594594594594595,37,55,-1,-1,0,44,46,-2,0.40540540540540543,0,0,0,0,0,0,0,0,0.4,0.8,11,0,0,0,0.05405405405405406,30
1994-04-23,Aston Villa,Arsenal,1,2,A,38,54,-1,-1,0,41,38,3,0.3684210526315789,38,67,-1,-1,0,50,22,28,0.4473684210526316,0,0,0,0,0,0,0,0,0.2,0.4,-13,0,0,0,-0.07894736842105265,-25
1994-04-23,Chelsea,Leeds,1,1,D,37,43,-1,-1,0,40,46,-6,0.2972972972972973,37,62,-1,-1,0,54,34,20,0.43243243243243246,0,0,0,0,0,0,0,0,0.2,0.6,-19,0,0,0,-0.13513513513513514,-26
1994-04-23,Everton,Coventry,0,0,D,39,40,-1,-1,0,39,58,-19,0.28205128205128205,38,48,-1,-1,0,39,43,-4,0.3157894736842105,0,0,0,0,0,0,0,0,0.2,0.6,-8,0,0,0,-0.03373819163292846,-15
1994-04-23,Man United,Man City,2,0,H,37,79,-1,-1,0,72,37,35,0.6216216216216216,39,43,-1,-1,0,35,44,-9,0.23076923076923078,0,0,0,0,0,0,0,0,0.4,0.6,36,0,0,0,0.3908523908523908,44
1994-04-23,Newcastle,Oldham,3,2,H,38,68,-1,-1,0,72,36,36,0.5263157894736842,36,37,-1,-1,0,38,58,-20,0.25,0,0,0,0,0,0,0,0,0.4,0.4,31,0,0,0,0.2763157894736842,56
1994-04-23,Norwich,Sheffield United,0,1,A,39,49,-1,-1,0,63,59,4,0.28205128205128205,38,35,-1,-1,0,36,56,-20,0.15789473684210525,0,0,0,0,0,0,0,0,0.0,0.4,14,0,0,0,0.1241565452091768,24
1994-04-23,Sheffield Weds,Ipswich,5,0,H,38,58,-1,-1,0,68,51,17,0.39473684210526316,39,42,-1,-1,0,34,51,-17,0.23076923076923078,0,0,0,0,0,0,0,0,0.8,0.0,16,0,0,0,0.16396761133603238,34
1994-04-23,Swindon,Wimbledon,2,4,A,38,27,-1,-1,0,42,88,-46,0.10526315789473684,38,56,-1,-1,0,45,47,-2,0.39473684210526316,0,0,0,0,0,0,0,0,0.0,0.6,-29,0,0,0,-0.2894736842105263,-44
1994-04-23,Tottenham,Southampton,3,0,H,38,39,-1,-1,0,47,55,-8,0.23684210526315788,38,39,-1,-1,0,42,57,-15,0.2894736842105263,0,0,1,0,0,0,0,0,0.4,0.4,0,0,0,0,-0.052631578947368446,7
1994-04-23,West Ham,Liverpool,1,2,A,37,47,-1,-1,0,40,51,-11,0.32432432432432434,39,57,-1,-1,0,56,51,5,0.41025641025641024,0,0,0,0,0,0,0,0,0.6,0.2,-10,0,0,0,-0.0859320859320859,-16
1994-04-24,Blackburn,QPR,1,1,D,38,79,-1,-1,0,59,32,27,0.631578947368421,37,54,-1,-1,0,57,55,2,0.40540540540540543,0,0,0,0,0,0,0,0,0.6,0.2,25,0,0,0,0.2261735419630156,25
1994-04-26,Wimbledon,Oldham,3,0,H,39,59,-1,-1,0,49,49,0,0.41025641025641024,37,37,-1,-1,0,40,61,-21,0.24324324324324326,0,0,0,0,0,0,1,0,0.6,0.4,22,0,0,0,0.16701316701316699,21
1994-04-27,Chelsea,Swindon,2,0,H,38,44,-1,-1,0,41,47,-6,0.2894736842105263,39,27,-1,-1,0,44,92,-48,0.10256410256410256,0,0,0,0,0,0,0,0,0.2,0.0,17,0,0,0,0.18690958164642377,42
1994-04-27,Leeds,Man United,0,2,A,38,63,-1,-1,0,55,35,20,0.42105263157894735,38,82,-1,-1,0,74,37,37,0.631578947368421,0,0,0,0,0,0,0,0,0.4,0.6,-19,0,0,0,-0.21052631578947367,-17
1994-04-27,Newcastle,Aston Villa,5,1,H,39,71,-1,-1,0,75,38,37,0.5384615384615384,39,54,-1,-1,0,42,40,2,0.358974358974359,0,0,0,0,0,0,0,0,0.4,0.2,17,0,0,0,0.17948717948717946,35
1994-04-27,QPR,Arsenal,1,1,D,38,55,-1,-1,0,58,56,2,0.39473684210526316,39,70,-1,-1,0,52,23,29,0.46153846153846156,0,0,0,0,0,0,0,0,0.2,0.4,-15,0,0,0,-0.0668016194331984,-27
1994-04-27,West Ham,Blackburn,1,2,A,38,47,-1,-1,0,41,53,-12,0.3157894736842105,39,80,-1,-1,0,60,33,27,0.6153846153846154,0,0,0,0,0,0,0,0,0.6,0.6,-33,0,0,0,-0.2995951417004049,-39
1994-04-30,Arsenal,West Ham,0,2,A,40,71,-1,-1,0,53,24,29,0.45,39,47,-1,-1,0,42,55,-13,0.3076923076923077,0,0,0,0,0,0,0,0,0.4,0.4,24,0,0,0,0.1423076923076923,42
1994-04-30,Leeds,Everton,3,0,H,39,63,-1,-1,0,55,37,18,0.41025641025641024,40,41,-1,-1,0,39,58,-19,0.275,0,0,0,0,0,0,0,0,0.4,0.2,22,0,0,0,0.13525641025641022,37
1994-04-30,Liverpool,Norwich,0,1,A,40,60,-1,-1,0,58,52,6,0.425,40,49,-1,-1,0,63,60,3,0.275,0,0,0,0,0,0,0,0,0.4,0.0,11,0,0,0,0.14999999999999997,3
1994-04-30,Man City,Chelsea,2,2,D,40,43,-1,-1,0,35,46,-11,0.225,39,47,-1,-1,0,43,47,-4,0.3076923076923077,0,0,0,0,0,0,0,0,0.6,0.2,-4,0,0,0,-0.0826923076923077,-7
1994-04-30,Oldham,Sheffield Weds,0,0,D,38,37,-1,-1,0,40,64,-24,0.23684210526315788,39,61,-1,-1,0,73,51,22,0.41025641025641024,0,0,1,0,0,0,0,0,0.2,0.8,-24,0,0,0,-0.17341430499325236,-46
1994-04-30,QPR,Swindon,1,3,A,39,56,-1,-1,0,59,57,2,0.38461538461538464,40,27,-1,-1,0,44,94,-50,0.1,0,0,0,0,0,0,0,0,0.2,0.0,29,0,0,0,0.2846153846153846,52
1994-04-30,Sheffield United,Newcastle,2,0,H,39,38,-1,-1,0,37,56,-19,0.1794871794871795,40,74,-1,-1,0,80,39,41,0.55,0,0,0,0,1,0,0,0,0.6,0.6,-36,0,0,0,-0.37051282051282053,-60
1994-04-30,Southampton,Aston Villa,4,1,H,39,39,-1,-1,0,42,60,-18,0.28205128205128205,40,54,-1,-1,0,43,45,-2,0.35,0,0,0,0,0,0,0,0,0.4,0.2,-15,0,0,0,-0.06794871794871793,-16
1994-04-30,Wimbledon,Tottenham,2,1,H,40,62,-1,-1,0,52,49,3,0.425,39,42,-1,-1,0,50,55,-5,0.2564102564102564,0,0,0,0,0,0,0,0,0.6,0.4,20,0,0,0,0.1685897435897436,8
1994-05-01,Ipswich,Man United,1,2,A,40,42,-1,-1,0,34,56,-22,0.225,39,85,-1,-1,0,76,37,39,0.6410256410256411,0,0,0,0,0,0,0,0,0.0,0.6,-43,0,0,0,-0.4160256410256411,-61
1994-05-02,Coventry,Blackburn,2,1,H,39,49,-1,-1,0,39,43,-4,0.3076923076923077,40,83,-1,-1,0,62,34,28,0.625,0,0,0,0,0,0,0,0,0.4,0.6,-34,0,0,0,-0.3173076923076923,-32
1994-05-03,Leeds,Sheffield Weds,2,2,D,40,66,-1,-1,0,58,37,21,0.425,40,62,-1,-1,0,73,51,22,0.4,0,0,0,0,0,0,0,0,0.6,0.6,4,0,0,0,0.024999999999999967,-1
1994-05-03,Oldham,Sheffield United,1,1,D,39,38,-1,-1,0,40,64,-24,0.23076923076923078,40,41,-1,-1,0,39,56,-17,0.2,0,0,0,0,0,0,0,0,0.0,0.6,-3,0,0,0,0.03076923076923077,-7
1994-05-03,QPR,West Ham,0,0,D,40,56,-1,-1,0,60,60,0,0.375,40,50,-1,-1,0,44,55,-11,0.325,0,0,0,0,0,0,0,0,0.2,0.4,6,0,0,0,0.04999999999999999,11
1994-05-04,Chelsea,Coventry,1,2,A,40,48,-1,-1,0,45,49,-4,0.3,40,52,-1,-1,0,41,44,-3,0.325,0,0,0,0,0,0,0,0,0.2,0.6,-4,0,0,0,-0.025000000000000022,-1
1994-05-04,Man United,Southampton,2,0,H,40,88,-1,-1,0,78,38,40,0.65,40,42,-1,-1,0,46,61,-15,0.3,1,0,0,0,0,0,0,0,0.8,0.6,46,0,0,0,0.35000000000000003,55
1994-05-05,Oldham,Tottenham,0,2,A,40,39,-1,-1,0,41,65,-24,0.225,40,42,-1,-1,0,51,57,-6,0.25,0,0,0,0,0,0,0,0,0.0,0.2,-3,0,0,0,-0.024999999999999994,-18
1994-05-07,Aston Villa,Liverpool,2,1,H,41,54,-1,-1,0,44,49,-5,0.34146341463414637,41,60,-1,-1,0,58,53,5,0.4146341463414634,0,0,1,0,0,0,0,0,0.2,0.4,-6,0,0,0,-0.07317073170731703,-10
1994-05-07,Blackburn,Ipswich,0,0,D,41,83,-1,-1,0,63,36,27,0.6097560975609756,41,42,-1,-1,0,35,58,-23,0.21951219512195122,0,0,0,0,0,0,0,0,0.4,0.0,41,0,0,0,0.3902439024390244,50
1994-05-07,Chelsea,Sheffield United,3,2,H,41,48,-1,-1,0,46,51,-5,0.2926829268292683,41,42,-1,-1,0,40,57,-17,0.1951219512195122,0,0,0,0,0,0,0,0,0.2,0.4,6,0,0,0,0.09756097560975607,12
1994-05-07,Everton,Wimbledon,3,2,H,41,41,-1,-1,0,39,61,-22,0.2682926829268293,41,65,-1,-1,0,54,50,4,0.43902439024390244,0,0,0,0,1,0,0,0,0.2,0.8,-24,0,0,0,-0.17073170731707316,-26
1994-05-07,Newcastle,Arsenal,2,0,H,41,74,-1,-1,0,80,41,39,0.5365853658536586,41,71,-1,-1,0,53,26,27,0.43902439024390244,0,0,0,0,0,0,0,0,0.6,0.4,3,0,0,0,0.09756097560975613,12
1994-05-07,Norwich,Oldham,1,1,D,41,52,-1,-1,0,64,60,4,0.2926829268292683,41,39,-1,-1,0,41,67,-26,0.21951219512195122,0,0,0,0,0,0,0,0,0.2,0.0,13,0,0,0,0.07317073170731705,30
1994-05-07,Sheffield Weds,Man City,1,1,D,41,63,-1,-1,0,75,53,22,0.3902439024390244,41,44,-1,-1,0,37,48,-11,0.21951219512195122,0,0,0,0,0,0,0,0,0.4,0.4,19,0,0,0,0.17073170731707318,33
1994-05-07,Swindon,Leeds,0,5,A,41,30,-1,-1,0,47,95,-48,0.12195121951219512,41,67,-1,-1,0,60,39,21,0.4146341463414634,0,0,0,0,0,0,0,0,0.2,0.4,-37,0,0,0,-0.2926829268292683,-69
1994-05-07,Tottenham,QPR,1,2,A,41,45,-1,-1,0,53,57,-4,0.2682926829268293,41,57,-1,-1,0,60,60,0,0.36585365853658536,0,0,0,0,0,0,0,0,0.4,0.2,-12,0,0,0,-0.09756097560975607,-4
1994-05-07,West Ham,Southampton,3,3,D,41,51,-1,-1,0,44,55,-11,0.3170731707317073,41,42,-1,-1,0,46,63,-17,0.2926829268292683,0,0,0,0,0,0,0,0,0.4,0.6,9,0,0,0,0.024390243902439046,6
1994-05-08,Man United,Coventry,0,0,D,41,91,-1,-1,0,80,38,42,0.6585365853658537,41,55,-1,-1,0,43,45,-2,0.34146341463414637,1,0,0,0,0,0,0,0,0.8,0.6,36,0,0,0,0.3170731707317073,44
