Date,HomeTeam,AwayTeam,FTHG,FTAG,FTR,HT_match_played,HT_current_standing,HT_past_standing,HT_past_goal_diff,HT_past_win_rate,HT_goal_for,HT_goal_against,HT_goal_diff,HT_win_rate_season,AT_match_played,AT_current_standing,AT_past_standing,AT_past_goal_diff,AT_past_win_rate,AT_goal_for,AT_goal_against,AT_goal_diff,AT_win_rate_season,HT_3_win_streak,HT_5_win_streak,HT_3_lose_Streak,HT_5_lose_Streak,AT_3_win_streak,AT_5_win_streak,AT_3_lose_Streak,AT_5_lose_Streak,HT_5_win_rate,AT_5_win_rate,current_standing_diff,past_standing_diff,past_goal_diff_diff,past_win_rate_diff,win_rate_season_diff,goal_diff_diff
1996-08-17,Arsenal,West Ham,2,0,H,0,0,63,17,0.4473684210526316,0,0,0,,0,0,51,-9,0.3684210526315789,0,0,0,,0,0,0,0,0,0,0,0,,,0,12,26,0.07894736842105265,,0
1996-08-17,Blackburn,Tottenham,0,2,A,0,0,61,14,0.4736842105263158,0,0,0,,0,0,61,12,0.42105263157894735,0,0,0,,0,0,0,0,0,0,0,0,,,0,0,2,0.052631578947368474,,0
1996-08-17,Coventry,Nott'm Forest,0,3,A,0,0,38,-18,0.21052631578947367,0,0,0,,0,0,58,-4,0.3947368421052632,0,0,0,,0,0,0,0,0,0,0,0,,,0,-20,-14,-0.18421052631578955,,0
1996-08-17,Derby,Leeds,3,3,D,0,0,-1,-1,0.0,0,0,0,,0,0,43,-17,0.3157894736842105,0,0,0,,0,0,0,0,0,0,0,0,,,0,-44,16,-0.3157894736842105,,0
1996-08-17,Everton,Newcastle,2,0,H,0,0,61,20,0.4473684210526316,0,0,0,,0,0,78,29,0.631578947368421,0,0,0,,0,0,0,0,0,0,0,0,,,0,-17,-9,-0.18421052631578944,,0
1996-08-17,Middlesbrough,Liverpool,3,3,D,0,0,43,-15,0.2894736842105263,0,0,0,,0,0,71,36,0.5263157894736842,0,0,0,,0,0,0,0,0,0,0,0,,,0,-28,-51,-0.23684210526315785,,0
1996-08-17,Sheffield Weds,Aston Villa,2,1,H,0,0,40,-13,0.2631578947368421,0,0,0,,0,0,63,17,0.4736842105263158,0,0,0,,0,0,0,0,0,0,0,0,,,0,-23,-30,-0.21052631578947373,,0
1996-08-17,Sunderland,Leicester,0,0,D,0,0,-1,-1,0.0,0,0,0,,0,0,-1,-1,0.0,0,0,0,,0,0,0,0,0,0,0,0,,,0,0,0,0.0,,0
1996-08-17,Wimbledon,Man United,0,3,A,0,0,41,-15,0.2631578947368421,0,0,0,,0,0,82,38,0.6578947368421053,0,0,0,,0,0,0,0,0,0,0,0,,,0,-41,-53,-0.3947368421052632,,0
1996-08-18,Southampton,Chelsea,0,0,D,0,0,38,-18,0.2368421052631579,0,0,0,,0,0,50,2,0.3157894736842105,0,0,0,,0,0,0,0,0,0,0,0,,,0,-12,-20,-0.0789473684210526,,0
1996-08-19,Liverpool,Arsenal,2,0,H,1,1,71,36,0.5263157894736842,3,3,0,0.0,1,3,63,17,0.4473684210526316,2,0,2,1.0,0,0,0,0,0,0,0,0,,,-2,8,19,0.0789473684210526,-1.0,-2
1996-08-20,Leeds,Sheffield Weds,0,2,A,1,1,43,-17,0.3157894736842105,3,3,0,0.0,1,3,40,-13,0.2631578947368421,2,1,1,1.0,0,0,0,0,0,0,0,0,,,-2,3,-4,0.05263157894736842,-1.0,-1
1996-08-21,Aston Villa,Blackburn,1,0,H,1,0,63,17,0.4736842105263158,1,2,-1,0.0,1,0,61,14,0.4736842105263158,0,2,-2,0.0,0,0,0,0,0,0,0,0,,,0,2,3,0.0,0.0,1
1996-08-21,Chelsea,Middlesbrough,1,0,H,1,1,50,2,0.3157894736842105,0,0,0,0.0,1,1,43,-15,0.2894736842105263,3,3,0,0.0,0,0,0,0,0,0,0,0,,,0,7,17,0.02631578947368418,0.0,0
1996-08-21,Leicester,Southampton,2,1,H,1,1,-1,-1,0.0,0,0,0,0.0,1,1,38,-18,0.2368421052631579,0,0,0,0.0,0,0,0,0,0,0,0,0,,,0,-39,17,-0.2368421052631579,0.0,0
1996-08-21,Man United,Everton,2,2,D,1,3,82,38,0.6578947368421053,3,0,3,1.0,1,3,61,20,0.4473684210526316,2,0,2,1.0,0,0,0,0,0,0,0,0,,,0,21,18,0.21052631578947373,0.0,1
1996-08-21,Newcastle,Wimbledon,2,0,H,1,0,78,29,0.631578947368421,0,2,-2,0.0,1,0,41,-15,0.2631578947368421,0,3,-3,0.0,0,0,0,0,0,0,0,0,,,0,37,44,0.3684210526315789,0.0,1
1996-08-21,Nott'm Forest,Sunderland,1,4,A,1,3,58,-4,0.3947368421052632,3,0,3,1.0,1,1,-1,-1,0.0,0,0,0,0.0,0,0,0,0,0,0,0,0,,,2,59,-3,0.3947368421052632,1.0,3
1996-08-21,Tottenham,Derby,1,1,D,1,3,61,12,0.42105263157894735,2,0,2,1.0,1,1,-1,-1,0.0,3,3,0,0.0,0,0,0,0,0,0,0,0,,,2,62,13,0.42105263157894735,1.0,2
1996-08-21,West Ham,Coventry,1,1,D,1,0,51,-9,0.3684210526315789,0,2,-2,0.0,1,0,38,-18,0.21052631578947367,0,3,-3,0.0,0,0,0,0,0,0,0,0,,,0,13,9,0.15789473684210525,0.0,1
1996-08-24,Aston Villa,Derby,2,0,H,2,3,63,17,0.4736842105263158,2,2,0,0.5,2,2,-1,-1,0.0,4,4,0,0.0,0,0,0,0,0,0,0,0,,,1,64,18,0.4736842105263158,0.5,0
1996-08-24,Chelsea,Coventry,2,0,H,2,4,50,2,0.3157894736842105,1,0,1,0.5,2,1,38,-18,0.21052631578947367,1,4,-3,0.0,0,0,0,0,0,0,0,0,,,3,12,20,0.10526315789473684,0.5,4
1996-08-24,Leicester,Arsenal,0,2,A,2,4,-1,-1,0.0,2,1,1,0.5,2,3,63,17,0.4473684210526316,2,2,0,0.5,0,0,0,0,0,0,0,0,,,1,-64,-18,-0.4473684210526316,0.0,1
1996-08-24,Liverpool,Sunderland,0,0,D,2,4,71,36,0.5263157894736842,5,3,2,0.5,2,4,-1,-1,0.0,4,1,3,0.5,0,0,0,0,0,0,0,0,,,0,72,37,0.5263157894736842,0.0,-1
1996-08-24,Newcastle,Sheffield Weds,1,2,A,2,3,78,29,0.631578947368421,2,2,0,0.5,2,6,40,-13,0.2631578947368421,4,1,3,1.0,0,0,0,0,0,0,0,0,,,-3,38,42,0.3684210526315789,-0.5,-3
1996-08-24,Nott'm Forest,Middlesbrough,1,1,D,2,3,58,-4,0.3947368421052632,4,4,0,0.5,2,1,43,-15,0.2894736842105263,3,4,-1,0.0,0,0,0,0,0,0,0,0,,,2,15,11,0.10526315789473689,0.5,1
1996-08-24,Tottenham,Everton,0,0,D,2,4,61,12,0.42105263157894735,3,1,2,0.5,2,4,61,20,0.4473684210526316,4,2,2,0.5,0,0,0,0,0,0,0,0,,,0,0,-8,-0.026315789473684237,0.0,0
1996-08-24,West Ham,Southampton,2,1,H,2,1,51,-9,0.3684210526315789,1,3,-2,0.0,2,1,38,-18,0.2368421052631579,1,2,-1,0.0,0,0,0,0,0,0,0,0,,,0,13,9,0.13157894736842102,0.0,-1
1996-08-25,Man United,Blackburn,2,2,D,2,4,82,38,0.6578947368421053,5,2,3,0.5,2,0,61,14,0.4736842105263158,0,3,-3,0.0,0,0,0,0,0,0,0,0,,,4,21,24,0.1842105263157895,0.5,6
1996-08-26,Leeds,Wimbledon,1,0,H,2,1,43,-17,0.3157894736842105,3,5,-2,0.0,2,0,41,-15,0.2631578947368421,0,5,-5,0.0,0,0,0,0,0,0,0,0,,,1,2,-2,0.05263157894736842,0.0,3
1996-09-02,Sheffield Weds,Leicester,2,1,H,3,9,40,-13,0.2631578947368421,6,2,4,1.0,3,4,-1,-1,0.0,2,3,-1,0.3333333333333333,0,0,0,0,0,0,0,0,,,5,41,-12,0.2631578947368421,0.6666666666666667,5
1996-09-04,Arsenal,Chelsea,3,3,D,3,6,63,17,0.4473684210526316,4,2,2,0.6666666666666666,3,7,50,2,0.3157894736842105,3,0,3,0.6666666666666666,0,0,0,0,0,0,0,0,,,-1,13,15,0.13157894736842107,0.0,-1
1996-09-04,Blackburn,Leeds,0,1,A,3,1,61,14,0.4736842105263158,2,5,-3,0.0,3,4,43,-17,0.3157894736842105,4,5,-1,0.3333333333333333,0,0,0,0,0,0,0,0,,,-3,18,31,0.1578947368421053,-0.3333333333333333,-2
1996-09-04,Coventry,Liverpool,0,1,A,3,1,38,-18,0.21052631578947367,1,6,-5,0.0,3,5,71,36,0.5263157894736842,5,3,2,0.3333333333333333,0,0,0,0,0,0,0,0,,,-4,-33,-54,-0.3157894736842105,-0.3333333333333333,-7
1996-09-04,Derby,Man United,1,1,D,3,2,-1,-1,0.0,4,6,-2,0.0,3,5,82,38,0.6578947368421053,7,4,3,0.3333333333333333,0,0,0,0,0,0,0,0,,,-3,-83,-39,-0.6578947368421053,-0.3333333333333333,-5
1996-09-04,Everton,Aston Villa,0,1,A,3,5,61,20,0.4473684210526316,4,2,2,0.3333333333333333,3,6,63,17,0.4736842105263158,4,2,2,0.6666666666666666,0,0,0,0,0,0,0,0,,,-1,-2,3,-0.026315789473684237,-0.3333333333333333,0
1996-09-04,Middlesbrough,West Ham,4,1,H,3,2,43,-15,0.2894736842105263,4,5,-1,0.0,3,4,51,-9,0.3684210526315789,3,4,-1,0.3333333333333333,0,0,0,0,0,0,0,0,,,-2,-8,-6,-0.0789473684210526,-0.3333333333333333,0
1996-09-04,Southampton,Nott'm Forest,2,2,D,3,1,38,-18,0.2368421052631579,2,4,-2,0.0,3,4,58,-4,0.3947368421052632,5,5,0,0.3333333333333333,0,0,0,0,0,0,0,0,,,-3,-20,-14,-0.1578947368421053,-0.3333333333333333,-2
1996-09-04,Sunderland,Newcastle,1,2,A,3,5,-1,-1,0.0,4,1,3,0.3333333333333333,3,3,78,29,0.631578947368421,3,4,-1,0.3333333333333333,0,0,0,0,0,0,0,0,,,2,-79,-30,-0.631578947368421,0.0,4
1996-09-04,Wimbledon,Tottenham,1,0,H,3,0,41,-15,0.2631578947368421,0,6,-6,0.0,3,5,61,12,0.42105263157894735,3,1,2,0.3333333333333333,0,0,0,0,0,0,0,0,,,-5,-20,-27,-0.15789473684210525,-0.3333333333333333,-8
1996-09-07,Aston Villa,Arsenal,2,2,D,4,9,63,17,0.4736842105263158,5,2,3,0.75,4,7,63,17,0.4473684210526316,7,5,2,0.5,1,0,0,0,0,0,0,0,,,2,0,0,0.026315789473684237,0.25,1
1996-09-07,Leeds,Man United,0,4,A,4,7,43,-17,0.3157894736842105,5,5,0,0.5,4,6,82,38,0.6578947368421053,8,5,3,0.25,0,0,0,0,0,0,0,0,,,1,-39,-55,-0.3421052631578948,0.25,-3
1996-09-07,Liverpool,Southampton,2,1,H,4,8,71,36,0.5263157894736842,6,3,3,0.5,4,2,38,-18,0.2368421052631579,4,6,-2,0.0,0,0,0,0,0,0,0,0,,,6,33,54,0.28947368421052627,0.5,5
1996-09-07,Middlesbrough,Coventry,4,0,H,4,5,43,-15,0.2894736842105263,8,6,2,0.25,4,1,38,-18,0.21052631578947367,1,7,-6,0.0,0,0,0,0,0,0,0,0,,,4,5,3,0.07894736842105265,0.25,8
1996-09-07,Nott'm Forest,Leicester,0,0,D,4,5,58,-4,0.3947368421052632,7,7,0,0.25,4,4,-1,-1,0.0,3,5,-2,0.25,0,0,0,0,0,0,0,0,,,1,59,-3,0.3947368421052632,0.0,2
1996-09-07,Sheffield Weds,Chelsea,0,2,A,4,12,40,-13,0.2631578947368421,8,3,5,1.0,4,8,50,2,0.3157894736842105,6,3,3,0.5,1,0,0,0,0,0,0,0,,,4,-10,-15,-0.05263157894736842,0.5,2
1996-09-07,Tottenham,Newcastle,1,2,A,4,5,61,12,0.42105263157894735,3,2,1,0.25,4,6,78,29,0.631578947368421,5,5,0,0.5,0,0,0,0,0,0,0,0,,,-1,-17,-17,-0.21052631578947367,-0.25,1
1996-09-07,Wimbledon,Everton,4,0,H,4,3,41,-15,0.2631578947368421,1,6,-5,0.25,4,5,61,20,0.4473684210526316,4,3,1,0.25,0,0,0,0,0,0,0,0,,,-2,-20,-35,-0.1842105263157895,0.0,-6
1996-09-08,Sunderland,West Ham,0,0,D,4,5,-1,-1,0.0,5,3,2,0.25,4,4,51,-9,0.3684210526315789,4,8,-4,0.25,0,0,0,0,0,0,0,0,,,1,-52,8,-0.3684210526315789,0.0,6
1996-09-09,Blackburn,Derby,1,2,A,4,1,61,14,0.4736842105263158,2,6,-4,0.0,4,3,-1,-1,0.0,5,7,-2,0.0,0,0,0,0,0,0,0,0,,,-2,62,15,0.4736842105263158,0.0,-2
1996-09-14,Coventry,Leeds,2,1,H,5,1,38,-18,0.21052631578947367,1,11,-10,0.0,5,7,43,-17,0.3157894736842105,5,9,-4,0.4,0,0,1,0,0,0,0,0,0.0,0.4,-6,-5,-1,-0.10526315789473684,-0.4,-6
1996-09-14,Derby,Sunderland,1,0,H,5,6,-1,-1,0.0,7,8,-1,0.2,5,6,-1,-1,0.0,5,3,2,0.2,0,0,0,0,0,0,0,0,0.2,0.2,0,0,0,0.0,0.0,-3
1996-09-14,Everton,Middlesbrough,1,2,A,5,5,61,20,0.4473684210526316,4,7,-3,0.2,5,8,43,-15,0.2894736842105263,12,6,6,0.4,0,0,0,0,0,0,0,0,0.2,0.4,-3,18,35,0.15789473684210525,-0.2,-9
1996-09-14,Man United,Nott'm Forest,4,1,H,5,9,82,38,0.6578947368421053,12,5,7,0.4,5,6,58,-4,0.3947368421052632,7,7,0,0.2,0,0,0,0,0,0,0,0,0.4,0.2,3,24,42,0.2631578947368421,0.2,7
1996-09-14,Newcastle,Blackburn,2,1,H,5,9,78,29,0.631578947368421,7,6,1,0.6,5,1,61,14,0.4736842105263158,3,8,-5,0.0,0,0,0,0,0,0,0,0,0.6,0.0,8,17,15,0.1578947368421052,0.6,6
1996-09-14,Southampton,Tottenham,0,1,A,5,2,38,-18,0.2368421052631579,5,8,-3,0.0,5,5,61,12,0.42105263157894735,4,4,0,0.2,0,0,0,0,0,0,0,0,0.0,0.2,-3,-23,-30,-0.18421052631578944,-0.2,-3
1996-09-14,West Ham,Wimbledon,0,2,A,5,5,51,-9,0.3684210526315789,4,8,-4,0.2,5,6,41,-15,0.2631578947368421,5,6,-1,0.4,0,0,0,0,0,0,0,0,0.2,0.4,-1,10,6,0.10526315789473684,-0.2,-3
1996-09-15,Chelsea,Aston Villa,1,1,D,5,11,50,2,0.3157894736842105,8,3,5,0.6,5,10,63,17,0.4736842105263158,7,4,3,0.6,0,0,0,0,0,0,0,0,0.6,0.6,1,-13,-15,-0.1578947368421053,0.0,2
1996-09-15,Leicester,Liverpool,0,3,A,5,5,-1,-1,0.0,3,5,-2,0.2,5,11,71,36,0.5263157894736842,8,4,4,0.6,0,0,0,0,0,0,0,0,0.2,0.6,-6,-72,-37,-0.5263157894736842,-0.39999999999999997,-6
1996-09-16,Arsenal,Sheffield Weds,4,1,H,5,8,63,17,0.4473684210526316,9,7,2,0.4,5,12,40,-13,0.2631578947368421,8,5,3,0.8,0,0,0,0,0,0,0,0,0.4,0.8,-4,23,30,0.1842105263157895,-0.4,-1
1996-09-21,Aston Villa,Man United,0,0,D,6,11,63,17,0.4736842105263158,8,5,3,0.5,6,12,82,38,0.6578947368421053,16,6,10,0.5,0,0,0,0,0,0,0,0,0.6,0.4,-1,-19,-21,-0.1842105263157895,0.0,-7
1996-09-21,Blackburn,Everton,1,1,D,6,1,61,14,0.4736842105263158,4,10,-6,0.0,6,5,61,20,0.4473684210526316,5,9,-4,0.16666666666666666,0,0,1,0,0,0,1,0,0.0,0.0,-4,0,-6,0.026315789473684237,-0.16666666666666666,-2
1996-09-21,Leeds,Newcastle,0,1,A,6,7,43,-17,0.3157894736842105,6,11,-5,0.3333333333333333,6,12,78,29,0.631578947368421,9,7,2,0.6666666666666666,0,0,0,0,1,0,0,0,0.4,0.8,-5,-35,-46,-0.3157894736842105,-0.3333333333333333,-7
1996-09-21,Liverpool,Chelsea,5,1,H,6,14,71,36,0.5263157894736842,11,4,7,0.6666666666666666,6,12,50,2,0.3157894736842105,9,4,5,0.5,1,0,0,0,0,0,0,0,0.8,0.6,2,21,34,0.21052631578947367,0.16666666666666663,2
1996-09-21,Middlesbrough,Arsenal,0,2,A,6,11,43,-15,0.2894736842105263,14,7,7,0.5,6,11,63,17,0.4473684210526316,13,8,5,0.5,1,0,0,0,0,0,0,0,0.6,0.4,0,-20,-32,-0.15789473684210525,0.0,2
1996-09-21,Nott'm Forest,West Ham,0,2,A,6,6,58,-4,0.3947368421052632,8,11,-3,0.16666666666666666,6,5,51,-9,0.3684210526315789,4,10,-6,0.16666666666666666,0,0,0,0,0,0,0,0,0.0,0.2,1,7,5,0.026315789473684292,0.0,3
1996-09-21,Sheffield Weds,Derby,0,0,D,6,12,40,-13,0.2631578947368421,9,9,0,0.6666666666666666,6,9,-1,-1,0.0,8,8,0,0.3333333333333333,0,0,0,0,0,0,0,0,0.6,0.4,3,41,-12,0.2631578947368421,0.3333333333333333,0
1996-09-21,Sunderland,Coventry,1,0,H,6,6,-1,-1,0.0,5,4,1,0.16666666666666666,6,4,38,-18,0.21052631578947367,3,12,-9,0.16666666666666666,0,0,0,0,0,0,0,0,0.2,0.2,2,-39,17,-0.21052631578947367,0.0,10
1996-09-22,Tottenham,Leicester,1,2,A,6,8,61,12,0.42105263157894735,5,4,1,0.3333333333333333,6,5,-1,-1,0.0,3,8,-5,0.16666666666666666,0,0,0,0,0,0,0,0,0.2,0.2,3,62,13,0.42105263157894735,0.16666666666666666,6
1996-09-23,Wimbledon,Southampton,3,1,H,6,9,41,-15,0.2631578947368421,7,6,1,0.5,6,2,38,-18,0.2368421052631579,5,9,-4,0.0,1,0,0,0,0,0,0,0,0.6,0.0,7,3,3,0.02631578947368418,0.5,5
1996-09-28,Arsenal,Sunderland,2,0,H,7,14,63,17,0.4473684210526316,15,8,7,0.5714285714285714,7,9,-1,-1,0.0,6,4,2,0.2857142857142857,0,0,0,0,0,0,0,0,0.6,0.2,5,64,18,0.4473684210526316,0.2857142857142857,5
1996-09-28,Chelsea,Nott'm Forest,1,1,D,7,12,50,2,0.3157894736842105,10,9,1,0.42857142857142855,7,6,58,-4,0.3947368421052632,8,13,-5,0.14285714285714285,0,0,0,0,0,0,0,0,0.4,0.0,6,-8,6,-0.07894736842105271,0.2857142857142857,6
1996-09-28,Coventry,Blackburn,0,0,D,7,4,38,-18,0.21052631578947367,3,13,-10,0.14285714285714285,7,2,61,14,0.4736842105263158,5,11,-6,0.0,0,0,0,0,0,0,0,0,0.2,0.0,2,-23,-32,-0.26315789473684215,0.14285714285714285,-4
1996-09-28,Derby,Wimbledon,0,2,A,7,10,-1,-1,0.0,8,8,0,0.2857142857142857,7,12,41,-15,0.2631578947368421,10,7,3,0.5714285714285714,0,0,0,0,1,0,0,0,0.4,0.8,-2,-42,14,-0.2631578947368421,-0.2857142857142857,-3
1996-09-28,Everton,Sheffield Weds,2,0,H,7,6,61,20,0.4473684210526316,6,10,-4,0.14285714285714285,7,13,40,-13,0.2631578947368421,9,9,0,0.5714285714285714,0,0,0,0,0,0,0,0,0.0,0.4,-7,21,33,0.1842105263157895,-0.42857142857142855,-4
1996-09-28,Leicester,Leeds,1,0,H,7,8,-1,-1,0.0,5,9,-4,0.2857142857142857,7,7,43,-17,0.3157894736842105,6,12,-6,0.2857142857142857,0,0,0,0,0,0,1,0,0.2,0.4,1,-44,16,-0.3157894736842105,0.0,2
1996-09-28,Southampton,Middlesbrough,4,0,H,7,2,38,-18,0.2368421052631579,6,12,-6,0.0,7,11,43,-15,0.2894736842105263,14,9,5,0.42857142857142855,0,0,1,0,0,0,0,0,0.0,0.6,-9,-5,-3,-0.05263157894736842,-0.42857142857142855,-11
1996-09-29,Man United,Tottenham,2,0,H,7,13,82,38,0.6578947368421053,16,6,10,0.42857142857142855,7,8,61,12,0.42105263157894735,6,6,0,0.2857142857142857,0,0,0,0,0,0,0,0,0.4,0.2,5,21,26,0.23684210526315796,0.14285714285714285,10
1996-09-29,West Ham,Liverpool,1,2,A,7,8,51,-9,0.3684210526315789,6,10,-4,0.2857142857142857,7,17,71,36,0.5263157894736842,16,5,11,0.7142857142857143,0,0,0,0,1,0,0,0,0.4,0.8,-9,-20,-45,-0.15789473684210525,-0.4285714285714286,-15
1996-09-30,Newcastle,Aston Villa,4,3,H,7,15,78,29,0.631578947368421,10,7,3,0.7142857142857143,7,12,63,17,0.4736842105263158,8,5,3,0.42857142857142855,1,0,0,0,0,0,0,0,0.8,0.4,3,15,12,0.1578947368421052,0.28571428571428575,0
1996-10-12,Blackburn,Arsenal,0,2,A,8,3,61,14,0.4736842105263158,5,11,-6,0.0,8,17,63,17,0.4473684210526316,17,8,9,0.625,0,0,0,0,1,0,0,0,0.0,0.6,-14,-2,-3,0.026315789473684237,-0.625,-15
1996-10-12,Derby,Newcastle,0,1,A,8,10,-1,-1,0.0,8,10,-2,0.25,8,18,78,29,0.631578947368421,14,10,4,0.75,0,0,0,0,1,1,0,0,0.4,1.0,-8,-79,-30,-0.631578947368421,-0.5,-6
1996-10-12,Everton,West Ham,2,1,H,8,9,61,20,0.4473684210526316,8,10,-2,0.25,8,8,51,-9,0.3684210526315789,7,12,-5,0.25,0,0,0,0,0,0,0,0,0.2,0.2,1,10,29,0.07894736842105265,0.0,3
1996-10-12,Leeds,Nott'm Forest,2,0,H,8,7,43,-17,0.3157894736842105,6,13,-7,0.25,8,7,58,-4,0.3947368421052632,9,14,-5,0.125,0,0,1,0,0,0,0,0,0.2,0.0,0,-15,-13,-0.07894736842105271,0.125,-2
1996-10-12,Leicester,Chelsea,1,3,A,8,11,-1,-1,0.0,6,9,-3,0.375,8,13,50,2,0.3157894736842105,11,10,1,0.375,0,0,0,0,0,0,0,0,0.4,0.2,-2,-51,-3,-0.3157894736842105,0.0,-4
1996-10-12,Man United,Liverpool,1,0,H,8,16,82,38,0.6578947368421053,18,6,12,0.5,8,20,71,36,0.5263157894736842,18,6,12,0.75,0,0,0,0,1,1,0,0,0.6,1.0,-4,11,2,0.13157894736842113,-0.25,0
1996-10-12,Tottenham,Aston Villa,1,0,H,8,8,61,12,0.42105263157894735,6,8,-2,0.25,8,12,63,17,0.4736842105263158,11,9,2,0.375,0,0,0,0,0,0,0,0,0.2,0.2,-4,-2,-5,-0.052631578947368474,-0.125,-4
1996-10-12,Wimbledon,Sheffield Weds,4,2,H,8,15,41,-15,0.2631578947368421,12,7,5,0.625,8,13,40,-13,0.2631578947368421,9,11,-2,0.5,1,1,0,0,0,0,0,0,1.0,0.2,2,1,-2,0.0,0.125,7
1996-10-13,Coventry,Southampton,1,1,D,8,5,38,-18,0.21052631578947367,3,13,-10,0.125,8,5,38,-18,0.2368421052631579,10,12,-2,0.125,0,0,0,0,0,0,0,0,0.2,0.2,0,0,0,-0.026315789473684237,0.0,-8
1996-10-14,Sunderland,Middlesbrough,2,2,D,8,9,-1,-1,0.0,6,6,0,0.25,8,11,43,-15,0.2894736842105263,14,13,1,0.375,0,0,0,0,0,0,0,0,0.2,0.6,-2,-44,14,-0.2894736842105263,-0.125,-1
1996-10-19,Arsenal,Coventry,0,0,D,9,20,63,17,0.4473684210526316,19,8,11,0.6666666666666666,9,6,38,-18,0.21052631578947367,4,14,-10,0.1111111111111111,1,0,0,0,0,0,0,0,0.8,0.2,14,25,35,0.2368421052631579,0.5555555555555556,21
1996-10-19,Aston Villa,Leeds,2,0,H,9,12,63,17,0.4736842105263158,11,10,1,0.3333333333333333,9,10,43,-17,0.3157894736842105,8,13,-5,0.3333333333333333,0,0,0,0,0,0,0,0,0.0,0.2,2,20,34,0.1578947368421053,0.0,6
1996-10-19,Chelsea,Wimbledon,2,4,A,9,16,50,2,0.3157894736842105,14,11,3,0.4444444444444444,9,18,41,-15,0.2631578947368421,16,9,7,0.6666666666666666,0,0,0,0,1,1,0,0,0.4,1.0,-2,9,17,0.05263157894736842,-0.2222222222222222,-4
1996-10-19,Middlesbrough,Tottenham,0,3,A,9,12,43,-15,0.2894736842105263,16,15,1,0.3333333333333333,9,11,61,12,0.42105263157894735,7,8,-1,0.3333333333333333,0,0,0,0,0,0,0,0,0.4,0.4,1,-18,-27,-0.13157894736842102,0.0,2
1996-10-19,Nott'm Forest,Derby,1,1,D,9,7,58,-4,0.3947368421052632,9,16,-7,0.1111111111111111,9,10,-1,-1,0.0,8,11,-3,0.2222222222222222,0,0,0,0,0,0,0,0,0.0,0.4,-3,59,-3,0.3947368421052632,-0.1111111111111111,-4
1996-10-19,Sheffield Weds,Blackburn,1,1,D,9,13,40,-13,0.2631578947368421,11,15,-4,0.4444444444444444,9,3,61,14,0.4736842105263158,5,13,-8,0.0,0,0,0,0,0,0,0,0,0.0,0.0,10,-21,-27,-0.21052631578947373,0.4444444444444444,4
1996-10-19,Southampton,Sunderland,3,0,H,9,6,38,-18,0.2368421052631579,11,13,-2,0.1111111111111111,9,10,-1,-1,0.0,8,8,0,0.2222222222222222,0,0,0,0,0,0,0,0,0.2,0.2,-4,39,-17,0.2368421052631579,-0.1111111111111111,-2
1996-10-19,West Ham,Leicester,1,0,H,9,8,51,-9,0.3684210526315789,8,14,-6,0.2222222222222222,9,11,-1,-1,0.0,7,12,-5,0.3333333333333333,0,0,0,0,0,0,0,0,0.2,0.4,-3,52,-8,0.3684210526315789,-0.1111111111111111,-1
1996-10-20,Newcastle,Man United,5,0,H,9,21,78,29,0.631578947368421,15,10,5,0.7777777777777778,9,19,82,38,0.6578947368421053,19,6,13,0.5555555555555556,1,1,0,0,0,0,0,0,1.0,0.8,2,-4,-9,-0.026315789473684292,0.2222222222222222,-8
1996-10-26,Arsenal,Leeds,3,0,H,10,21,63,17,0.4473684210526316,19,8,11,0.6,10,10,43,-17,0.3157894736842105,8,15,-7,0.3,0,0,0,0,0,0,0,0,0.8,0.2,11,20,34,0.13157894736842107,0.3,18
1996-10-26,Chelsea,Tottenham,3,1,H,10,16,50,2,0.3157894736842105,16,15,1,0.4,10,14,61,12,0.42105263157894735,10,8,2,0.4,0,0,0,0,0,0,0,0,0.2,0.6,2,-11,-10,-0.10526315789473684,0.0,-1
1996-10-26,Coventry,Sheffield Weds,0,0,D,10,7,38,-18,0.21052631578947367,4,14,-10,0.1,10,14,40,-13,0.2631578947368421,12,16,-4,0.4,0,0,0,0,0,0,0,0,0.2,0.0,-7,-2,-5,-0.05263157894736842,-0.30000000000000004,-6
1996-10-26,Leicester,Newcastle,2,0,H,10,11,-1,-1,0.0,7,13,-6,0.3,10,24,78,29,0.631578947368421,20,10,10,0.8,0,0,0,0,1,1,0,0,0.4,1.0,-13,-79,-30,-0.631578947368421,-0.5,-16
1996-10-26,Middlesbrough,Wimbledon,0,0,D,10,12,43,-15,0.2894736842105263,16,18,-2,0.3,10,21,41,-15,0.2631578947368421,20,11,9,0.7,0,0,0,0,1,1,0,0,0.2,1.0,-9,2,0,0.026315789473684237,-0.39999999999999997,-11
1996-10-26,Southampton,Man United,6,3,H,10,9,38,-18,0.2368421052631579,14,13,1,0.2,10,19,82,38,0.6578947368421053,19,11,8,0.5,0,0,0,0,0,0,0,0,0.4,0.6,-10,-44,-56,-0.4210526315789474,-0.3,-7
1996-10-26,Sunderland,Aston Villa,1,0,H,10,10,-1,-1,0.0,8,11,-3,0.2,10,15,63,17,0.4736842105263158,13,10,3,0.4,0,0,0,0,0,0,0,0,0.2,0.2,-5,-64,-18,-0.4736842105263158,-0.2,-6
1996-10-26,West Ham,Blackburn,2,1,H,10,11,51,-9,0.3684210526315789,9,14,-5,0.3,10,4,61,14,0.4736842105263158,6,14,-8,0.0,0,0,0,0,0,0,0,0,0.4,0.0,7,-10,-23,-0.10526315789473689,0.3,3
1996-10-27,Liverpool,Derby,2,1,H,9,20,71,36,0.5263157894736842,18,7,11,0.6666666666666666,10,11,-1,-1,0.0,9,12,-3,0.2,0,0,0,0,0,0,0,0,0.8,0.2,9,72,37,0.5263157894736842,0.4666666666666666,14
1996-10-28,Nott'm Forest,Everton,0,1,A,10,8,58,-4,0.3947368421052632,10,17,-7,0.1,9,12,61,20,0.4473684210526316,10,11,-1,0.3333333333333333,0,0,0,0,0,0,0,0,0.0,0.4,-4,-3,-24,-0.05263157894736836,-0.2333333333333333,-6
1996-11-02,Aston Villa,Nott'm Forest,2,0,H,11,15,63,17,0.4736842105263158,13,11,2,0.36363636363636365,11,8,58,-4,0.3947368421052632,10,18,-8,0.09090909090909091,0,0,0,0,0,0,0,0,0.2,0.0,7,5,21,0.0789473684210526,0.2727272727272727,10
1996-11-02,Derby,Leicester,2,0,H,11,11,-1,-1,0.0,10,14,-4,0.18181818181818182,11,14,-1,-1,0.0,9,13,-4,0.36363636363636365,0,0,0,0,0,0,0,0,0.0,0.6,-3,0,0,0.0,-0.18181818181818182,0
1996-11-02,Leeds,Sunderland,3,0,H,11,10,43,-17,0.3157894736842105,8,18,-10,0.2727272727272727,11,13,-1,-1,0.0,9,11,-2,0.2727272727272727,0,0,0,0,0,0,0,0,0.2,0.4,-3,44,-16,0.3157894736842105,0.0,-8
1996-11-02,Man United,Chelsea,1,2,A,11,19,82,38,0.6578947368421053,22,17,5,0.45454545454545453,11,19,50,2,0.3157894736842105,19,16,3,0.45454545454545453,0,0,0,0,0,0,0,0,0.4,0.4,0,32,36,0.3421052631578948,0.0,2
1996-11-02,Sheffield Weds,Southampton,1,1,D,11,15,40,-13,0.2631578947368421,12,16,-4,0.36363636363636365,11,12,38,-18,0.2368421052631579,20,16,4,0.2727272727272727,0,0,0,0,0,0,0,0,0.0,0.6,3,2,5,0.02631578947368418,0.09090909090909094,-8
1996-11-02,Tottenham,West Ham,1,0,H,11,14,61,12,0.42105263157894735,11,11,0,0.36363636363636365,11,14,51,-9,0.3684210526315789,11,15,-4,0.36363636363636365,0,0,0,0,0,0,0,0,0.4,0.6,0,10,21,0.05263157894736842,0.0,4
1996-11-02,Wimbledon,Arsenal,2,2,D,11,22,41,-15,0.2631578947368421,20,11,9,0.6363636363636364,11,24,63,17,0.4473684210526316,22,8,14,0.6363636363636364,0,0,0,0,0,0,0,0,0.8,0.8,-2,-22,-32,-0.1842105263157895,0.0,-5
1996-11-03,Blackburn,Liverpool,3,0,H,11,4,61,14,0.4736842105263158,7,16,-9,0.0,10,23,71,36,0.5263157894736842,20,8,12,0.7,0,0,0,0,0,0,0,0,0.0,0.8,-19,-10,-22,-0.05263157894736836,-0.7,-21
1996-11-03,Newcastle,Middlesbrough,3,1,H,11,24,78,29,0.631578947368421,20,12,8,0.7272727272727273,11,13,43,-15,0.2894736842105263,16,18,-2,0.2727272727272727,0,0,0,0,0,0,0,0,0.8,0.0,11,35,44,0.3421052631578947,0.4545454545454546,10
1996-11-04,Everton,Coventry,1,1,D,10,15,61,20,0.4473684210526316,11,11,0,0.4,11,8,38,-18,0.21052631578947367,4,14,-10,0.09090909090909091,1,0,0,0,0,0,0,0,0.6,0.0,7,23,38,0.2368421052631579,0.3090909090909091,10
1996-11-16,Aston Villa,Leicester,1,3,A,12,18,63,17,0.4736842105263158,15,11,4,0.4166666666666667,12,14,-1,-1,0.0,9,15,-6,0.3333333333333333,0,0,0,0,0,0,0,0,0.4,0.4,4,64,18,0.4736842105263158,0.08333333333333337,10
1996-11-16,Blackburn,Chelsea,1,1,D,12,7,61,14,0.4736842105263158,10,16,-6,0.08333333333333333,12,22,50,2,0.3157894736842105,21,17,4,0.5,0,0,0,0,0,0,0,0,0.2,0.6,-15,11,12,0.1578947368421053,-0.4166666666666667,-10
1996-11-16,Everton,Southampton,7,1,H,11,16,61,20,0.4473684210526316,12,12,0,0.36363636363636365,12,13,38,-18,0.2368421052631579,21,17,4,0.25,0,0,0,0,0,0,0,0,0.6,0.6,3,23,38,0.21052631578947367,0.11363636363636365,-4
1996-11-16,Leeds,Liverpool,0,2,A,12,13,43,-17,0.3157894736842105,11,18,-7,0.3333333333333333,11,23,71,36,0.5263157894736842,20,11,9,0.6363636363636364,0,0,0,0,0,0,0,0,0.4,0.6,-10,-28,-53,-0.21052631578947367,-0.30303030303030304,-16
1996-11-16,Man United,Arsenal,1,0,H,12,19,82,38,0.6578947368421053,23,19,4,0.4166666666666667,12,25,63,17,0.4473684210526316,24,10,14,0.5833333333333334,0,0,1,0,0,0,0,0,0.4,0.6,-6,19,21,0.21052631578947373,-0.16666666666666669,-10
1996-11-16,Newcastle,West Ham,1,1,D,12,27,78,29,0.631578947368421,23,13,10,0.75,12,14,51,-9,0.3684210526315789,11,16,-5,0.3333333333333333,0,0,0,0,0,0,0,0,0.8,0.4,13,27,38,0.2631578947368421,0.4166666666666667,15
1996-11-16,Tottenham,Sunderland,2,0,H,12,17,61,12,0.42105263157894735,12,11,1,0.4166666666666667,12,13,-1,-1,0.0,9,14,-5,0.25,0,0,0,0,0,0,0,0,0.6,0.2,4,62,13,0.42105263157894735,0.16666666666666669,6
1996-11-16,Wimbledon,Coventry,2,2,D,12,23,41,-15,0.2631578947368421,22,13,9,0.5833333333333334,12,9,38,-18,0.21052631578947367,5,15,-10,0.08333333333333333,0,0,0,0,0,0,0,0,0.6,0.0,14,3,3,0.05263157894736842,0.5,19
1996-11-17,Derby,Middlesbrough,2,1,H,12,14,-1,-1,0.0,12,14,-2,0.25,12,13,43,-15,0.2894736842105263,17,21,-4,0.25,0,0,0,0,0,0,0,0,0.2,0.0,1,-44,14,-0.2894736842105263,0.0,2
1996-11-18,Sheffield Weds,Nott'm Forest,2,0,H,12,16,40,-13,0.2631578947368421,13,17,-4,0.3333333333333333,12,8,58,-4,0.3947368421052632,10,20,-10,0.08333333333333333,0,0,0,0,0,0,0,0,0.0,0.0,8,-18,-9,-0.13157894736842113,0.25,6
1996-11-20,Liverpool,Everton,1,1,D,12,26,71,36,0.5263157894736842,22,11,11,0.6666666666666666,12,19,61,20,0.4473684210526316,19,13,6,0.4166666666666667,0,0,0,0,0,0,0,0,0.6,0.8,7,10,16,0.0789473684210526,0.24999999999999994,5
1996-11-23,Chelsea,Newcastle,1,1,D,13,23,50,2,0.3157894736842105,22,18,4,0.46153846153846156,13,28,78,29,0.631578947368421,24,14,10,0.6923076923076923,0,0,0,0,0,0,0,0,0.6,0.6,-5,-28,-27,-0.3157894736842105,-0.23076923076923073,-6
1996-11-23,Coventry,Aston Villa,1,2,A,13,10,38,-18,0.21052631578947367,7,17,-10,0.07692307692307693,13,18,63,17,0.4736842105263158,16,14,2,0.38461538461538464,0,0,0,0,0,0,0,0,0.0,0.4,-8,-25,-35,-0.26315789473684215,-0.3076923076923077,-12
1996-11-23,Leicester,Everton,1,2,A,13,17,-1,-1,0.0,12,16,-4,0.38461538461538464,13,20,61,20,0.4473684210526316,20,14,6,0.38461538461538464,0,0,0,0,0,0,0,0,0.4,0.6,-3,-62,-21,-0.4473684210526316,0.0,-10
1996-11-23,Liverpool,Wimbledon,1,1,D,13,27,71,36,0.5263157894736842,23,12,11,0.6153846153846154,13,24,41,-15,0.2631578947368421,24,15,9,0.5384615384615384,0,0,0,0,0,0,0,0,0.4,0.4,3,30,51,0.2631578947368421,0.07692307692307698,2
1996-11-23,Middlesbrough,Man United,2,2,D,13,13,43,-15,0.2894736842105263,18,23,-5,0.23076923076923078,13,22,82,38,0.6578947368421053,24,19,5,0.46153846153846156,0,0,0,0,0,0,0,0,0.0,0.4,-9,-39,-53,-0.368421052631579,-0.23076923076923078,-10
1996-11-23,Southampton,Leeds,0,2,A,13,13,38,-18,0.2368421052631579,22,24,-2,0.23076923076923078,13,13,43,-17,0.3157894736842105,11,20,-9,0.3076923076923077,0,0,0,0,0,0,0,0,0.4,0.4,0,-5,-1,-0.0789473684210526,-0.07692307692307693,7
1996-11-23,Sunderland,Sheffield Weds,1,1,D,13,13,-1,-1,0.0,9,16,-7,0.23076923076923078,13,19,40,-13,0.2631578947368421,15,17,-2,0.38461538461538464,0,0,0,0,0,0,0,0,0.2,0.2,-6,-41,12,-0.2631578947368421,-0.15384615384615385,-5
1996-11-23,West Ham,Derby,1,1,D,13,15,51,-9,0.3684210526315789,12,17,-5,0.3076923076923077,13,17,-1,-1,0.0,14,15,-1,0.3076923076923077,0,0,0,0,0,0,0,0,0.4,0.4,-2,52,-8,0.3684210526315789,0.0,-4
1996-11-24,Arsenal,Tottenham,3,1,H,13,25,63,17,0.4473684210526316,24,11,13,0.5384615384615384,13,20,61,12,0.42105263157894735,14,11,3,0.46153846153846156,0,0,0,0,0,0,0,0,0.4,0.8,5,2,5,0.026315789473684237,0.07692307692307687,10
1996-11-25,Nott'm Forest,Blackburn,2,2,D,13,8,58,-4,0.3947368421052632,10,22,-12,0.07692307692307693,13,8,61,14,0.4736842105263158,11,17,-6,0.07692307692307693,0,0,1,0,0,0,0,0,0.0,0.2,0,-3,-18,-0.0789473684210526,0.0,-6
1996-11-30,Aston Villa,Middlesbrough,1,0,H,14,21,63,17,0.4736842105263158,18,15,3,0.42857142857142855,14,14,43,-15,0.2894736842105263,20,25,-5,0.21428571428571427,0,0,0,0,0,0,0,0,0.6,0.0,7,20,32,0.1842105263157895,0.21428571428571427,8
1996-11-30,Blackburn,Southampton,2,1,H,14,9,61,14,0.4736842105263158,13,19,-6,0.07142857142857142,14,13,38,-18,0.2368421052631579,22,26,-4,0.21428571428571427,0,0,0,0,0,0,0,0,0.2,0.4,-4,23,32,0.2368421052631579,-0.14285714285714285,-2
1996-11-30,Derby,Coventry,2,1,H,14,18,-1,-1,0.0,15,16,-1,0.2857142857142857,14,10,38,-18,0.21052631578947367,8,19,-11,0.07142857142857142,0,0,0,0,0,0,0,0,0.4,0.0,8,-39,17,-0.21052631578947367,0.21428571428571427,10
1996-11-30,Everton,Sunderland,1,3,A,14,23,61,20,0.4473684210526316,22,15,7,0.42857142857142855,14,14,-1,-1,0.0,10,17,-7,0.21428571428571427,0,0,0,0,0,0,0,0,0.6,0.2,9,62,21,0.4473684210526316,0.21428571428571427,14
1996-11-30,Man United,Leicester,3,1,H,14,23,82,38,0.6578947368421053,26,21,5,0.42857142857142855,14,17,-1,-1,0.0,13,18,-5,0.35714285714285715,0,0,0,0,0,0,0,0,0.2,0.4,6,83,39,0.6578947368421053,0.0714285714285714,10
1996-11-30,Newcastle,Arsenal,1,2,A,14,29,78,29,0.631578947368421,25,15,10,0.6428571428571429,14,28,63,17,0.4473684210526316,27,12,15,0.5714285714285714,0,0,0,0,0,0,0,0,0.4,0.4,1,15,12,0.18421052631578944,0.07142857142857151,-5
1996-11-30,Sheffield Weds,West Ham,0,0,D,14,20,40,-13,0.2631578947368421,16,18,-2,0.35714285714285715,14,16,51,-9,0.3684210526315789,13,18,-5,0.2857142857142857,0,0,0,0,0,0,0,0,0.2,0.4,4,-11,-4,-0.10526315789473684,0.07142857142857145,3
1996-11-30,Wimbledon,Nott'm Forest,1,0,H,14,25,41,-15,0.2631578947368421,25,16,9,0.5,14,9,58,-4,0.3947368421052632,12,24,-12,0.07142857142857142,0,0,0,0,0,0,0,0,0.2,0.0,16,-17,-11,-0.13157894736842113,0.4285714285714286,21
1996-12-01,Leeds,Chelsea,2,0,H,14,16,43,-17,0.3157894736842105,13,20,-7,0.35714285714285715,14,24,50,2,0.3157894736842105,23,19,4,0.42857142857142855,0,0,0,0,0,0,0,0,0.4,0.4,-8,-7,-19,0.0,-0.0714285714285714,-11
1996-12-02,Tottenham,Liverpool,0,2,A,14,20,61,12,0.42105263157894735,15,14,1,0.42857142857142855,14,28,71,36,0.5263157894736842,24,13,11,0.5714285714285714,0,0,0,0,0,0,0,0,0.6,0.4,-8,-10,-24,-0.10526315789473684,-0.14285714285714285,-10
1996-12-03,Middlesbrough,Leicester,0,2,A,15,14,43,-15,0.2894736842105263,20,26,-6,0.2,15,17,-1,-1,0.0,14,21,-7,0.3333333333333333,0,0,0,0,0,0,0,0,0.0,0.4,-3,44,-14,0.2894736842105263,-0.1333333333333333,1
1996-12-04,Arsenal,Southampton,3,1,H,15,31,63,17,0.4473684210526316,29,13,16,0.6,15,13,38,-18,0.2368421052631579,23,28,-5,0.2,0,0,0,0,0,0,1,0,0.6,0.2,18,25,35,0.21052631578947367,0.39999999999999997,21
1996-12-04,West Ham,Aston Villa,0,2,A,15,17,51,-9,0.3684210526315789,13,18,-5,0.26666666666666666,15,24,63,17,0.4736842105263158,19,15,4,0.4666666666666667,0,0,0,0,0,0,0,0,0.2,0.6,-7,-12,-26,-0.10526315789473689,-0.2,-9
1996-12-07,Arsenal,Derby,2,2,D,16,34,63,17,0.4473684210526316,32,14,18,0.625,15,21,-1,-1,0.0,17,17,0,0.3333333333333333,1,0,0,0,0,0,0,0,0.6,0.6,13,64,18,0.4473684210526316,0.2916666666666667,18
1996-12-07,Chelsea,Everton,2,2,D,15,24,50,2,0.3157894736842105,23,21,2,0.4,15,23,61,20,0.4473684210526316,23,18,5,0.4,0,0,0,0,0,0,0,0,0.4,0.4,1,-11,-18,-0.13157894736842107,0.0,-3
1996-12-07,Coventry,Tottenham,1,2,A,15,10,38,-18,0.21052631578947367,9,21,-12,0.06666666666666667,15,20,61,12,0.42105263157894735,15,16,-1,0.4,0,0,0,0,0,0,0,0,0.0,0.4,-10,-23,-30,-0.21052631578947367,-0.33333333333333337,-11
1996-12-07,Leicester,Blackburn,1,1,D,16,20,-1,-1,0.0,16,21,-5,0.375,15,12,61,14,0.4736842105263158,15,20,-5,0.13333333333333333,0,0,0,0,0,0,0,0,0.4,0.4,8,-62,-15,-0.4736842105263158,0.24166666666666667,0
1996-12-07,Liverpool,Sheffield Weds,0,1,A,15,31,71,36,0.5263157894736842,26,13,13,0.6,15,21,40,-13,0.2631578947368421,16,18,-2,0.3333333333333333,0,0,0,0,0,0,0,0,0.4,0.2,10,31,49,0.2631578947368421,0.26666666666666666,15
1996-12-07,Middlesbrough,Leeds,0,0,D,16,14,43,-15,0.2894736842105263,20,28,-8,0.1875,15,19,43,-17,0.3157894736842105,15,20,-5,0.4,0,0,0,0,0,0,0,0,0.0,0.6,-5,0,2,-0.02631578947368418,-0.21250000000000002,-3
1996-12-07,Southampton,Aston Villa,0,1,A,16,13,38,-18,0.2368421052631579,24,31,-7,0.1875,16,27,63,17,0.4736842105263158,21,15,6,0.5,0,0,1,0,1,0,0,0,0.0,0.8,-14,-25,-35,-0.2368421052631579,-0.3125,-13
1996-12-07,Sunderland,Wimbledon,1,3,A,15,17,-1,-1,0.0,13,18,-5,0.26666666666666666,15,28,41,-15,0.2631578947368421,26,16,10,0.5333333333333333,0,0,0,0,0,0,0,0,0.4,0.2,-11,-42,14,-0.2631578947368421,-0.26666666666666666,-15
1996-12-08,West Ham,Man United,2,2,D,16,17,51,-9,0.3684210526315789,13,20,-7,0.25,15,26,82,38,0.6578947368421053,29,22,7,0.4666666666666667,0,0,0,0,0,0,0,0,0.0,0.4,-9,-31,-47,-0.2894736842105264,-0.21666666666666667,-14
1996-12-09,Nott'm Forest,Newcastle,0,0,D,15,9,58,-4,0.3947368421052632,12,25,-13,0.06666666666666667,15,29,78,29,0.631578947368421,26,17,9,0.6,0,0,0,0,0,0,0,0,0.0,0.2,-20,-20,-33,-0.2368421052631578,-0.5333333333333333,-22
1996-12-14,Leeds,Tottenham,0,0,D,16,20,43,-17,0.3157894736842105,15,20,-5,0.375,16,23,61,12,0.42105263157894735,17,17,0,0.4375,0,0,0,0,0,0,0,0,0.6,0.6,-3,-18,-29,-0.10526315789473684,-0.0625,-5
1996-12-14,Liverpool,Middlesbrough,5,1,H,16,31,71,36,0.5263157894736842,26,14,12,0.5625,17,15,43,-15,0.2894736842105263,20,28,-8,0.17647058823529413,0,0,0,0,0,0,0,0,0.4,0.0,16,28,51,0.23684210526315785,0.38602941176470584,20
1996-12-14,Wimbledon,Blackburn,1,0,H,16,31,41,-15,0.2631578947368421,29,17,12,0.5625,16,13,61,14,0.4736842105263158,16,21,-5,0.125,0,0,0,0,0,0,0,0,0.4,0.4,18,-20,-29,-0.21052631578947373,0.4375,17
1996-12-15,Sunderland,Chelsea,3,0,H,16,17,-1,-1,0.0,14,21,-7,0.25,16,25,50,2,0.3157894736842105,25,23,2,0.375,0,0,0,0,0,0,0,0,0.2,0.2,-8,-51,-3,-0.3157894736842105,-0.125,-9
1996-12-16,Derby,Everton,0,1,A,16,22,-1,-1,0.0,19,19,0,0.3125,16,24,61,20,0.4473684210526316,25,20,5,0.375,0,0,0,0,0,0,0,0,0.6,0.4,-2,-62,-21,-0.4473684210526316,-0.0625,-5
1996-12-17,Coventry,Newcastle,2,1,H,16,10,38,-18,0.21052631578947367,10,23,-13,0.0625,16,30,78,29,0.631578947368421,26,17,9,0.5625,0,0,1,0,0,0,0,0,0.0,0.2,-20,-40,-47,-0.42105263157894735,-0.5,-22
1996-12-17,Liverpool,Nott'm Forest,4,2,H,17,34,71,36,0.5263157894736842,31,15,16,0.5882352941176471,16,10,58,-4,0.3947368421052632,12,25,-13,0.0625,0,0,0,0,0,0,0,0,0.4,0.0,24,13,40,0.13157894736842096,0.5257352941176471,29
1996-12-18,Sheffield Weds,Man United,1,1,D,16,24,40,-13,0.2631578947368421,17,18,-1,0.375,16,27,82,38,0.6578947368421053,31,24,7,0.4375,0,0,0,0,0,0,0,0,0.4,0.4,-3,-42,-51,-0.3947368421052632,-0.0625,-8
1996-12-21,Chelsea,West Ham,3,1,H,17,25,50,2,0.3157894736842105,25,26,-1,0.35294117647058826,17,18,51,-9,0.3684210526315789,15,22,-7,0.23529411764705882,0,0,0,0,0,0,0,0,0.0,0.0,7,-1,11,-0.05263157894736842,0.11764705882352944,6
1996-12-21,Everton,Leeds,0,0,D,17,27,61,20,0.4473684210526316,26,20,6,0.4117647058823529,17,21,43,-17,0.3157894736842105,15,20,-5,0.35294117647058826,0,0,0,0,0,0,0,0,0.4,0.4,6,18,37,0.13157894736842107,0.05882352941176466,11
1996-12-21,Leicester,Coventry,0,2,A,17,21,-1,-1,0.0,17,22,-5,0.35294117647058826,17,13,38,-18,0.21052631578947367,12,24,-12,0.11764705882352941,0,0,0,0,0,0,0,0,0.4,0.2,8,-39,17,-0.21052631578947367,0.23529411764705885,7
1996-12-21,Man United,Sunderland,5,0,H,17,28,82,38,0.6578947368421053,32,25,7,0.4117647058823529,17,20,-1,-1,0.0,17,21,-4,0.29411764705882354,0,0,0,0,0,0,0,0,0.4,0.4,8,83,39,0.6578947368421053,0.11764705882352938,11
1996-12-21,Nott'm Forest,Arsenal,2,1,H,17,10,58,-4,0.3947368421052632,14,29,-15,0.058823529411764705,17,35,63,17,0.4473684210526316,34,16,18,0.5882352941176471,0,0,0,0,0,0,0,0,0.0,0.6,-25,-5,-21,-0.05263157894736836,-0.5294117647058824,-33
1996-12-21,Southampton,Derby,3,1,H,17,13,38,-18,0.2368421052631579,24,32,-8,0.17647058823529413,17,22,-1,-1,0.0,19,20,-1,0.29411764705882354,0,0,1,1,0,0,0,0,0.0,0.4,-9,39,-17,0.2368421052631579,-0.11764705882352941,-7
1996-12-21,Tottenham,Sheffield Weds,1,1,D,17,24,61,12,0.42105263157894735,17,17,0,0.4117647058823529,17,25,40,-13,0.2631578947368421,18,19,-1,0.35294117647058826,0,0,0,0,0,0,0,0,0.4,0.4,-1,21,25,0.15789473684210525,0.05882352941176466,1
1996-12-22,Aston Villa,Wimbledon,5,0,H,17,30,63,17,0.4736842105263158,22,15,7,0.5294117647058824,17,34,41,-15,0.2631578947368421,30,17,13,0.5882352941176471,1,0,0,0,1,0,0,0,0.8,0.6,-4,22,32,0.21052631578947373,-0.05882352941176472,-6
1996-12-23,Newcastle,Liverpool,1,1,D,17,30,78,29,0.631578947368421,27,19,8,0.5294117647058824,18,37,71,36,0.5263157894736842,35,17,18,0.6111111111111112,0,0,0,0,0,0,0,0,0.0,0.6,-7,7,-7,0.10526315789473684,-0.0816993464052288,-10
1996-12-26,Aston Villa,Chelsea,0,2,A,18,33,63,17,0.4736842105263158,27,15,12,0.5555555555555556,18,28,50,2,0.3157894736842105,28,27,1,0.3888888888888889,1,1,0,0,0,0,0,0,1.0,0.2,5,13,15,0.1578947368421053,0.16666666666666669,11
1996-12-26,Blackburn,Newcastle,1,0,H,17,13,61,14,0.4736842105263158,16,22,-6,0.11764705882352941,18,31,78,29,0.631578947368421,28,20,8,0.5,0,0,0,0,0,0,0,0,0.2,0.0,-18,-17,-15,-0.1578947368421052,-0.38235294117647056,-14
1996-12-26,Leeds,Coventry,1,3,A,18,22,43,-17,0.3157894736842105,15,20,-5,0.3333333333333333,18,16,38,-18,0.21052631578947367,14,24,-10,0.16666666666666666,0,0,0,0,0,0,0,0,0.4,0.4,6,5,1,0.10526315789473684,0.16666666666666666,5
1996-12-26,Liverpool,Leicester,1,1,D,19,38,71,36,0.5263157894736842,36,18,18,0.5789473684210527,18,21,-1,-1,0.0,17,24,-7,0.3333333333333333,0,0,0,0,0,0,0,0,0.6,0.2,17,72,37,0.5263157894736842,0.24561403508771934,25
1996-12-26,Middlesbrough,Everton,4,2,H,18,15,43,-15,0.2894736842105263,21,33,-12,0.16666666666666666,18,28,61,20,0.4473684210526316,26,20,6,0.3888888888888889,0,0,0,0,0,0,0,0,0.0,0.4,-13,-18,-35,-0.15789473684210525,-0.22222222222222224,-18
1996-12-26,Nott'm Forest,Man United,0,4,A,18,13,58,-4,0.3947368421052632,16,30,-14,0.1111111111111111,18,31,82,38,0.6578947368421053,37,25,12,0.4444444444444444,0,0,0,0,0,0,0,0,0.2,0.4,-18,-24,-42,-0.2631578947368421,-0.3333333333333333,-26
1996-12-26,Sheffield Weds,Arsenal,0,0,D,18,26,40,-13,0.2631578947368421,19,20,-1,0.3333333333333333,18,35,63,17,0.4473684210526316,35,18,17,0.5555555555555556,0,0,0,0,0,0,0,0,0.2,0.6,-9,-23,-30,-0.1842105263157895,-0.22222222222222227,-18
1996-12-26,Sunderland,Derby,2,0,H,18,20,-1,-1,0.0,17,26,-9,0.2777777777777778,18,22,-1,-1,0.0,20,23,-3,0.2777777777777778,0,0,0,0,0,0,0,0,0.4,0.2,-2,0,0,0.0,0.0,-6
1996-12-26,Tottenham,Southampton,3,1,H,18,25,61,12,0.42105263157894735,18,18,0,0.3888888888888889,18,16,38,-18,0.2368421052631579,27,33,-6,0.2222222222222222,0,0,0,0,0,0,0,0,0.2,0.2,9,23,30,0.18421052631578944,0.16666666666666669,6
1996-12-28,Arsenal,Aston Villa,2,2,D,19,36,63,17,0.4473684210526316,35,18,17,0.5263157894736842,19,33,63,17,0.4736842105263158,27,17,10,0.5263157894736842,0,0,0,0,0,0,0,0,0.4,0.8,3,0,0,-0.026315789473684237,0.0,7
1996-12-28,Chelsea,Sheffield Weds,2,2,D,19,31,50,2,0.3157894736842105,30,27,3,0.42105263157894735,19,27,40,-13,0.2631578947368421,19,20,-1,0.3157894736842105,0,0,0,0,0,0,0,0,0.4,0.2,4,10,15,0.05263157894736842,0.10526315789473684,4
1996-12-28,Coventry,Middlesbrough,3,0,H,19,19,38,-18,0.21052631578947367,17,25,-8,0.21052631578947367,19,18,43,-15,0.2894736842105263,25,35,-10,0.21052631578947367,1,0,0,0,0,0,0,0,0.6,0.2,1,-5,-3,-0.07894736842105265,0.0,2
1996-12-28,Derby,Blackburn,0,0,D,19,22,-1,-1,0.0,20,25,-5,0.2631578947368421,18,16,61,14,0.4736842105263158,17,22,-5,0.16666666666666666,0,0,1,0,0,0,0,0,0.2,0.4,6,-62,-15,-0.4736842105263158,0.09649122807017543,0
1996-12-28,Everton,Wimbledon,1,3,A,19,28,61,20,0.4473684210526316,28,24,4,0.3684210526315789,18,34,41,-15,0.2631578947368421,30,22,8,0.5555555555555556,0,0,0,0,0,0,0,0,0.2,0.6,-6,20,35,0.1842105263157895,-0.18713450292397665,-4
1996-12-28,Leicester,Nott'm Forest,2,2,D,19,22,-1,-1,0.0,18,25,-7,0.3157894736842105,19,13,58,-4,0.3947368421052632,16,34,-18,0.10526315789473684,0,0,0,0,0,0,0,0,0.2,0.2,9,-59,3,-0.3947368421052632,0.21052631578947367,11
1996-12-28,Man United,Leeds,1,0,H,19,34,82,38,0.6578947368421053,41,25,16,0.47368421052631576,19,22,43,-17,0.3157894736842105,16,23,-7,0.3157894736842105,0,0,0,0,0,0,0,0,0.6,0.2,12,39,55,0.3421052631578948,0.15789473684210525,23
1996-12-28,Newcastle,Tottenham,7,1,H,19,31,78,29,0.631578947368421,28,21,7,0.47368421052631576,19,28,61,12,0.42105263157894735,21,19,2,0.42105263157894735,0,0,0,0,0,0,0,0,0.0,0.4,3,17,17,0.21052631578947367,0.05263157894736842,5
1996-12-28,West Ham,Sunderland,2,0,H,18,18,51,-9,0.3684210526315789,16,25,-9,0.2222222222222222,19,23,-1,-1,0.0,19,26,-7,0.3157894736842105,0,0,0,0,0,0,0,0,0.0,0.6,-5,52,-8,0.3684210526315789,-0.0935672514619883,-2
1996-12-29,Southampton,Liverpool,0,1,A,19,16,38,-18,0.2368421052631579,28,36,-8,0.21052631578947367,20,39,71,36,0.5263157894736842,37,19,18,0.55,0,0,0,0,0,0,0,0,0.2,0.4,-23,-33,-54,-0.28947368421052627,-0.33947368421052637,-26
1997-01-01,Arsenal,Middlesbrough,2,0,H,20,37,63,17,0.4473684210526316,37,20,17,0.5,20,18,43,-15,0.2894736842105263,25,38,-13,0.2,0,0,0,0,0,0,0,0,0.2,0.2,19,20,32,0.15789473684210525,0.3,30
1997-01-01,Chelsea,Liverpool,1,0,H,20,32,50,2,0.3157894736842105,32,29,3,0.4,21,42,71,36,0.5263157894736842,38,19,19,0.5714285714285714,0,0,0,0,0,0,0,0,0.4,0.6,-10,-21,-34,-0.21052631578947367,-0.17142857142857137,-16
1997-01-01,Coventry,Sunderland,2,2,D,20,22,38,-18,0.21052631578947367,20,25,-5,0.25,20,23,-1,-1,0.0,19,28,-9,0.3,1,0,0,0,0,0,0,0,0.8,0.4,-1,39,-17,0.21052631578947367,-0.04999999999999999,4
1997-01-01,Everton,Blackburn,0,2,A,20,28,61,20,0.4473684210526316,29,27,2,0.35,19,17,61,14,0.4736842105263158,17,22,-5,0.15789473684210525,0,0,0,0,0,0,0,0,0.2,0.4,11,0,6,-0.026315789473684237,0.19210526315789472,7
1997-01-01,Man United,Aston Villa,0,0,D,20,37,82,38,0.6578947368421053,42,25,17,0.5,20,34,63,17,0.4736842105263158,29,19,10,0.5,1,0,0,0,0,0,0,0,0.6,0.6,3,19,21,0.1842105263157895,0.0,7
1997-01-01,Newcastle,Leeds,3,0,H,20,34,78,29,0.631578947368421,35,22,13,0.5,20,22,43,-17,0.3157894736842105,16,24,-8,0.3,0,0,0,0,0,0,0,0,0.2,0.0,12,35,46,0.3157894736842105,0.2,21
1997-01-01,West Ham,Nott'm Forest,0,1,A,19,21,51,-9,0.3684210526315789,18,25,-7,0.2631578947368421,20,14,58,-4,0.3947368421052632,18,36,-18,0.1,0,0,0,0,0,0,0,0,0.2,0.2,7,-7,-5,-0.026315789473684292,0.16315789473684209,11
1997-01-11,Aston Villa,Newcastle,2,2,D,21,35,63,17,0.4736842105263158,29,19,10,0.47619047619047616,21,37,78,29,0.631578947368421,38,22,16,0.5238095238095238,0,0,0,0,0,0,0,0,0.4,0.4,-2,-15,-12,-0.1578947368421052,-0.04761904761904767,-6
1997-01-11,Blackburn,Coventry,4,0,H,20,20,61,14,0.4736842105263158,19,22,-3,0.2,21,23,38,-18,0.21052631578947367,22,27,-5,0.23809523809523808,0,0,0,0,0,0,0,0,0.4,0.8,-3,23,32,0.26315789473684215,-0.03809523809523807,2
1997-01-11,Leeds,Leicester,3,0,H,21,22,43,-17,0.3157894736842105,16,27,-11,0.2857142857142857,20,23,-1,-1,0.0,20,27,-7,0.3,0,0,1,0,0,0,0,0,0.0,0.2,-1,44,-16,0.3157894736842105,-0.01428571428571429,-4
1997-01-11,Liverpool,West Ham,0,0,D,22,42,71,36,0.5263157894736842,38,20,18,0.5454545454545454,20,21,51,-9,0.3684210526315789,18,26,-8,0.25,0,0,0,0,0,0,0,0,0.4,0.2,21,20,45,0.15789473684210525,0.2954545454545454,26
1997-01-11,Middlesbrough,Southampton,0,1,A,21,18,43,-15,0.2894736842105263,25,40,-15,0.19047619047619047,20,16,38,-18,0.2368421052631579,28,37,-9,0.2,0,0,0,0,0,0,0,0,0.2,0.2,2,5,3,0.05263157894736842,-0.009523809523809545,-6
1997-01-11,Nott'm Forest,Chelsea,2,0,H,21,17,58,-4,0.3947368421052632,19,36,-17,0.14285714285714285,21,35,50,2,0.3157894736842105,33,29,4,0.42857142857142855,0,0,0,0,0,0,0,0,0.4,0.6,-18,8,-6,0.07894736842105271,-0.2857142857142857,-21
1997-01-11,Sheffield Weds,Everton,2,1,H,20,28,40,-13,0.2631578947368421,21,22,-1,0.3,21,28,61,20,0.4473684210526316,29,29,0,0.3333333333333333,0,0,0,0,0,0,1,0,0.2,0.2,0,-21,-33,-0.1842105263157895,-0.033333333333333326,-1
1997-01-11,Sunderland,Arsenal,1,0,H,21,24,-1,-1,0.0,21,30,-9,0.2857142857142857,21,40,63,17,0.4473684210526316,39,20,19,0.5238095238095238,0,0,0,0,0,0,0,0,0.4,0.2,-16,-64,-18,-0.4473684210526316,-0.23809523809523814,-28
1997-01-11,Wimbledon,Derby,1,1,D,19,37,41,-15,0.2631578947368421,33,23,10,0.5789473684210527,20,23,-1,-1,0.0,20,25,-5,0.25,0,0,0,0,0,0,0,0,0.8,0.0,14,42,-14,0.2631578947368421,0.32894736842105265,15
1997-01-12,Tottenham,Man United,1,2,A,20,28,61,12,0.42105263157894735,22,26,-4,0.4,21,38,82,38,0.6578947368421053,42,25,17,0.47619047619047616,0,0,0,0,0,0,0,0,0.4,0.6,-10,-21,-26,-0.23684210526315796,-0.07619047619047614,-21
1997-01-18,Chelsea,Derby,3,1,H,22,35,50,2,0.3157894736842105,33,31,2,0.4090909090909091,21,24,-1,-1,0.0,21,26,-5,0.23809523809523808,0,0,0,0,0,0,0,0,0.6,0.0,11,51,3,0.3157894736842105,0.17099567099567103,7
1997-01-18,Coventry,Man United,0,2,A,22,23,38,-18,0.21052631578947367,22,31,-9,0.22727272727272727,22,41,82,38,0.6578947368421053,44,26,18,0.5,0,0,0,0,0,0,0,0,0.6,0.8,-18,-44,-56,-0.44736842105263164,-0.2727272727272727,-27
1997-01-18,Leicester,Wimbledon,1,0,H,21,23,-1,-1,0.0,20,30,-10,0.2857142857142857,20,38,41,-15,0.2631578947368421,34,24,10,0.55,0,0,0,0,0,0,0,0,0.0,0.6,-15,-42,14,-0.2631578947368421,-0.26428571428571435,-20
1997-01-18,Liverpool,Aston Villa,3,0,H,23,43,71,36,0.5263157894736842,38,20,18,0.5217391304347826,22,36,63,17,0.4736842105263158,31,21,10,0.45454545454545453,0,0,0,0,0,0,0,0,0.2,0.2,7,8,19,0.05263157894736836,0.06719367588932806,8
1997-01-18,Middlesbrough,Sheffield Weds,4,2,H,22,18,43,-15,0.2894736842105263,25,41,-16,0.18181818181818182,21,31,40,-13,0.2631578947368421,23,23,0,0.3333333333333333,0,0,1,0,0,0,0,0,0.2,0.2,-13,3,-2,0.026315789473684237,-0.1515151515151515,-16
1997-01-18,Southampton,Newcastle,2,2,D,21,19,38,-18,0.2368421052631579,29,37,-8,0.23809523809523808,22,38,78,29,0.631578947368421,40,24,16,0.5,0,0,0,0,0,0,0,0,0.4,0.4,-19,-40,-47,-0.3947368421052631,-0.2619047619047619,-24
1997-01-18,Sunderland,Blackburn,0,0,D,22,27,-1,-1,0.0,22,30,-8,0.3181818181818182,21,23,61,14,0.4736842105263158,23,22,1,0.23809523809523808,0,0,0,0,0,0,0,0,0.4,0.6,4,-62,-15,-0.4736842105263158,0.0800865800865801,-9
1997-01-19,Arsenal,Everton,3,1,H,22,40,63,17,0.4473684210526316,39,21,18,0.5,22,28,61,20,0.4473684210526316,30,31,-1,0.3181818181818182,0,0,0,0,0,0,1,0,0.2,0.0,12,2,-3,0.0,0.18181818181818182,19
1997-01-19,Nott'm Forest,Tottenham,2,1,H,22,20,58,-4,0.3947368421052632,21,36,-15,0.18181818181818182,21,28,61,12,0.42105263157894735,23,28,-5,0.38095238095238093,0,0,0,0,0,0,0,0,0.6,0.2,-8,-3,-16,-0.026315789473684126,-0.1991341991341991,-10
1997-01-20,West Ham,Leeds,0,2,A,21,22,51,-9,0.3684210526315789,18,26,-8,0.23809523809523808,22,25,43,-17,0.3157894736842105,19,27,-8,0.3181818181818182,0,0,0,0,0,0,0,0,0.2,0.2,-3,8,8,0.05263157894736842,-0.0800865800865801,0
1997-01-29,Aston Villa,Sheffield Weds,0,1,A,23,36,63,17,0.4736842105263158,31,24,7,0.43478260869565216,22,31,40,-13,0.2631578947368421,25,27,-2,0.3181818181818182,0,0,0,0,0,0,0,0,0.0,0.2,5,23,30,0.21052631578947373,0.11660079051383399,9
1997-01-29,Leeds,Derby,0,0,D,23,28,43,-17,0.3157894736842105,21,27,-6,0.34782608695652173,22,24,-1,-1,0.0,22,29,-7,0.22727272727272727,0,0,0,0,0,0,0,0,0.4,0.0,4,44,-16,0.3157894736842105,0.12055335968379446,1
1997-01-29,Leicester,Sunderland,1,1,D,22,26,-1,-1,0.0,21,30,-9,0.3181818181818182,23,28,-1,-1,0.0,22,30,-8,0.30434782608695654,0,0,0,0,0,0,0,0,0.2,0.4,-2,0,0,0.0,0.013833992094861636,-1
1997-01-29,Man United,Wimbledon,2,1,H,23,44,82,38,0.6578947368421053,46,26,20,0.5217391304347826,21,38,41,-15,0.2631578947368421,34,25,9,0.5238095238095238,0,0,0,0,0,0,0,0,0.8,0.4,6,41,53,0.3947368421052632,-0.0020703933747412417,11
1997-01-29,Newcastle,Everton,4,1,H,23,39,78,29,0.631578947368421,42,26,16,0.4782608695652174,23,28,61,20,0.4473684210526316,31,34,-3,0.30434782608695654,0,0,0,0,0,0,1,1,0.4,0.0,11,17,9,0.18421052631578944,0.17391304347826086,19
1997-01-29,Nott'm Forest,Coventry,0,1,A,23,23,58,-4,0.3947368421052632,23,37,-14,0.21739130434782608,23,23,38,-18,0.21052631578947367,22,33,-11,0.21739130434782608,1,0,0,0,0,0,0,0,0.6,0.4,0,20,14,0.18421052631578955,0.0,-3
1997-01-29,Tottenham,Blackburn,2,1,H,22,28,61,12,0.42105263157894735,24,30,-6,0.36363636363636365,22,24,61,14,0.4736842105263158,23,22,1,0.22727272727272727,0,0,1,0,0,0,0,0,0.2,0.6,4,0,-2,-0.052631578947368474,0.13636363636363638,-7
1997-01-29,West Ham,Arsenal,1,2,A,22,22,51,-9,0.3684210526315789,18,28,-10,0.22727272727272727,23,43,63,17,0.4473684210526316,42,22,20,0.5217391304347826,0,0,0,0,0,0,0,0,0.2,0.4,-21,-12,-26,-0.07894736842105265,-0.2944664031620553,-30
1997-02-01,Aston Villa,Sunderland,1,0,H,24,36,63,17,0.4736842105263158,31,25,6,0.4166666666666667,24,29,-1,-1,0.0,23,31,-8,0.2916666666666667,0,0,0,0,0,0,0,0,0.0,0.2,7,64,18,0.4736842105263158,0.125,14
1997-02-01,Blackburn,West Ham,2,1,H,23,24,61,14,0.4736842105263158,24,24,0,0.21739130434782608,23,22,51,-9,0.3684210526315789,19,30,-11,0.21739130434782608,0,0,0,0,0,0,0,0,0.4,0.2,2,10,23,0.10526315789473689,0.0,11
1997-02-01,Derby,Liverpool,0,1,A,23,25,-1,-1,0.0,22,29,-7,0.21739130434782608,24,46,71,36,0.5263157894736842,41,20,21,0.5416666666666666,0,0,0,0,0,0,0,0,0.0,0.4,-21,-72,-37,-0.5263157894736842,-0.3242753623188406,-28
1997-02-01,Everton,Nott'm Forest,2,0,H,24,28,61,20,0.4473684210526316,32,38,-6,0.2916666666666667,24,23,58,-4,0.3947368421052632,23,38,-15,0.20833333333333334,0,0,1,1,0,0,0,0,0.0,0.6,5,3,24,0.05263157894736836,0.08333333333333334,9
1997-02-01,Leeds,Arsenal,0,0,D,24,29,43,-17,0.3157894736842105,21,27,-6,0.3333333333333333,24,46,63,17,0.4473684210526316,44,23,21,0.5416666666666666,0,0,0,0,0,0,0,0,0.4,0.6,-17,-20,-34,-0.13157894736842107,-0.20833333333333331,-27
1997-02-01,Man United,Southampton,2,1,H,24,47,82,38,0.6578947368421053,48,27,21,0.5416666666666666,22,20,38,-18,0.2368421052631579,31,39,-8,0.22727272727272727,1,0,0,0,0,0,0,0,0.8,0.4,27,44,56,0.4210526315789474,0.31439393939393934,29
1997-02-01,Sheffield Weds,Coventry,0,0,D,23,34,40,-13,0.2631578947368421,26,27,-1,0.34782608695652173,24,26,38,-18,0.21052631578947367,23,33,-10,0.25,0,0,0,0,0,0,0,0,0.4,0.4,8,2,5,0.05263157894736842,0.09782608695652173,9
1997-02-01,Tottenham,Chelsea,1,2,A,23,31,61,12,0.42105263157894735,26,31,-5,0.391304347826087,23,38,50,2,0.3157894736842105,36,32,4,0.43478260869565216,0,0,0,0,0,0,0,0,0.4,0.6,-7,11,10,0.10526315789473684,-0.04347826086956519,-9
1997-02-01,Wimbledon,Middlesbrough,1,1,D,22,38,41,-15,0.2631578947368421,35,27,8,0.5,23,21,43,-15,0.2894736842105263,29,43,-14,0.21739130434782608,0,0,0,0,0,0,0,0,0.2,0.4,17,-2,0,-0.026315789473684237,0.28260869565217395,22
1997-02-02,Newcastle,Leicester,4,3,H,24,42,78,29,0.631578947368421,46,27,19,0.5,23,27,-1,-1,0.0,22,31,-9,0.30434782608695654,0,0,0,0,0,0,0,0,0.6,0.2,15,79,30,0.631578947368421,0.19565217391304346,28
1997-02-15,Derby,West Ham,1,0,H,24,25,-1,-1,0.0,22,30,-8,0.20833333333333334,24,22,51,-9,0.3684210526315789,20,32,-12,0.20833333333333334,0,0,0,0,0,0,1,0,0.0,0.0,3,-52,8,-0.3684210526315789,0.0,4
1997-02-15,Tottenham,Arsenal,0,0,D,24,31,61,12,0.42105263157894735,27,33,-6,0.375,25,47,63,17,0.4473684210526316,44,23,21,0.52,0,0,0,0,0,0,0,0,0.2,0.6,-16,-2,-5,-0.026315789473684237,-0.14500000000000002,-27
1997-02-19,Arsenal,Man United,1,2,A,26,48,63,17,0.4473684210526316,44,23,21,0.5,25,50,82,38,0.6578947368421053,50,28,22,0.56,0,0,0,0,1,0,0,0,0.4,0.8,-2,-19,-21,-0.21052631578947373,-0.06000000000000005,-1
1997-02-19,Aston Villa,Coventry,2,1,H,25,39,63,17,0.4736842105263158,32,25,7,0.44,25,27,38,-18,0.21052631578947367,23,33,-10,0.24,0,0,0,0,0,0,0,0,0.2,0.2,12,25,35,0.26315789473684215,0.2,17
1997-02-19,Derby,Sheffield Weds,2,2,D,25,28,-1,-1,0.0,23,30,-7,0.24,24,35,40,-13,0.2631578947368421,26,27,-1,0.3333333333333333,0,0,0,0,0,0,0,0,0.2,0.4,-7,-41,12,-0.2631578947368421,-0.09333333333333332,-6
1997-02-19,Liverpool,Leeds,4,0,H,25,49,71,36,0.5263157894736842,42,20,22,0.56,25,30,43,-17,0.3157894736842105,21,27,-6,0.32,0,0,0,0,0,0,0,0,0.6,0.4,19,28,53,0.21052631578947367,0.24000000000000005,28
1997-02-22,Chelsea,Man United,1,1,D,24,41,50,2,0.3157894736842105,38,33,5,0.4583333333333333,26,53,82,38,0.6578947368421053,52,29,23,0.5769230769230769,0,0,0,0,1,1,0,0,0.6,1.0,-12,-32,-36,-0.3421052631578948,-0.11858974358974356,-18
1997-02-22,Coventry,Everton,0,0,D,26,27,38,-18,0.21052631578947367,24,35,-11,0.23076923076923078,25,31,61,20,0.4473684210526316,34,38,-4,0.32,0,0,0,0,0,0,0,0,0.2,0.2,-4,-23,-38,-0.2368421052631579,-0.08923076923076922,-7
1997-02-22,Leicester,Derby,4,2,H,24,27,-1,-1,0.0,25,35,-10,0.2916666666666667,26,29,-1,-1,0.0,25,32,-7,0.23076923076923078,0,0,0,0,0,0,0,0,0.2,0.2,-2,0,0,0.0,0.0608974358974359,-3
1997-02-22,Liverpool,Blackburn,0,0,D,26,52,71,36,0.5263157894736842,46,20,26,0.5769230769230769,24,27,61,14,0.4736842105263158,26,25,1,0.25,1,0,0,0,0,0,0,0,0.6,0.6,25,10,22,0.05263157894736836,0.32692307692307687,25
1997-02-22,Middlesbrough,Newcastle,0,1,A,24,22,43,-15,0.2894736842105263,30,44,-14,0.20833333333333334,25,45,78,29,0.631578947368421,50,30,20,0.52,0,0,0,0,0,0,0,0,0.2,0.6,-23,-35,-44,-0.3421052631578947,-0.31166666666666665,-34
1997-02-22,Nott'm Forest,Aston Villa,0,0,D,25,23,58,-4,0.3947368421052632,23,40,-17,0.2,26,42,63,17,0.4736842105263158,34,26,8,0.46153846153846156,0,0,0,0,0,0,0,0,0.6,0.4,-19,-5,-21,-0.0789473684210526,-0.26153846153846155,-25
1997-02-22,Southampton,Sheffield Weds,2,3,A,23,20,38,-18,0.2368421052631579,32,41,-9,0.21739130434782608,25,36,40,-13,0.2631578947368421,28,29,-1,0.32,0,0,0,0,0,0,0,0,0.2,0.4,-16,-2,-5,-0.02631578947368418,-0.10260869565217393,-8
1997-02-22,Sunderland,Leeds,0,1,A,25,29,-1,-1,0.0,23,32,-9,0.28,26,30,43,-17,0.3157894736842105,21,31,-10,0.3076923076923077,0,0,0,0,0,0,0,0,0.2,0.4,-1,-44,16,-0.3157894736842105,-0.027692307692307683,1
1997-02-23,Arsenal,Wimbledon,0,1,A,27,48,63,17,0.4473684210526316,45,25,20,0.48148148148148145,23,39,41,-15,0.2631578947368421,36,28,8,0.4782608695652174,0,0,0,0,0,0,0,0,0.4,0.2,9,22,32,0.1842105263157895,0.003220611916264049,12
1997-02-24,West Ham,Tottenham,4,3,H,25,22,51,-9,0.3684210526315789,20,33,-13,0.2,25,32,61,12,0.42105263157894735,27,33,-6,0.36,0,0,1,0,0,0,0,0,0.0,0.2,-10,-10,-21,-0.05263157894736842,-0.15999999999999998,-7
1997-02-26,Southampton,Wimbledon,0,0,D,24,20,38,-18,0.2368421052631579,34,44,-10,0.20833333333333334,24,42,41,-15,0.2631578947368421,37,28,9,0.5,0,0,0,0,0,0,0,0,0.2,0.2,-22,-3,-3,-0.02631578947368418,-0.29166666666666663,-19
1997-03-01,Blackburn,Sunderland,1,0,H,25,28,61,14,0.4736842105263158,26,25,1,0.24,26,29,-1,-1,0.0,23,33,-10,0.2692307692307692,0,0,0,0,0,0,0,0,0.4,0.2,-1,62,15,0.4736842105263158,-0.029230769230769227,11
1997-03-01,Derby,Chelsea,3,2,H,27,29,-1,-1,0.0,27,36,-9,0.2222222222222222,25,42,50,2,0.3157894736842105,39,34,5,0.44,0,0,0,0,0,0,0,0,0.2,0.6,-13,-51,-3,-0.3157894736842105,-0.2177777777777778,-14
1997-03-01,Everton,Arsenal,0,2,A,26,32,61,20,0.4473684210526316,34,38,-4,0.3076923076923077,28,48,63,17,0.4473684210526316,45,26,19,0.4642857142857143,0,0,0,0,0,0,0,0,0.2,0.2,-16,-2,3,0.0,-0.1565934065934066,-23
1997-03-01,Leeds,West Ham,1,0,H,27,33,43,-17,0.3157894736842105,22,31,-9,0.3333333333333333,26,25,51,-9,0.3684210526315789,24,36,-12,0.23076923076923078,0,0,0,0,0,0,0,0,0.4,0.2,8,-8,-8,-0.05263157894736842,0.10256410256410253,3
1997-03-01,Man United,Coventry,3,1,H,27,54,82,38,0.6578947368421053,53,30,23,0.5555555555555556,27,28,38,-18,0.21052631578947367,24,35,-11,0.2222222222222222,0,0,0,0,0,0,0,0,0.8,0.2,26,44,56,0.44736842105263164,0.33333333333333337,34
1997-03-01,Newcastle,Southampton,0,1,A,26,48,78,29,0.631578947368421,51,30,21,0.5384615384615384,25,21,38,-18,0.2368421052631579,34,44,-10,0.2,1,0,0,0,0,0,0,0,0.6,0.2,27,40,47,0.3947368421052631,0.3384615384615384,31
1997-03-01,Sheffield Weds,Middlesbrough,3,1,H,26,39,40,-13,0.2631578947368421,31,31,0,0.34615384615384615,25,22,43,-15,0.2894736842105263,30,45,-15,0.2,0,0,0,0,0,0,0,0,0.4,0.2,17,-3,2,-0.026315789473684237,0.14615384615384613,15
1997-03-01,Tottenham,Nott'm Forest,0,1,A,26,32,61,12,0.42105263157894735,30,37,-7,0.34615384615384615,26,24,58,-4,0.3947368421052632,23,40,-17,0.19230769230769232,0,0,0,0,0,0,0,0,0.2,0.4,8,3,16,0.026315789473684126,0.15384615384615383,10
1997-03-01,Wimbledon,Leicester,1,3,A,25,43,41,-15,0.2631578947368421,37,28,9,0.48,25,30,-1,-1,0.0,29,37,-8,0.32,0,0,0,0,0,0,0,0,0.2,0.4,13,42,-14,0.2631578947368421,0.15999999999999998,17
1997-03-02,Aston Villa,Liverpool,1,0,H,27,43,63,17,0.4736842105263158,34,26,8,0.4444444444444444,27,53,71,36,0.5263157894736842,46,20,26,0.5555555555555556,0,0,0,0,0,0,0,0,0.4,0.6,-10,-8,-19,-0.05263157894736836,-0.11111111111111116,-18
1997-03-03,Coventry,Wimbledon,1,1,D,28,28,38,-18,0.21052631578947367,25,38,-13,0.21428571428571427,26,43,41,-15,0.2631578947368421,38,31,7,0.46153846153846156,0,0,0,0,0,0,0,0,0.2,0.2,-15,-3,-3,-0.05263157894736842,-0.2472527472527473,-20
1997-03-04,Sunderland,Tottenham,0,4,A,27,29,-1,-1,0.0,23,34,-11,0.25925925925925924,27,32,61,12,0.42105263157894735,30,38,-8,0.3333333333333333,0,0,1,0,0,0,0,0,0.0,0.2,-3,-62,-13,-0.42105263157894735,-0.07407407407407407,-3
1997-03-05,Chelsea,Blackburn,1,1,D,26,42,50,2,0.3157894736842105,41,37,4,0.4230769230769231,26,31,61,14,0.4736842105263158,27,25,2,0.2692307692307692,0,0,0,0,0,0,0,0,0.4,0.4,11,-11,-12,-0.1578947368421053,0.15384615384615385,2
1997-03-05,Leicester,Aston Villa,1,0,H,26,33,-1,-1,0.0,32,38,-6,0.34615384615384615,28,46,63,17,0.4736842105263158,35,26,9,0.4642857142857143,0,0,0,0,0,0,0,0,0.6,0.6,-13,-64,-18,-0.4736842105263158,-0.11813186813186816,-15
1997-03-05,Middlesbrough,Derby,6,1,H,26,22,43,-15,0.2894736842105263,31,48,-17,0.19230769230769232,28,32,-1,-1,0.0,30,38,-8,0.25,0,0,0,0,0,0,0,0,0.2,0.4,-10,44,-14,0.2894736842105263,-0.05769230769230768,-9
1997-03-05,Nott'm Forest,Sheffield Weds,0,3,A,27,27,58,-4,0.3947368421052632,24,40,-16,0.2222222222222222,27,42,40,-13,0.2631578947368421,34,32,2,0.37037037037037035,0,0,0,0,0,0,0,0,0.4,0.6,-15,18,9,0.13157894736842113,-0.14814814814814814,-18
1997-03-05,Southampton,Everton,2,2,D,26,24,38,-18,0.2368421052631579,35,44,-9,0.23076923076923078,27,32,61,20,0.4473684210526316,34,40,-6,0.2962962962962963,0,0,0,0,0,0,0,0,0.2,0.2,-8,-23,-38,-0.21052631578947367,-0.0655270655270655,-3
1997-03-08,Arsenal,Nott'm Forest,2,0,H,29,51,63,17,0.4473684210526316,47,26,21,0.4827586206896552,28,27,58,-4,0.3947368421052632,24,43,-19,0.21428571428571427,0,0,0,0,0,0,0,0,0.2,0.2,24,5,21,0.05263157894736836,0.26847290640394095,40
1997-03-08,Coventry,Leicester,0,0,D,29,29,38,-18,0.21052631578947367,26,39,-13,0.20689655172413793,27,36,-1,-1,0.0,33,38,-5,0.37037037037037035,0,0,0,0,1,0,0,0,0.0,0.6,-7,39,-17,0.21052631578947367,-0.16347381864623242,-8
1997-03-08,Leeds,Everton,1,0,H,28,36,43,-17,0.3157894736842105,23,31,-8,0.35714285714285715,28,33,61,20,0.4473684210526316,36,42,-6,0.2857142857142857,0,0,0,0,0,0,0,0,0.4,0.2,3,-18,-37,-0.13157894736842107,0.07142857142857145,-2
1997-03-08,Sunderland,Man United,2,1,H,28,29,-1,-1,0.0,23,38,-15,0.25,28,57,82,38,0.6578947368421053,56,31,25,0.5714285714285714,0,0,1,0,0,0,0,0,0.0,0.8,-28,-83,-39,-0.6578947368421053,-0.3214285714285714,-40
1997-03-10,Liverpool,Newcastle,4,3,H,28,53,71,36,0.5263157894736842,46,21,25,0.5357142857142857,27,48,78,29,0.631578947368421,51,31,20,0.5185185185185185,0,0,0,0,0,0,0,0,0.6,0.6,5,-7,7,-0.10526315789473684,0.01719576719576721,5
1997-03-11,Blackburn,Nott'm Forest,1,1,D,27,32,61,14,0.4736842105263158,28,26,2,0.25925925925925924,29,27,58,-4,0.3947368421052632,24,45,-21,0.20689655172413793,0,0,0,0,0,0,0,0,0.4,0.2,5,3,18,0.0789473684210526,0.05236270753512132,23
1997-03-12,Leeds,Southampton,0,0,D,29,39,43,-17,0.3157894736842105,24,31,-7,0.3793103448275862,27,25,38,-18,0.2368421052631579,37,46,-9,0.2222222222222222,1,0,0,0,0,0,0,0,0.6,0.2,14,5,1,0.0789473684210526,0.15708812260536398,2
1997-03-12,Sheffield Weds,Sunderland,2,1,H,28,45,40,-13,0.2631578947368421,37,32,5,0.39285714285714285,29,32,-1,-1,0.0,25,39,-14,0.27586206896551724,1,0,0,0,0,0,0,0,0.6,0.2,13,41,-12,0.2631578947368421,0.11699507389162561,19
1997-03-12,West Ham,Chelsea,3,2,H,27,25,51,-9,0.3684210526315789,24,37,-13,0.2222222222222222,27,43,50,2,0.3157894736842105,42,38,4,0.4074074074074074,0,0,0,0,0,0,0,0,0.2,0.4,-18,1,-11,0.05263157894736842,-0.18518518518518517,-17
1997-03-15,Aston Villa,West Ham,0,0,D,29,46,63,17,0.4736842105263158,35,27,8,0.4482758620689655,28,28,51,-9,0.3684210526315789,27,39,-12,0.25,0,0,0,0,0,0,0,0,0.6,0.4,18,12,26,0.10526315789473689,0.19827586206896552,20
1997-03-15,Blackburn,Wimbledon,3,1,H,28,33,61,14,0.4736842105263158,29,27,2,0.25,27,44,41,-15,0.2631578947368421,39,32,7,0.4444444444444444,0,0,0,0,0,0,0,0,0.4,0.2,-11,20,29,0.21052631578947373,-0.19444444444444442,-5
1997-03-15,Everton,Derby,1,0,H,29,33,61,20,0.4473684210526316,36,43,-7,0.27586206896551724,29,32,-1,-1,0.0,31,44,-13,0.2413793103448276,0,0,0,0,0,0,0,0,0.2,0.4,1,62,21,0.4473684210526316,0.03448275862068964,6
1997-03-15,Leicester,Middlesbrough,1,3,A,28,37,-1,-1,0.0,33,38,-5,0.35714285714285715,27,25,43,-15,0.2894736842105263,37,49,-12,0.2222222222222222,0,0,0,0,0,0,0,0,0.6,0.4,12,-44,14,-0.2894736842105263,0.13492063492063494,7
1997-03-15,Man United,Sheffield Weds,2,0,H,29,57,82,38,0.6578947368421053,57,33,24,0.5517241379310345,29,48,40,-13,0.2631578947368421,39,33,6,0.41379310344827586,0,0,0,0,1,0,0,0,0.6,0.8,9,42,51,0.3947368421052632,0.13793103448275862,18
1997-03-15,Newcastle,Coventry,4,0,H,28,48,78,29,0.631578947368421,54,35,19,0.5,30,30,38,-18,0.21052631578947367,26,39,-13,0.2,0,0,0,0,0,0,0,0,0.6,0.0,18,40,47,0.42105263157894735,0.3,32
1997-03-15,Nott'm Forest,Liverpool,1,1,D,30,28,58,-4,0.3947368421052632,25,46,-21,0.2,29,56,71,36,0.5263157894736842,50,24,26,0.5517241379310345,0,0,0,0,0,0,0,0,0.2,0.6,-28,-13,-40,-0.13157894736842096,-0.35172413793103446,-47
1997-03-15,Southampton,Arsenal,0,2,A,28,26,38,-18,0.2368421052631579,37,46,-9,0.21428571428571427,30,54,63,17,0.4473684210526316,49,26,23,0.5,0,0,0,0,0,0,0,0,0.2,0.4,-28,-25,-35,-0.21052631578947367,-0.2857142857142857,-32
1997-03-15,Tottenham,Leeds,1,0,H,28,35,61,12,0.42105263157894735,34,38,-4,0.35714285714285715,30,40,43,-17,0.3157894736842105,24,31,-7,0.36666666666666664,0,0,0,0,0,0,0,0,0.2,0.6,-5,18,29,0.10526315789473684,-0.00952380952380949,3
1997-03-16,Chelsea,Sunderland,6,2,H,28,43,50,2,0.3157894736842105,44,41,3,0.39285714285714285,30,32,-1,-1,0.0,26,41,-15,0.26666666666666666,0,0,0,0,0,0,0,0,0.2,0.2,11,51,3,0.3157894736842105,0.1261904761904762,18
1997-03-18,Wimbledon,West Ham,1,1,D,28,44,41,-15,0.2631578947368421,40,35,5,0.42857142857142855,29,29,51,-9,0.3684210526315789,27,39,-12,0.2413793103448276,0,0,0,0,0,0,0,0,0.2,0.4,15,-10,-6,-0.10526315789473684,0.18719211822660095,17
1997-03-19,Chelsea,Southampton,1,0,H,29,46,50,2,0.3157894736842105,50,43,7,0.41379310344827586,29,26,38,-18,0.2368421052631579,37,48,-11,0.20689655172413793,0,0,0,0,0,0,0,0,0.2,0.2,20,12,20,0.0789473684210526,0.20689655172413793,18
1997-03-19,Leicester,Tottenham,1,1,D,29,37,-1,-1,0.0,34,41,-7,0.3448275862068966,29,38,61,12,0.42105263157894735,35,38,-3,0.3793103448275862,0,0,0,0,0,0,0,0,0.6,0.4,-1,-62,-13,-0.42105263157894735,-0.03448275862068961,-4
1997-03-19,Middlesbrough,Blackburn,2,1,H,28,28,43,-15,0.2894736842105263,40,50,-10,0.25,29,36,61,14,0.4736842105263158,32,28,4,0.27586206896551724,0,0,0,0,0,0,0,0,0.4,0.4,-8,-18,-29,-0.1842105263157895,-0.025862068965517238,-14
1997-03-22,Blackburn,Aston Villa,0,2,A,30,36,61,14,0.4736842105263158,33,30,3,0.26666666666666666,30,47,63,17,0.4736842105263158,35,27,8,0.43333333333333335,0,0,0,0,0,0,0,0,0.4,0.4,-11,-2,-3,0.0,-0.16666666666666669,-5
1997-03-22,Coventry,West Ham,1,3,A,31,30,38,-18,0.21052631578947367,26,43,-17,0.1935483870967742,30,30,51,-9,0.3684210526315789,28,40,-12,0.23333333333333334,0,0,0,0,0,0,0,0,0.0,0.4,0,-13,-9,-0.15789473684210525,-0.03978494623655915,-5
1997-03-22,Derby,Tottenham,4,2,H,30,32,-1,-1,0.0,31,45,-14,0.23333333333333334,30,39,61,12,0.42105263157894735,36,39,-3,0.36666666666666664,0,0,0,0,0,0,0,0,0.2,0.4,-7,-62,-13,-0.42105263157894735,-0.1333333333333333,-11
1997-03-22,Everton,Man United,0,2,A,30,36,61,20,0.4473684210526316,37,43,-6,0.3,30,60,82,38,0.6578947368421053,59,33,26,0.5666666666666667,0,0,0,0,0,0,0,0,0.2,0.6,-24,-21,-18,-0.21052631578947373,-0.26666666666666666,-32
1997-03-22,Middlesbrough,Chelsea,1,0,H,29,31,43,-15,0.2894736842105263,42,51,-9,0.27586206896551724,30,49,50,2,0.3157894736842105,51,43,8,0.43333333333333335,1,0,0,0,0,0,0,0,0.6,0.4,-18,-7,-17,-0.02631578947368418,-0.1574712643678161,-17
1997-03-22,Sheffield Weds,Leeds,2,2,D,30,48,40,-13,0.2631578947368421,39,35,4,0.4,31,40,43,-17,0.3157894736842105,24,32,-8,0.3548387096774194,0,0,0,0,0,0,0,0,0.8,0.6,8,-3,4,-0.05263157894736842,0.04516129032258065,12
1997-03-22,Southampton,Leicester,2,2,D,30,26,38,-18,0.2368421052631579,37,49,-12,0.2,30,38,-1,-1,0.0,35,42,-7,0.3333333333333333,0,0,0,0,0,0,0,0,0.2,0.4,-12,39,-17,0.2368421052631579,-0.1333333333333333,-5
1997-03-22,Sunderland,Nott'm Forest,1,1,D,31,32,-1,-1,0.0,28,47,-19,0.25806451612903225,31,29,58,-4,0.3947368421052632,26,47,-21,0.1935483870967742,0,0,0,0,0,0,0,0,0.2,0.2,3,-59,3,-0.3947368421052632,0.06451612903225806,2
1997-03-23,Wimbledon,Newcastle,1,1,D,29,45,41,-15,0.2631578947368421,41,36,5,0.41379310344827586,29,51,78,29,0.631578947368421,58,35,23,0.5172413793103449,0,0,0,0,0,0,0,0,0.0,0.6,-6,-37,-44,-0.3684210526315789,-0.103448275862069,-18
1997-03-24,Arsenal,Liverpool,1,2,A,31,57,63,17,0.4473684210526316,51,26,25,0.5161290322580645,30,57,71,36,0.5263157894736842,51,25,26,0.5333333333333333,1,0,0,0,0,0,0,0,0.6,0.4,0,-8,-19,-0.0789473684210526,-0.017204301075268824,-1
1997-03-24,Middlesbrough,Nott'm Forest,1,1,D,30,34,43,-15,0.2894736842105263,43,51,-8,0.3,32,30,58,-4,0.3947368421052632,27,48,-21,0.1875,1,0,0,0,0,0,0,0,0.8,0.0,4,-15,-11,-0.10526315789473689,0.11249999999999999,13
1997-04-05,Aston Villa,Everton,3,1,H,31,50,63,17,0.4736842105263158,37,27,10,0.45161290322580644,31,36,61,20,0.4473684210526316,37,45,-8,0.2903225806451613,0,0,0,0,0,0,0,0,0.4,0.2,14,2,-3,0.026315789473684237,0.16129032258064513,18
1997-04-05,Chelsea,Arsenal,0,3,A,31,49,50,2,0.3157894736842105,51,44,7,0.41935483870967744,32,57,63,17,0.4473684210526316,52,28,24,0.5,0,0,0,0,0,0,0,0,0.4,0.6,-8,-13,-15,-0.13157894736842107,-0.08064516129032256,-17
1997-04-05,Man United,Derby,2,3,A,31,63,82,38,0.6578947368421053,61,33,28,0.5806451612903226,31,35,-1,-1,0.0,35,47,-12,0.25806451612903225,0,0,0,0,0,0,0,0,0.6,0.4,28,83,39,0.6578947368421053,0.32258064516129037,40
1997-04-05,Newcastle,Sunderland,1,1,D,30,52,78,29,0.631578947368421,59,36,23,0.5,32,33,-1,-1,0.0,29,48,-19,0.25,0,0,0,0,0,0,0,0,0.4,0.2,19,79,30,0.631578947368421,0.25,42
1997-04-05,Nott'm Forest,Southampton,1,3,A,33,31,58,-4,0.3947368421052632,28,49,-21,0.18181818181818182,31,27,38,-18,0.2368421052631579,39,51,-12,0.1935483870967742,0,0,0,0,0,0,0,0,0.0,0.0,4,20,14,0.1578947368421053,-0.011730205278592365,-9
1997-04-05,Tottenham,Wimbledon,1,0,H,31,39,61,12,0.42105263157894735,38,43,-5,0.3548387096774194,30,46,41,-15,0.2631578947368421,42,37,5,0.4,0,0,0,0,0,0,0,0,0.4,0.0,-7,20,27,0.15789473684210525,-0.04516129032258065,-10
1997-04-06,Liverpool,Coventry,1,2,A,31,60,71,36,0.5263157894736842,53,26,27,0.5483870967741935,32,30,38,-18,0.21052631578947367,27,46,-19,0.1875,0,0,0,0,0,0,0,0,0.4,0.0,30,33,54,0.3157894736842105,0.3608870967741935,46
1997-04-07,Leeds,Blackburn,0,0,D,32,41,43,-17,0.3157894736842105,26,34,-8,0.34375,31,36,61,14,0.4736842105263158,33,32,1,0.25806451612903225,0,0,0,0,0,0,0,0,0.4,0.2,5,-18,-31,-0.1578947368421053,0.08568548387096775,-9
1997-04-09,Coventry,Chelsea,3,1,H,33,33,38,-18,0.21052631578947367,29,47,-18,0.21212121212121213,32,49,50,2,0.3157894736842105,51,47,4,0.40625,0,0,0,0,0,0,0,0,0.2,0.4,-16,-12,-20,-0.10526315789473684,-0.19412878787878787,-22
1997-04-09,Derby,Southampton,1,1,D,32,38,-1,-1,0.0,38,49,-11,0.28125,32,30,38,-18,0.2368421052631579,42,52,-10,0.21875,0,0,0,0,0,0,0,0,0.6,0.2,8,-39,17,-0.2368421052631579,0.0625,-1
1997-04-09,Everton,Leicester,1,1,D,32,36,61,20,0.4473684210526316,38,48,-10,0.28125,31,39,-1,-1,0.0,37,44,-7,0.3225806451612903,0,0,0,0,0,0,0,0,0.2,0.2,-3,62,21,0.4473684210526316,-0.041330645161290314,-3
1997-04-09,Sheffield Weds,Tottenham,2,1,H,31,49,40,-13,0.2631578947368421,41,37,4,0.3870967741935484,32,42,61,12,0.42105263157894735,39,43,-4,0.375,0,0,0,0,0,0,0,0,0.6,0.6,7,-21,-25,-0.15789473684210525,0.012096774193548376,8
1997-04-09,West Ham,Middlesbrough,0,0,D,31,33,51,-9,0.3684210526315789,31,41,-10,0.25806451612903225,31,35,43,-15,0.2894736842105263,44,52,-8,0.2903225806451613,0,0,0,0,0,0,0,0,0.4,0.8,-2,8,6,0.0789473684210526,-0.03225806451612906,-2
1997-04-09,Wimbledon,Aston Villa,0,2,A,31,46,41,-15,0.2631578947368421,42,38,4,0.3870967741935484,32,53,63,17,0.4736842105263158,40,28,12,0.46875,0,0,0,0,0,0,0,0,0.0,0.6,-7,-22,-32,-0.21052631578947373,-0.08165322580645162,-8
1997-04-12,Arsenal,Leicester,2,0,H,33,60,63,17,0.4473684210526316,55,28,27,0.5151515151515151,32,40,-1,-1,0.0,38,45,-7,0.3125,0,0,0,0,0,0,0,0,0.8,0.0,20,64,18,0.4473684210526316,0.20265151515151514,34
1997-04-12,Blackburn,Man United,2,3,A,32,37,61,14,0.4736842105263158,33,32,1,0.25,32,63,82,38,0.6578947368421053,63,36,27,0.5625,0,0,0,0,0,0,0,0,0.2,0.6,-26,-21,-24,-0.1842105263157895,-0.3125,-26
1997-04-12,Derby,Aston Villa,2,1,H,33,39,-1,-1,0.0,39,50,-11,0.2727272727272727,33,56,63,17,0.4736842105263158,42,28,14,0.48484848484848486,0,0,0,0,1,0,0,0,0.4,0.6,-17,-64,-18,-0.4736842105263158,-0.21212121212121215,-25
1997-04-12,Everton,Tottenham,1,0,H,33,37,61,20,0.4473684210526316,39,49,-10,0.2727272727272727,33,42,61,12,0.42105263157894735,40,45,-5,0.36363636363636365,0,0,0,0,0,0,0,0,0.2,0.4,-5,0,8,0.026315789473684237,-0.09090909090909094,-5
1997-04-12,Southampton,West Ham,2,0,H,33,31,38,-18,0.2368421052631579,43,53,-10,0.21212121212121213,32,34,51,-9,0.3684210526315789,31,41,-10,0.25,0,0,0,0,0,0,0,0,0.2,0.4,-3,-13,-9,-0.13157894736842102,-0.03787878787878787,0
1997-04-13,Sheffield Weds,Newcastle,1,1,D,32,52,40,-13,0.2631578947368421,43,38,5,0.40625,31,53,78,29,0.631578947368421,60,37,23,0.4838709677419355,0,0,0,0,0,0,0,0,0.6,0.2,-1,-38,-42,-0.3684210526315789,-0.0776209677419355,-18
1997-04-13,Sunderland,Liverpool,1,2,A,33,34,-1,-1,0.0,30,49,-19,0.24242424242424243,32,60,71,36,0.5263157894736842,54,28,26,0.53125,0,0,0,0,0,0,0,0,0.2,0.4,-26,-72,-37,-0.5263157894736842,-0.28882575757575757,-45
1997-04-16,Everton,Liverpool,1,1,D,34,40,61,20,0.4473684210526316,40,49,-9,0.29411764705882354,33,63,71,36,0.5263157894736842,56,29,27,0.5454545454545454,0,0,0,0,0,0,0,0,0.4,0.6,-23,-10,-16,-0.0789473684210526,-0.2513368983957219,-36
1997-04-16,Newcastle,Chelsea,3,1,H,32,54,78,29,0.631578947368421,61,38,23,0.46875,33,49,50,2,0.3157894736842105,52,50,2,0.3939393939393939,0,0,0,0,0,0,1,0,0.2,0.4,5,28,27,0.3157894736842105,0.07481060606060608,21
1997-04-16,Wimbledon,Leeds,2,0,H,32,46,41,-15,0.2631578947368421,42,40,2,0.375,33,42,43,-17,0.3157894736842105,26,34,-8,0.3333333333333333,0,0,0,0,0,0,0,0,0.0,0.2,4,-2,2,-0.05263157894736842,0.041666666666666685,10
1997-04-19,Arsenal,Blackburn,1,1,D,34,63,63,17,0.4473684210526316,57,28,29,0.5294117647058824,33,37,61,14,0.4736842105263158,35,35,0,0.24242424242424243,0,0,0,0,0,0,0,0,0.8,0.2,26,2,3,-0.026315789473684237,0.28698752228163993,29
1997-04-19,Aston Villa,Tottenham,1,1,D,34,56,63,17,0.4736842105263158,43,30,13,0.47058823529411764,34,42,61,12,0.42105263157894735,40,46,-6,0.35294117647058826,0,0,0,0,0,0,0,0,0.6,0.2,14,2,5,0.052631578947368474,0.11764705882352938,19
1997-04-19,Chelsea,Leicester,2,1,H,34,49,50,2,0.3157894736842105,53,53,0,0.38235294117647056,33,40,-1,-1,0.0,38,47,-9,0.30303030303030304,0,0,1,0,0,0,0,0,0.2,0.0,9,51,3,0.3157894736842105,0.07932263814616752,9
1997-04-19,Liverpool,Man United,1,3,A,34,64,71,36,0.5263157894736842,57,30,27,0.5294117647058824,33,66,82,38,0.6578947368421053,66,38,28,0.5757575757575758,0,0,0,0,0,0,0,0,0.4,0.6,-2,-11,-2,-0.13157894736842113,-0.04634581105169344,-1
1997-04-19,Middlesbrough,Sunderland,0,1,A,32,36,43,-15,0.2894736842105263,44,52,-8,0.28125,34,34,-1,-1,0.0,31,51,-20,0.23529411764705882,0,0,0,0,0,0,0,0,0.6,0.0,2,44,-14,0.2894736842105263,0.04595588235294118,12
1997-04-19,Newcastle,Derby,3,1,H,33,57,78,29,0.631578947368421,64,39,25,0.48484848484848486,34,42,-1,-1,0.0,41,51,-10,0.29411764705882354,0,0,0,0,0,0,0,0,0.4,0.6,15,79,30,0.631578947368421,0.19073083778966132,35
1997-04-19,Nott'm Forest,Leeds,1,1,D,34,31,58,-4,0.3947368421052632,29,52,-23,0.17647058823529413,34,42,43,-17,0.3157894736842105,26,36,-10,0.3235294117647059,0,0,0,0,0,0,0,0,0.0,0.0,-11,15,13,0.07894736842105271,-0.14705882352941177,-13
1997-04-19,Sheffield Weds,Wimbledon,3,1,H,33,53,40,-13,0.2631578947368421,44,39,5,0.3939393939393939,33,49,41,-15,0.2631578947368421,44,40,4,0.3939393939393939,0,0,0,0,0,0,0,0,0.4,0.2,4,-1,2,0.0,0.0,1
1997-04-19,Southampton,Coventry,2,2,D,34,34,38,-18,0.2368421052631579,45,53,-8,0.23529411764705882,34,36,38,-18,0.21052631578947367,32,48,-16,0.23529411764705882,0,0,0,0,0,0,0,0,0.4,0.4,-2,0,0,0.026315789473684237,0.0,8
1997-04-19,West Ham,Everton,2,2,D,33,34,51,-9,0.3684210526315789,31,43,-12,0.24242424242424243,35,41,61,20,0.4473684210526316,41,50,-9,0.2857142857142857,0,0,0,0,0,0,0,0,0.2,0.2,-7,-10,-29,-0.07894736842105265,-0.04329004329004327,-3
1997-04-21,Coventry,Arsenal,1,1,D,35,37,38,-18,0.21052631578947367,34,50,-16,0.22857142857142856,35,64,63,17,0.4473684210526316,58,29,29,0.5142857142857142,0,0,0,0,0,0,0,0,0.4,0.6,-27,-25,-35,-0.2368421052631579,-0.2857142857142857,-45
1997-04-22,Blackburn,Sheffield Weds,4,1,H,34,38,61,14,0.4736842105263158,36,36,0,0.23529411764705882,34,56,40,-13,0.2631578947368421,47,40,7,0.4117647058823529,0,0,0,0,0,0,0,0,0.0,0.4,-18,21,27,0.21052631578947373,-0.1764705882352941,-7
1997-04-22,Leeds,Aston Villa,0,0,D,35,43,43,-17,0.3157894736842105,27,37,-10,0.3142857142857143,35,57,63,17,0.4736842105263158,44,31,13,0.45714285714285713,0,0,0,0,0,0,0,0,0.0,0.6,-14,-20,-34,-0.1578947368421053,-0.14285714285714285,-23
1997-04-22,Sunderland,Southampton,0,1,A,35,37,-1,-1,0.0,32,51,-19,0.2571428571428571,35,35,38,-18,0.2368421052631579,47,55,-8,0.22857142857142856,0,0,0,0,0,0,0,0,0.2,0.4,2,-39,17,-0.2368421052631579,0.028571428571428553,-11
1997-04-22,Wimbledon,Chelsea,0,1,A,34,49,41,-15,0.2631578947368421,45,43,2,0.38235294117647056,35,52,50,2,0.3157894736842105,55,54,1,0.4,0,0,0,0,0,0,0,0,0.2,0.2,-3,-9,-17,-0.05263157894736842,-0.01764705882352946,1
1997-04-23,Derby,Nott'm Forest,0,0,D,35,42,-1,-1,0.0,42,54,-12,0.2857142857142857,35,32,58,-4,0.3947368421052632,30,53,-23,0.17142857142857143,0,0,0,0,0,0,0,0,0.6,0.0,10,-59,3,-0.3947368421052632,0.11428571428571427,11
1997-04-23,Leicester,West Ham,0,1,A,34,40,-1,-1,0.0,39,49,-10,0.29411764705882354,34,35,51,-9,0.3684210526315789,33,45,-12,0.23529411764705882,0,0,0,0,0,0,0,0,0.0,0.2,5,-52,8,-0.3684210526315789,0.05882352941176472,2
1997-04-24,Tottenham,Middlesbrough,1,0,H,35,43,61,12,0.42105263157894735,41,47,-6,0.34285714285714286,33,36,43,-15,0.2894736842105263,44,53,-9,0.2727272727272727,0,0,0,0,0,0,0,0,0.2,0.4,7,18,27,0.13157894736842102,0.07012987012987015,3
1997-05-03,Arsenal,Newcastle,0,1,A,36,65,63,17,0.4473684210526316,59,30,29,0.5,34,60,78,29,0.631578947368421,67,40,27,0.5,0,0,0,0,0,0,0,0,0.4,0.4,5,-15,-12,-0.18421052631578944,0.0,2
1997-05-03,Chelsea,Leeds,0,0,D,36,55,50,2,0.3157894736842105,56,54,2,0.4166666666666667,36,44,43,-17,0.3157894736842105,27,37,-10,0.3055555555555556,0,0,0,0,0,0,0,0,0.4,0.0,11,7,19,0.0,0.1111111111111111,12
1997-05-03,Coventry,Derby,1,2,A,36,38,38,-18,0.21052631578947367,35,51,-16,0.2222222222222222,36,43,-1,-1,0.0,42,54,-12,0.2777777777777778,0,0,0,0,0,0,0,0,0.4,0.4,-5,39,-17,0.21052631578947367,-0.05555555555555558,-4
1997-05-03,Leicester,Man United,2,2,D,35,40,-1,-1,0.0,39,50,-11,0.2857142857142857,34,69,82,38,0.6578947368421053,69,39,30,0.5882352941176471,0,0,1,0,0,0,0,0,0.0,0.8,-29,-83,-39,-0.6578947368421053,-0.3025210084033614,-41
1997-05-03,Liverpool,Tottenham,2,1,H,35,64,71,36,0.5263157894736842,58,33,25,0.5142857142857142,36,46,61,12,0.42105263157894735,42,47,-5,0.3611111111111111,0,0,0,0,0,0,0,0,0.4,0.4,18,10,24,0.10526315789473684,0.15317460317460313,30
1997-05-03,Middlesbrough,Aston Villa,3,2,H,34,36,43,-15,0.2894736842105263,44,54,-10,0.2647058823529412,36,58,63,17,0.4736842105263158,44,31,13,0.4444444444444444,0,0,0,0,0,0,0,0,0.2,0.4,-22,-20,-32,-0.1842105263157895,-0.17973856209150324,-23
1997-05-03,Nott'm Forest,Wimbledon,1,1,D,36,33,58,-4,0.3947368421052632,30,53,-23,0.16666666666666666,35,49,41,-15,0.2631578947368421,45,44,1,0.37142857142857144,0,0,0,0,0,0,0,0,0.0,0.2,-16,17,11,0.13157894736842113,-0.20476190476190478,-24
1997-05-03,Southampton,Blackburn,2,0,H,36,38,38,-18,0.2368421052631579,48,55,-7,0.25,35,41,61,14,0.4736842105263158,40,37,3,0.2571428571428571,0,0,0,0,0,0,0,0,0.6,0.2,-3,-23,-32,-0.2368421052631579,-0.0071428571428571175,-10
1997-05-03,Sunderland,Everton,3,0,H,36,37,-1,-1,0.0,32,52,-20,0.25,36,42,61,20,0.4473684210526316,43,52,-9,0.2777777777777778,0,0,0,0,0,0,0,0,0.2,0.2,-5,-62,-21,-0.4473684210526316,-0.02777777777777779,-11
1997-05-03,West Ham,Sheffield Weds,5,1,H,35,38,51,-9,0.3684210526315789,34,45,-11,0.2571428571428571,35,56,40,-13,0.2631578947368421,48,44,4,0.4,0,0,0,0,0,0,0,0,0.4,0.4,-18,11,4,0.10526315789473684,-0.1428571428571429,-15
1997-05-05,Man United,Middlesbrough,3,3,D,35,70,82,38,0.6578947368421053,71,41,30,0.5714285714285714,35,39,43,-15,0.2894736842105263,47,56,-9,0.2857142857142857,0,0,0,0,0,0,0,0,0.6,0.2,31,39,53,0.368421052631579,0.2857142857142857,39
1997-05-06,West Ham,Newcastle,0,0,D,36,41,51,-9,0.3684210526315789,39,46,-7,0.2777777777777778,35,63,78,29,0.631578947368421,68,40,28,0.5142857142857142,0,0,0,0,1,0,0,0,0.4,0.6,-22,-27,-38,-0.2631578947368421,-0.23650793650793644,-35
1997-05-06,Wimbledon,Liverpool,2,1,H,36,50,41,-15,0.2631578947368421,46,45,1,0.3611111111111111,36,67,71,36,0.5263157894736842,60,34,26,0.5277777777777778,0,0,0,0,0,0,0,0,0.2,0.4,-17,-30,-51,-0.2631578947368421,-0.16666666666666669,-25
1997-05-07,Leicester,Sheffield Weds,1,0,H,36,41,-1,-1,0.0,41,52,-11,0.2777777777777778,36,56,40,-13,0.2631578947368421,49,49,0,0.3888888888888889,0,0,0,0,0,0,0,0,0.0,0.4,-15,-41,12,-0.2631578947368421,-0.1111111111111111,-11
1997-05-08,Blackburn,Middlesbrough,0,0,D,36,41,61,14,0.4736842105263158,40,39,1,0.25,36,40,43,-15,0.2894736842105263,50,59,-9,0.2777777777777778,0,0,0,0,0,0,0,0,0.2,0.2,1,18,29,0.1842105263157895,-0.02777777777777779,10
1997-05-08,Man United,Newcastle,0,0,D,36,71,82,38,0.6578947368421053,74,44,30,0.5555555555555556,36,64,78,29,0.631578947368421,68,40,28,0.5,0,0,0,0,0,0,0,0,0.4,0.6,7,4,9,0.026315789473684292,0.05555555555555558,2
1997-05-11,Aston Villa,Southampton,1,0,H,37,58,63,17,0.4736842105263158,46,34,12,0.43243243243243246,37,41,38,-18,0.2368421052631579,50,55,-5,0.2702702702702703,0,0,0,0,0,0,0,0,0.2,0.6,17,25,35,0.2368421052631579,0.16216216216216217,17
1997-05-11,Blackburn,Leicester,2,4,A,37,42,61,14,0.4736842105263158,40,39,1,0.24324324324324326,37,44,-1,-1,0.0,42,52,-10,0.2972972972972973,0,0,0,0,0,0,0,0,0.2,0.2,-2,62,15,0.4736842105263158,-0.05405405405405406,11
1997-05-11,Derby,Arsenal,1,3,A,37,46,-1,-1,0.0,44,55,-11,0.2972972972972973,37,65,63,17,0.4473684210526316,59,31,28,0.4864864864864865,0,0,0,0,0,0,0,0,0.4,0.4,-19,-64,-18,-0.4473684210526316,-0.1891891891891892,-39
1997-05-11,Everton,Chelsea,1,2,A,37,42,61,20,0.4473684210526316,43,55,-12,0.2702702702702703,37,56,50,2,0.3157894736842105,56,54,2,0.40540540540540543,0,0,0,0,0,0,0,0,0.2,0.4,-14,11,18,0.13157894736842107,-0.13513513513513514,-14
1997-05-11,Leeds,Middlesbrough,1,1,D,37,45,43,-17,0.3157894736842105,27,37,-10,0.2972972972972973,37,41,43,-15,0.2894736842105263,50,59,-9,0.2702702702702703,0,0,0,0,0,0,0,0,0.0,0.2,4,0,-2,0.02631578947368418,0.02702702702702703,-1
1997-05-11,Man United,West Ham,2,0,H,37,72,82,38,0.6578947368421053,74,44,30,0.5405405405405406,37,42,51,-9,0.3684210526315789,39,46,-7,0.2702702702702703,0,0,0,0,0,0,0,0,0.4,0.4,30,31,47,0.2894736842105264,0.2702702702702703,37
1997-05-11,Newcastle,Nott'm Forest,5,0,H,37,65,78,29,0.631578947368421,68,40,28,0.4864864864864865,37,34,58,-4,0.3947368421052632,31,54,-23,0.16216216216216217,0,0,0,0,0,0,0,0,0.6,0.0,31,20,33,0.2368421052631578,0.32432432432432434,51
1997-05-11,Sheffield Weds,Liverpool,1,1,D,37,56,40,-13,0.2631578947368421,49,50,-1,0.3783783783783784,37,67,71,36,0.5263157894736842,61,36,25,0.5135135135135135,0,0,1,0,0,0,0,0,0.2,0.4,-11,-31,-49,-0.2631578947368421,-0.1351351351351351,-26
1997-05-11,Tottenham,Coventry,1,2,A,37,46,61,12,0.42105263157894735,43,49,-6,0.35135135135135137,37,38,38,-18,0.21052631578947367,36,53,-17,0.21621621621621623,0,0,0,0,0,0,0,0,0.2,0.4,8,23,30,0.21052631578947367,0.13513513513513514,11
1997-05-11,Wimbledon,Sunderland,1,0,H,37,53,41,-15,0.2631578947368421,48,46,2,0.3783783783783784,37,40,-1,-1,0.0,35,52,-17,0.2702702702702703,0,0,0,0,0,0,0,0,0.4,0.4,13,42,-14,0.2631578947368421,0.10810810810810811,19
