Date,HomeTeam,AwayTeam,FTHG,FTAG,FTR,HT_match_played,HT_current_standing,HT_past_standing,HT_past_goal_diff,HT_past_win_rate,HT_goal_for,HT_goal_against,HT_goal_diff,HT_win_rate_season,AT_match_played,AT_current_standing,AT_past_standing,AT_past_goal_diff,AT_past_win_rate,AT_goal_for,AT_goal_against,AT_goal_diff,AT_win_rate_season,HT_3_win_streak,HT_5_win_streak,HT_3_lose_Streak,HT_5_lose_Streak,AT_3_win_streak,AT_5_win_streak,AT_3_lose_Streak,AT_5_lose_Streak,HT_5_win_rate,AT_5_win_rate,current_standing_diff,past_standing_diff,past_goal_diff_diff,past_win_rate_diff,win_rate_season_diff,goal_diff_diff
1997-08-09,Barnsley,West Ham,1,2,A,0,0,-1,-1,0.0,0,0,0,,0,0,42,-9,0.2631578947368421,0,0,0,,0,0,0,0,0,0,0,0,,,0,-43,8,-0.2631578947368421,,0
1997-08-09,Blackburn,Derby,1,0,H,0,0,42,-1,0.2368421052631579,0,0,0,,0,0,46,-13,0.2894736842105263,0,0,0,,0,0,0,0,0,0,0,0,,,0,-4,12,-0.05263157894736842,,0
1997-08-09,Coventry,Chelsea,3,2,H,0,0,41,-16,0.2368421052631579,0,0,0,,0,0,59,3,0.42105263157894735,0,0,0,,0,0,0,0,0,0,0,0,,,0,-18,-19,-0.18421052631578944,,0
1997-08-09,Everton,Crystal Palace,1,2,A,0,0,42,-13,0.2631578947368421,0,0,0,,0,0,-1,-1,0.0,0,0,0,,0,0,0,0,0,0,0,0,,,0,43,-12,0.2631578947368421,,0
1997-08-09,Leeds,Arsenal,1,1,D,0,0,46,-10,0.2894736842105263,0,0,0,,0,0,68,30,0.5,0,0,0,,0,0,0,0,0,0,0,0,,,0,-22,-40,-0.21052631578947367,,0
1997-08-09,Leicester,Aston Villa,1,0,H,0,0,47,-8,0.3157894736842105,0,0,0,,0,0,61,13,0.4473684210526316,0,0,0,,0,0,0,0,0,0,0,0,,,0,-14,-21,-0.13157894736842107,,0
1997-08-09,Newcastle,Sheffield Weds,2,1,H,0,0,68,33,0.5,0,0,0,,0,0,57,-1,0.3684210526315789,0,0,0,,0,0,0,0,0,0,0,0,,,0,11,34,0.13157894736842107,,0
1997-08-09,Southampton,Bolton,0,1,A,0,0,41,-6,0.2631578947368421,0,0,0,,0,0,-1,-1,0.0,0,0,0,,0,0,0,0,0,0,0,0,,,0,42,-5,0.2631578947368421,,0
1997-08-09,Wimbledon,Liverpool,1,1,D,0,0,56,3,0.3947368421052632,0,0,0,,0,0,68,25,0.5,0,0,0,,0,0,0,0,0,0,0,0,,,0,-12,-22,-0.10526315789473678,,0
1997-08-10,Tottenham,Man United,0,2,A,0,0,46,-7,0.34210526315789475,0,0,0,,0,0,75,32,0.5526315789473685,0,0,0,,0,0,0,0,0,0,0,0,,,0,-29,-39,-0.21052631578947373,,0
1997-08-11,Arsenal,Coventry,2,0,H,1,1,68,30,0.5,1,1,0,0.0,1,3,41,-16,0.2368421052631579,3,2,1,1.0,0,0,0,0,0,0,0,0,,,-2,27,46,0.2631578947368421,-1.0,-1
1997-08-12,Crystal Palace,Barnsley,0,1,A,1,3,-1,-1,0.0,2,1,1,1.0,1,0,-1,-1,0.0,1,2,-1,0.0,0,0,0,0,0,0,0,0,,,3,0,0,0.0,1.0,2
1997-08-13,Aston Villa,Blackburn,0,4,A,1,0,61,13,0.4473684210526316,0,1,-1,0.0,1,3,42,-1,0.2368421052631579,1,0,1,1.0,0,0,0,0,0,0,0,0,,,-3,19,14,0.21052631578947367,-1.0,-2
1997-08-13,Liverpool,Leicester,1,2,A,1,1,68,25,0.5,1,1,0,0.0,1,3,47,-8,0.3157894736842105,1,0,1,1.0,0,0,0,0,0,0,0,0,,,-2,21,33,0.1842105263157895,-1.0,-1
1997-08-13,Man United,Southampton,1,0,H,1,3,75,32,0.5526315789473685,2,0,2,1.0,1,0,41,-6,0.2631578947368421,0,1,-1,0.0,0,0,0,0,0,0,0,0,,,3,34,38,0.2894736842105264,1.0,3
1997-08-13,Sheffield Weds,Leeds,1,3,A,1,0,57,-1,0.3684210526315789,1,2,-1,0.0,1,1,46,-10,0.2894736842105263,1,1,0,0.0,0,0,0,0,0,0,0,0,,,-1,11,9,0.0789473684210526,0.0,-1
1997-08-13,West Ham,Tottenham,2,1,H,1,3,42,-9,0.2631578947368421,2,1,1,1.0,1,0,46,-7,0.34210526315789475,0,2,-2,0.0,0,0,0,0,0,0,0,0,,,3,-4,-2,-0.07894736842105265,1.0,3
1997-08-23,Blackburn,Liverpool,1,1,D,2,6,42,-1,0.2368421052631579,5,0,5,1.0,2,1,68,25,0.5,2,3,-1,0.0,0,0,0,0,0,0,0,0,,,5,-26,-26,-0.2631578947368421,1.0,6
1997-08-23,Coventry,Bolton,2,2,D,2,3,41,-16,0.2368421052631579,3,4,-1,0.5,1,3,-1,-1,0.0,1,0,1,1.0,0,0,0,0,0,0,0,0,,,0,42,-15,0.2368421052631579,-0.5,-2
1997-08-23,Everton,West Ham,2,1,H,1,0,42,-13,0.2631578947368421,1,2,-1,0.0,2,6,42,-9,0.2631578947368421,4,2,2,1.0,0,0,0,0,0,0,0,0,,,-6,0,-4,0.0,-1.0,-3
1997-08-23,Leeds,Crystal Palace,0,2,A,2,4,46,-10,0.2894736842105263,4,2,2,0.5,2,3,-1,-1,0.0,2,2,0,0.5,0,0,0,0,0,0,0,0,,,1,47,-9,0.2894736842105263,0.0,2
1997-08-23,Leicester,Man United,0,0,D,2,6,47,-8,0.3157894736842105,3,1,2,1.0,2,6,75,32,0.5526315789473685,3,0,3,1.0,0,0,0,0,0,0,0,0,,,0,-28,-40,-0.23684210526315796,0.0,-1
1997-08-23,Newcastle,Aston Villa,1,0,H,1,3,68,33,0.5,2,1,1,1.0,2,0,61,13,0.4473684210526316,0,5,-5,0.0,0,0,0,0,0,0,0,0,,,3,7,20,0.05263157894736842,1.0,6
1997-08-23,Southampton,Arsenal,1,3,A,2,0,41,-6,0.2631578947368421,0,2,-2,0.0,2,4,68,30,0.5,3,1,2,0.5,0,0,0,0,0,0,0,0,,,-4,-27,-36,-0.2368421052631579,-0.5,-4
1997-08-23,Tottenham,Derby,1,0,H,2,0,46,-7,0.34210526315789475,1,4,-3,0.0,1,0,46,-13,0.2894736842105263,0,1,-1,0.0,0,0,0,0,0,0,0,0,,,0,0,6,0.05263157894736842,0.0,-2
1997-08-23,Wimbledon,Sheffield Weds,1,1,D,1,1,56,3,0.3947368421052632,1,1,0,0.0,2,0,57,-1,0.3684210526315789,2,5,-3,0.0,0,0,0,0,0,0,0,0,,,1,-1,4,0.026315789473684292,0.0,3
1997-08-24,Barnsley,Chelsea,0,6,A,2,3,-1,-1,0.0,2,2,0,0.5,1,0,59,3,0.42105263157894735,2,3,-1,0.0,0,0,0,0,0,0,0,0,,,3,-60,-4,-0.42105263157894735,0.5,1
1997-08-25,Blackburn,Sheffield Weds,7,2,H,3,7,42,-1,0.2368421052631579,6,1,5,0.6666666666666666,3,1,57,-1,0.3684210526315789,3,6,-3,0.0,0,0,0,0,0,0,0,0,,,6,-15,0,-0.13157894736842102,0.6666666666666666,8
1997-08-26,Leeds,Liverpool,0,2,A,3,4,46,-10,0.2894736842105263,4,4,0,0.3333333333333333,3,2,68,25,0.5,3,4,-1,0.0,0,0,0,0,0,0,0,0,,,2,-22,-35,-0.21052631578947367,0.3333333333333333,1
1997-08-27,Barnsley,Bolton,2,1,H,3,3,-1,-1,0.0,2,8,-6,0.3333333333333333,2,4,-1,-1,0.0,3,2,1,0.5,0,0,0,0,0,0,0,0,,,-1,0,0,0.0,-0.16666666666666669,-7
1997-08-27,Coventry,West Ham,1,1,D,3,4,41,-16,0.2368421052631579,5,6,-1,0.3333333333333333,3,6,42,-9,0.2631578947368421,5,4,1,0.6666666666666666,0,0,0,0,0,0,0,0,,,-2,-1,-7,-0.02631578947368418,-0.3333333333333333,-2
1997-08-27,Everton,Man United,0,2,A,2,3,42,-13,0.2631578947368421,3,3,0,0.5,3,7,75,32,0.5526315789473685,3,0,3,0.6666666666666666,0,0,0,0,0,0,0,0,,,-4,-33,-45,-0.2894736842105264,-0.16666666666666663,-3
1997-08-27,Leicester,Arsenal,3,3,D,3,7,47,-8,0.3157894736842105,3,1,2,0.6666666666666666,3,7,68,30,0.5,6,2,4,0.6666666666666666,0,0,0,0,0,0,0,0,,,0,-21,-38,-0.1842105263157895,0.0,-2
1997-08-27,Southampton,Crystal Palace,1,0,H,3,0,41,-6,0.2631578947368421,1,5,-4,0.0,3,6,-1,-1,0.0,4,2,2,0.6666666666666666,0,0,0,0,0,0,0,0,,,-6,42,-5,0.2631578947368421,-0.6666666666666666,-6
1997-08-27,Tottenham,Aston Villa,3,2,H,3,3,46,-7,0.34210526315789475,2,4,-2,0.3333333333333333,3,0,61,13,0.4473684210526316,0,6,-6,0.0,0,0,0,0,0,0,0,0,,,3,-15,-20,-0.10526315789473684,0.3333333333333333,4
1997-08-27,Wimbledon,Chelsea,0,2,A,2,2,56,3,0.3947368421052632,2,2,0,0.0,2,3,59,3,0.42105263157894735,8,3,5,0.5,0,0,0,0,0,0,0,0,,,-1,-3,0,-0.026315789473684126,-0.5,-5
1997-08-30,Arsenal,Tottenham,0,0,D,4,8,68,30,0.5,9,5,4,0.5,4,6,46,-7,0.34210526315789475,5,6,-1,0.5,0,0,0,0,0,0,0,0,,,2,22,37,0.15789473684210525,0.0,5
1997-08-30,Aston Villa,Leeds,1,0,H,4,0,61,13,0.4473684210526316,2,9,-7,0.0,4,4,46,-10,0.2894736842105263,4,6,-2,0.25,0,0,1,0,0,0,0,0,,,-4,15,23,0.15789473684210525,-0.25,-5
1997-08-30,Chelsea,Southampton,4,2,H,3,6,59,3,0.42105263157894735,10,3,7,0.6666666666666666,4,3,41,-6,0.2631578947368421,2,5,-3,0.25,0,0,0,0,0,0,0,0,,,3,18,9,0.15789473684210525,0.41666666666666663,10
1997-08-30,Crystal Palace,Blackburn,1,2,A,4,6,-1,-1,0.0,4,3,1,0.5,4,10,42,-1,0.2368421052631579,13,3,10,0.75,0,0,0,0,0,0,0,0,,,-4,-43,0,-0.2368421052631579,-0.25,-9
1997-08-30,Derby,Barnsley,1,0,H,2,0,46,-13,0.2894736842105263,0,2,-2,0.0,4,6,-1,-1,0.0,4,9,-5,0.5,0,0,0,0,0,0,0,0,,,-6,47,-12,0.2894736842105263,-0.5,3
1997-08-30,Man United,Coventry,3,0,H,4,10,75,32,0.5526315789473685,5,0,5,0.75,4,5,41,-16,0.2368421052631579,6,7,-1,0.25,0,0,0,0,0,0,0,0,,,5,34,48,0.31578947368421056,0.5,6
1997-08-30,Sheffield Weds,Leicester,1,0,H,4,1,57,-1,0.3684210526315789,5,13,-8,0.0,4,8,47,-8,0.3157894736842105,6,4,2,0.5,0,0,0,0,0,0,0,0,,,-7,10,7,0.05263157894736842,-0.5,-10
1997-08-30,West Ham,Wimbledon,3,1,H,4,7,42,-9,0.2631578947368421,6,5,1,0.5,3,2,56,3,0.3947368421052632,2,4,-2,0.0,0,0,0,0,0,0,0,0,,,5,-14,-12,-0.13157894736842113,0.5,3
1997-09-01,Bolton,Everton,0,0,D,3,4,-1,-1,0.0,4,4,0,0.3333333333333333,3,3,42,-13,0.2631578947368421,3,5,-2,0.3333333333333333,0,0,0,0,0,0,0,0,,,1,-43,12,-0.2631578947368421,0.0,2
1997-09-13,Arsenal,Bolton,4,1,H,5,9,68,30,0.5,9,5,4,0.4,4,5,-1,-1,0.0,4,4,0,0.25,0,0,0,0,0,0,0,0,0.4,,4,69,31,0.5,0.15000000000000002,4
1997-09-13,Barnsley,Aston Villa,0,3,A,5,6,-1,-1,0.0,4,10,-6,0.4,5,3,61,13,0.4473684210526316,3,9,-6,0.2,0,0,0,0,0,0,0,0,0.4,0.2,3,-62,-14,-0.4473684210526316,0.2,0
1997-09-13,Coventry,Southampton,1,0,H,5,5,41,-16,0.2368421052631579,6,10,-4,0.2,5,3,41,-6,0.2631578947368421,4,9,-5,0.2,0,0,0,0,0,0,0,0,0.2,0.2,2,0,-10,-0.02631578947368418,0.0,1
1997-09-13,Crystal Palace,Chelsea,0,3,A,5,6,-1,-1,0.0,5,5,0,0.4,4,9,59,3,0.42105263157894735,14,5,9,0.75,0,0,0,0,1,0,0,0,0.4,,-3,-60,-4,-0.42105263157894735,-0.35,-9
1997-09-13,Derby,Everton,3,1,H,3,3,46,-13,0.2894736842105263,1,2,-1,0.3333333333333333,4,4,42,-13,0.2631578947368421,3,5,-2,0.25,0,0,0,0,0,0,0,0,,,-1,4,0,0.026315789473684237,0.08333333333333331,1
1997-09-13,Leicester,Tottenham,3,0,H,5,8,47,-8,0.3157894736842105,6,5,1,0.4,5,7,46,-7,0.34210526315789475,5,6,-1,0.4,0,0,0,0,0,0,0,0,0.4,0.4,1,1,-1,-0.026315789473684237,0.0,2
1997-09-13,Liverpool,Sheffield Weds,2,1,H,4,5,68,25,0.5,5,4,1,0.25,5,4,57,-1,0.3684210526315789,6,13,-7,0.2,0,0,0,0,0,0,0,0,,0.2,1,11,26,0.13157894736842107,0.04999999999999999,8
1997-09-13,Man United,West Ham,2,1,H,5,13,75,32,0.5526315789473685,8,0,8,0.8,5,10,42,-9,0.2631578947368421,9,6,3,0.6,0,0,0,0,0,0,0,0,0.8,0.6,3,33,41,0.2894736842105264,0.20000000000000007,5
1997-09-13,Newcastle,Wimbledon,1,3,A,2,6,68,33,0.5,3,1,2,1.0,4,2,56,3,0.3947368421052632,3,7,-4,0.0,0,0,0,0,0,0,0,0,,,4,12,30,0.10526315789473678,1.0,6
1997-09-14,Blackburn,Leeds,3,4,A,5,13,42,-1,0.2368421052631579,15,4,11,0.8,5,4,46,-10,0.2894736842105263,4,7,-3,0.2,0,0,0,0,0,0,1,0,0.8,0.2,9,-4,9,-0.05263157894736842,0.6000000000000001,14
1997-09-20,Aston Villa,Derby,2,1,H,6,6,61,13,0.4473684210526316,6,9,-3,0.3333333333333333,4,6,46,-13,0.2894736842105263,4,3,1,0.5,0,0,0,0,0,0,0,0,0.4,,0,15,26,0.15789473684210525,-0.16666666666666669,-4
1997-09-20,Bolton,Man United,0,0,D,5,5,-1,-1,0.0,5,8,-3,0.2,6,16,75,32,0.5526315789473685,10,1,9,0.8333333333333334,0,0,0,0,1,0,0,0,0.2,0.8,-11,-76,-33,-0.5526315789473685,-0.6333333333333333,-12
1997-09-20,Everton,Barnsley,4,2,H,5,4,42,-13,0.2631578947368421,4,8,-4,0.2,6,6,-1,-1,0.0,4,13,-9,0.3333333333333333,0,0,0,0,0,0,0,0,0.2,0.4,-2,43,-12,0.2631578947368421,-0.1333333333333333,5
1997-09-20,Leeds,Leicester,0,1,A,6,7,46,-10,0.2894736842105263,8,10,-2,0.3333333333333333,6,11,47,-8,0.3157894736842105,9,5,4,0.5,0,0,0,0,0,0,0,0,0.4,0.4,-4,-1,-2,-0.02631578947368418,-0.16666666666666669,-6
1997-09-20,Sheffield Weds,Coventry,0,0,D,6,4,57,-1,0.3684210526315789,7,15,-8,0.16666666666666666,6,8,41,-16,0.2368421052631579,7,10,-3,0.3333333333333333,0,0,0,0,0,0,0,0,0.2,0.2,-4,16,15,0.13157894736842102,-0.16666666666666666,-5
1997-09-20,Southampton,Liverpool,1,1,D,6,3,41,-6,0.2631578947368421,4,10,-6,0.16666666666666666,5,8,68,25,0.5,7,5,2,0.4,0,0,0,0,0,0,0,0,0.2,0.4,-5,-27,-31,-0.2368421052631579,-0.23333333333333336,-8
1997-09-20,Tottenham,Blackburn,0,0,D,6,7,46,-7,0.34210526315789475,5,9,-4,0.3333333333333333,6,13,42,-1,0.2368421052631579,18,8,10,0.6666666666666666,0,0,0,0,0,0,0,0,0.4,0.6,-6,4,-6,0.10526315789473684,-0.3333333333333333,-14
1997-09-20,West Ham,Newcastle,0,1,A,6,10,42,-9,0.2631578947368421,10,8,2,0.5,3,6,68,33,0.5,4,4,0,0.6666666666666666,0,0,0,0,0,0,0,0,0.4,,4,-26,-42,-0.2368421052631579,-0.16666666666666663,2
1997-09-20,Wimbledon,Crystal Palace,0,1,A,5,5,56,3,0.3947368421052632,6,8,-2,0.2,6,6,-1,-1,0.0,5,8,-3,0.3333333333333333,0,0,0,0,0,0,1,0,0.2,0.2,-1,57,4,0.3947368421052632,-0.1333333333333333,1
1997-09-21,Chelsea,Arsenal,2,3,A,5,12,59,3,0.42105263157894735,17,5,12,0.8,6,12,68,30,0.5,13,6,7,0.5,1,0,0,0,0,0,0,0,0.8,0.6,0,-9,-27,-0.07894736842105265,0.30000000000000004,5
1997-09-22,Liverpool,Aston Villa,3,0,H,6,9,68,25,0.5,8,6,2,0.3333333333333333,7,9,61,13,0.4473684210526316,8,10,-2,0.42857142857142855,0,0,0,0,1,0,0,0,0.4,0.6,0,7,12,0.05263157894736842,-0.09523809523809523,4
1997-09-23,Bolton,Tottenham,1,1,D,6,6,-1,-1,0.0,5,8,-3,0.16666666666666666,7,8,46,-7,0.34210526315789475,5,9,-4,0.2857142857142857,0,0,0,0,0,0,0,0,0.0,0.4,-2,-47,6,-0.34210526315789475,-0.11904761904761904,1
1997-09-23,Wimbledon,Barnsley,4,1,H,6,5,56,3,0.3947368421052632,6,9,-3,0.16666666666666666,7,6,-1,-1,0.0,6,17,-11,0.2857142857142857,0,0,0,0,0,0,1,0,0.2,0.2,-1,57,4,0.3947368421052632,-0.11904761904761904,8
1997-09-24,Arsenal,West Ham,4,0,H,7,15,68,30,0.5,16,8,8,0.5714285714285714,7,10,42,-9,0.2631578947368421,10,9,1,0.42857142857142855,0,0,0,0,0,0,0,0,0.6,0.2,5,26,39,0.2368421052631579,0.14285714285714285,7
1997-09-24,Coventry,Crystal Palace,1,1,D,7,9,41,-16,0.2368421052631579,7,10,-3,0.2857142857142857,7,9,-1,-1,0.0,6,8,-2,0.42857142857142855,0,0,0,0,0,0,0,0,0.2,0.4,0,42,-15,0.2368421052631579,-0.14285714285714285,-1
1997-09-24,Leicester,Blackburn,1,1,D,7,14,47,-8,0.3157894736842105,10,5,5,0.5714285714285714,7,14,42,-1,0.2368421052631579,18,8,10,0.5714285714285714,0,0,0,0,0,0,0,0,0.4,0.4,0,5,-7,0.0789473684210526,0.0,-5
1997-09-24,Man United,Chelsea,2,2,D,7,17,75,32,0.5526315789473685,10,1,9,0.7142857142857143,6,12,59,3,0.42105263157894735,19,8,11,0.6666666666666666,0,0,0,0,0,0,0,0,0.6,0.8,5,16,29,0.13157894736842113,0.04761904761904767,-2
1997-09-24,Newcastle,Everton,1,0,H,4,9,68,33,0.5,5,4,1,0.75,6,7,42,-13,0.2631578947368421,8,10,-2,0.3333333333333333,0,0,0,0,0,0,0,0,,0.4,2,26,46,0.2368421052631579,0.4166666666666667,3
1997-09-24,Sheffield Weds,Derby,2,5,A,7,5,57,-1,0.3684210526315789,7,15,-8,0.14285714285714285,5,6,46,-13,0.2894736842105263,5,5,0,0.4,0,0,0,0,0,0,0,0,0.2,0.4,-1,11,12,0.0789473684210526,-0.2571428571428572,-8
1997-09-24,Southampton,Leeds,0,2,A,7,4,41,-6,0.2631578947368421,5,11,-6,0.14285714285714285,7,7,46,-10,0.2894736842105263,8,11,-3,0.2857142857142857,0,0,0,0,0,0,0,0,0.2,0.2,-3,-5,4,-0.026315789473684237,-0.14285714285714285,-3
1997-09-27,Aston Villa,Sheffield Weds,2,2,D,8,9,61,13,0.4473684210526316,8,13,-5,0.375,8,5,57,-1,0.3684210526315789,9,20,-11,0.125,0,0,0,0,0,0,0,0,0.6,0.2,4,4,14,0.07894736842105265,0.25,6
1997-09-27,Barnsley,Leicester,0,2,A,8,6,-1,-1,0.0,7,21,-14,0.25,8,15,47,-8,0.3157894736842105,11,6,5,0.5,0,0,1,0,0,0,0,0,0.2,0.4,-9,-48,7,-0.3157894736842105,-0.25,-19
1997-09-27,Chelsea,Newcastle,1,0,H,7,13,59,3,0.42105263157894735,21,10,11,0.5714285714285714,5,12,68,33,0.5,6,4,2,0.8,0,0,0,0,0,0,0,0,0.6,0.8,1,-9,-30,-0.07894736842105265,-0.22857142857142865,9
1997-09-27,Crystal Palace,Bolton,2,2,D,8,10,-1,-1,0.0,7,9,-2,0.375,7,7,-1,-1,0.0,6,9,-3,0.14285714285714285,0,0,0,0,0,0,0,0,0.2,0.0,3,0,0,0.0,0.23214285714285715,1
1997-09-27,Derby,Southampton,4,0,H,6,9,46,-13,0.2894736842105263,10,7,3,0.5,8,4,41,-6,0.2631578947368421,5,13,-8,0.125,0,0,0,0,0,0,0,0,0.6,0.2,5,5,-7,0.026315789473684237,0.375,11
1997-09-27,Everton,Arsenal,2,2,D,7,7,42,-13,0.2631578947368421,8,11,-3,0.2857142857142857,8,18,68,30,0.5,20,8,12,0.625,0,0,0,0,1,0,0,0,0.2,0.6,-11,-26,-43,-0.2368421052631579,-0.3392857142857143,-15
1997-09-27,Leeds,Man United,1,0,H,8,10,46,-10,0.2894736842105263,10,11,-1,0.375,8,18,75,32,0.5526315789473685,12,3,9,0.625,0,0,0,0,0,0,0,0,0.4,0.6,-8,-29,-42,-0.26315789473684215,-0.25,-10
1997-09-27,Tottenham,Wimbledon,0,0,D,8,9,46,-7,0.34210526315789475,6,10,-4,0.25,7,8,56,3,0.3947368421052632,10,10,0,0.2857142857142857,0,0,0,0,0,0,0,0,0.2,0.4,1,-10,-10,-0.052631578947368474,-0.0357142857142857,-4
1997-09-27,West Ham,Liverpool,2,1,H,8,10,42,-9,0.2631578947368421,10,13,-3,0.375,7,12,68,25,0.5,11,6,5,0.42857142857142855,0,0,1,0,0,0,0,0,0.2,0.6,-2,-26,-34,-0.2368421052631579,-0.05357142857142855,-8
1997-09-28,Blackburn,Coventry,0,0,D,8,15,42,-1,0.2368421052631579,19,9,10,0.5,8,10,41,-16,0.2368421052631579,8,11,-3,0.25,0,0,0,0,0,0,0,0,0.4,0.2,5,1,15,0.0,0.25,13
1997-10-04,Arsenal,Barnsley,5,0,H,9,19,68,30,0.5,22,10,12,0.5555555555555556,9,6,-1,-1,0.0,7,23,-16,0.2222222222222222,0,0,0,0,0,0,1,1,0.6,0.0,13,69,31,0.5,0.33333333333333337,28
1997-10-04,Bolton,Aston Villa,0,1,A,8,8,-1,-1,0.0,8,11,-3,0.125,9,10,61,13,0.4473684210526316,10,15,-5,0.3333333333333333,0,0,0,0,0,0,0,0,0.0,0.6,-2,-62,-14,-0.4473684210526316,-0.20833333333333331,2
1997-10-04,Coventry,Leeds,0,0,D,9,11,41,-16,0.2368421052631579,8,11,-3,0.2222222222222222,9,13,46,-10,0.2894736842105263,11,11,0,0.4444444444444444,0,0,0,0,0,0,0,0,0.2,0.6,-2,-5,-6,-0.05263157894736842,-0.2222222222222222,-3
1997-10-04,Man United,Crystal Palace,2,0,H,9,18,75,32,0.5526315789473685,12,4,8,0.5555555555555556,9,11,-1,-1,0.0,9,11,-2,0.3333333333333333,0,0,0,0,0,0,0,0,0.4,0.2,7,76,33,0.5526315789473685,0.22222222222222227,10
1997-10-04,Newcastle,Tottenham,1,0,H,6,12,68,33,0.5,6,5,1,0.6666666666666666,9,10,46,-7,0.34210526315789475,6,10,-4,0.2222222222222222,0,0,0,0,0,0,0,0,0.6,0.0,2,22,40,0.15789473684210525,0.4444444444444444,5
1997-10-04,Sheffield Weds,Everton,3,1,H,9,6,57,-1,0.3684210526315789,11,22,-11,0.1111111111111111,8,8,42,-13,0.2631578947368421,10,13,-3,0.25,0,0,0,0,0,0,0,0,0.2,0.2,-2,15,12,0.10526315789473684,-0.1388888888888889,-8
1997-10-04,Southampton,West Ham,3,0,H,9,4,41,-6,0.2631578947368421,5,17,-12,0.1111111111111111,9,13,42,-9,0.2631578947368421,12,14,-2,0.4444444444444444,0,0,0,0,0,0,0,0,0.0,0.4,-9,-1,3,0.0,-0.3333333333333333,-10
1997-10-04,Wimbledon,Blackburn,0,1,A,8,9,56,3,0.3947368421052632,10,10,0,0.25,9,16,42,-1,0.2368421052631579,19,9,10,0.4444444444444444,0,0,0,0,0,0,0,0,0.4,0.2,-7,14,4,0.1578947368421053,-0.19444444444444442,-10
1997-10-05,Liverpool,Chelsea,4,2,H,8,12,68,25,0.5,12,8,4,0.375,8,16,59,3,0.42105263157894735,22,10,12,0.625,0,0,0,0,0,0,0,0,0.6,0.6,-4,9,22,0.07894736842105265,-0.25,-8
1997-10-06,Leicester,Derby,1,2,A,9,18,47,-8,0.3157894736842105,13,6,7,0.5555555555555556,7,12,46,-13,0.2894736842105263,14,7,7,0.5714285714285714,0,0,0,0,0,0,0,0,0.6,0.8,6,1,5,0.02631578947368418,-0.015873015873015817,0
1997-10-18,Aston Villa,Wimbledon,1,2,A,10,13,61,13,0.4473684210526316,11,15,-4,0.4,9,9,56,3,0.3947368421052632,10,11,-1,0.2222222222222222,0,0,0,0,0,0,0,0,0.6,0.4,4,5,10,0.05263157894736836,0.1777777777777778,-3
1997-10-18,Blackburn,Southampton,1,0,H,10,19,42,-1,0.2368421052631579,20,9,11,0.5,10,7,41,-6,0.2631578947368421,8,17,-9,0.2,0,0,0,0,0,0,0,0,0.2,0.2,12,1,5,-0.02631578947368418,0.3,20
1997-10-18,Chelsea,Leicester,1,0,H,9,16,59,3,0.42105263157894735,24,14,10,0.5555555555555556,10,18,47,-8,0.3157894736842105,14,8,6,0.5,0,0,0,0,0,0,0,0,0.4,0.6,-2,12,11,0.10526315789473684,0.05555555555555558,4
1997-10-18,Crystal Palace,Arsenal,0,0,D,10,11,-1,-1,0.0,9,13,-4,0.3,10,22,68,30,0.5,27,10,17,0.6,0,0,0,0,0,0,0,0,0.2,0.8,-11,-69,-31,-0.5,-0.3,-21
1997-10-18,Derby,Man United,2,2,D,8,15,46,-13,0.2894736842105263,16,8,8,0.625,10,21,75,32,0.5526315789473685,14,4,10,0.6,1,0,0,0,0,0,0,0,0.8,0.4,-6,-29,-45,-0.26315789473684215,0.025000000000000022,-2
1997-10-18,Everton,Liverpool,2,0,H,9,8,42,-13,0.2631578947368421,11,16,-5,0.2222222222222222,9,15,68,25,0.5,16,10,6,0.4444444444444444,0,0,0,0,0,0,0,0,0.2,0.6,-7,-26,-38,-0.2368421052631579,-0.2222222222222222,-11
1997-10-18,Leeds,Newcastle,4,1,H,10,14,46,-10,0.2894736842105263,11,11,0,0.4,7,15,68,33,0.5,7,5,2,0.7142857142857143,0,0,0,0,0,0,0,0,0.6,0.6,-1,-22,-43,-0.21052631578947367,-0.3142857142857143,-2
1997-10-18,West Ham,Bolton,3,0,H,10,13,42,-9,0.2631578947368421,12,17,-5,0.4,9,8,-1,-1,0.0,8,12,-4,0.1111111111111111,0,0,0,0,0,0,0,0,0.2,0.0,5,43,-8,0.2631578947368421,0.2888888888888889,-1
1997-10-19,Tottenham,Sheffield Weds,3,2,H,10,10,46,-7,0.34210526315789475,6,11,-5,0.2,10,9,57,-1,0.3684210526315789,14,23,-9,0.2,0,0,0,0,0,0,0,0,0.0,0.2,1,-11,-6,-0.02631578947368418,0.0,4
1997-10-20,Barnsley,Coventry,2,0,H,10,6,-1,-1,0.0,7,28,-21,0.2,10,12,41,-16,0.2368421052631579,8,11,-3,0.2,0,0,1,1,0,0,0,0,0.0,0.2,-6,-42,15,-0.2368421052631579,0.0,-18
1997-10-22,Derby,Wimbledon,1,1,D,9,16,46,-13,0.2894736842105263,18,10,8,0.5555555555555556,10,12,56,3,0.3947368421052632,12,12,0,0.3,0,0,0,0,0,0,0,0,0.6,0.4,4,-10,-16,-0.10526315789473689,0.2555555555555556,8
1997-10-25,Coventry,Everton,0,0,D,11,12,41,-16,0.2368421052631579,8,13,-5,0.18181818181818182,10,11,42,-13,0.2631578947368421,13,16,-3,0.3,0,0,0,0,0,0,0,0,0.0,0.4,1,-1,-3,-0.02631578947368418,-0.11818181818181817,-2
1997-10-25,Liverpool,Derby,4,0,H,10,15,68,25,0.5,16,12,4,0.4,10,17,46,-13,0.2894736842105263,19,11,8,0.5,0,0,0,0,0,0,0,0,0.4,0.6,-2,22,38,0.21052631578947367,-0.09999999999999998,-4
1997-10-25,Man United,Barnsley,7,0,H,11,22,75,32,0.5526315789473685,16,6,10,0.5454545454545454,11,9,-1,-1,0.0,9,28,-19,0.2727272727272727,0,0,0,0,0,0,0,0,0.2,0.2,13,76,33,0.5526315789473685,0.2727272727272727,29
1997-10-25,Newcastle,Blackburn,1,1,D,8,15,68,33,0.5,8,9,-1,0.625,11,22,42,-1,0.2368421052631579,21,9,12,0.5454545454545454,0,0,0,0,0,0,0,0,0.6,0.4,-7,26,34,0.2631578947368421,0.07954545454545459,-13
1997-10-25,Sheffield Weds,Crystal Palace,1,3,A,11,9,57,-1,0.3684210526315789,16,26,-10,0.18181818181818182,11,12,-1,-1,0.0,9,13,-4,0.2727272727272727,0,0,0,0,0,0,0,0,0.2,0.2,-3,58,0,0.3684210526315789,-0.09090909090909088,-6
1997-10-25,Southampton,Tottenham,3,2,H,11,7,41,-6,0.2631578947368421,8,18,-10,0.18181818181818182,11,13,46,-7,0.34210526315789475,9,13,-4,0.2727272727272727,0,0,0,0,0,0,0,0,0.2,0.2,-6,-5,1,-0.07894736842105265,-0.09090909090909088,-6
1997-10-25,Wimbledon,Leeds,1,0,H,11,13,56,3,0.3947368421052632,13,13,0,0.2727272727272727,11,17,46,-10,0.2894736842105263,15,12,3,0.45454545454545453,0,0,0,0,0,0,0,0,0.4,0.6,-4,10,13,0.10526315789473689,-0.18181818181818182,-3
1997-10-26,Arsenal,Aston Villa,0,0,D,11,23,68,30,0.5,27,10,17,0.5454545454545454,11,13,61,13,0.4473684210526316,12,17,-5,0.36363636363636365,0,0,0,0,0,0,0,0,0.6,0.4,10,7,17,0.05263157894736842,0.18181818181818177,22
1997-10-26,Bolton,Chelsea,1,0,H,10,8,-1,-1,0.0,8,15,-7,0.1,10,19,59,3,0.42105263157894735,25,14,11,0.6,0,0,0,0,0,0,0,0,0.0,0.4,-11,-60,-4,-0.42105263157894735,-0.5,-18
1997-10-27,Leicester,West Ham,2,1,H,11,18,47,-8,0.3157894736842105,14,9,5,0.45454545454545453,11,16,42,-9,0.2631578947368421,15,17,-2,0.45454545454545453,0,0,0,0,0,0,0,0,0.4,0.4,2,5,1,0.05263157894736842,0.0,7
1997-11-01,Aston Villa,Chelsea,0,2,A,12,14,61,13,0.4473684210526316,12,17,-5,0.3333333333333333,11,19,59,3,0.42105263157894735,25,15,10,0.5454545454545454,0,0,0,0,0,0,0,0,0.2,0.4,-5,2,10,0.026315789473684237,-0.2121212121212121,-15
1997-11-01,Barnsley,Blackburn,1,1,D,12,9,-1,-1,0.0,9,35,-26,0.25,12,23,42,-1,0.2368421052631579,22,10,12,0.5,0,0,0,0,0,0,0,0,0.2,0.4,-14,-43,0,-0.2368421052631579,-0.25,-38
1997-11-01,Bolton,Liverpool,1,1,D,11,11,-1,-1,0.0,9,15,-6,0.18181818181818182,11,18,68,25,0.5,20,12,8,0.45454545454545453,0,0,0,0,0,0,0,0,0.2,0.6,-7,-69,-26,-0.5,-0.2727272727272727,-14
1997-11-01,Derby,Arsenal,3,0,H,11,17,46,-13,0.2894736842105263,19,15,4,0.45454545454545453,12,24,68,30,0.5,27,10,17,0.5,0,0,0,0,0,0,0,0,0.4,0.4,-7,-22,-43,-0.21052631578947367,-0.04545454545454547,-13
1997-11-01,Man United,Sheffield Weds,6,1,H,12,25,75,32,0.5526315789473685,23,6,17,0.5833333333333334,12,9,57,-1,0.3684210526315789,17,29,-12,0.16666666666666666,0,0,0,0,0,0,0,0,0.4,0.2,16,18,33,0.18421052631578955,0.41666666666666674,29
1997-11-01,Newcastle,Leicester,3,3,D,9,16,68,33,0.5,9,10,-1,0.5555555555555556,12,21,47,-8,0.3157894736842105,16,10,6,0.5,0,0,0,0,0,0,0,0,0.4,0.4,-5,21,41,0.1842105263157895,0.05555555555555558,-7
1997-11-01,Tottenham,Leeds,0,1,A,12,13,46,-7,0.34210526315789475,11,16,-5,0.25,12,17,46,-10,0.2894736842105263,15,13,2,0.4166666666666667,0,0,0,0,0,0,0,0,0.2,0.6,-4,0,3,0.05263157894736842,-0.16666666666666669,-7
1997-11-01,Wimbledon,Coventry,1,2,A,12,16,56,3,0.3947368421052632,14,13,1,0.3333333333333333,12,13,41,-16,0.2368421052631579,8,13,-5,0.16666666666666666,0,0,0,0,0,0,0,0,0.4,0.0,3,15,19,0.1578947368421053,0.16666666666666666,6
1997-11-02,Everton,Southampton,0,2,A,11,12,42,-13,0.2631578947368421,13,16,-3,0.2727272727272727,12,10,41,-6,0.2631578947368421,11,20,-9,0.25,0,0,0,0,0,0,0,0,0.2,0.4,2,1,-7,0.0,0.022727272727272707,6
1997-11-08,Blackburn,Everton,3,2,H,13,24,42,-1,0.2368421052631579,23,11,12,0.46153846153846156,12,12,42,-13,0.2631578947368421,13,18,-5,0.25,0,0,0,0,0,0,0,0,0.4,0.2,12,0,12,-0.02631578947368418,0.21153846153846156,17
1997-11-08,Coventry,Newcastle,2,2,D,13,16,41,-16,0.2368421052631579,10,14,-4,0.23076923076923078,10,17,68,33,0.5,12,13,-1,0.5,0,0,0,0,0,0,0,0,0.2,0.2,-1,-27,-49,-0.2631578947368421,-0.2692307692307692,-3
1997-11-08,Crystal Palace,Aston Villa,1,1,D,12,15,-1,-1,0.0,12,14,-2,0.3333333333333333,13,14,61,13,0.4473684210526316,12,19,-7,0.3076923076923077,0,0,0,0,0,0,0,0,0.2,0.2,1,-62,-14,-0.4473684210526316,0.025641025641025605,5
1997-11-08,Leeds,Derby,4,3,H,13,20,46,-10,0.2894736842105263,16,13,3,0.46153846153846156,12,20,46,-13,0.2894736842105263,22,15,7,0.5,0,0,0,0,0,0,0,0,0.6,0.4,0,0,3,0.0,-0.038461538461538436,-4
1997-11-08,Liverpool,Tottenham,4,0,H,12,19,68,25,0.5,21,13,8,0.4166666666666667,13,13,46,-7,0.34210526315789475,11,17,-6,0.23076923076923078,0,0,0,0,0,0,0,0,0.4,0.2,6,22,32,0.15789473684210525,0.1858974358974359,14
1997-11-08,Sheffield Weds,Bolton,5,0,H,13,9,57,-1,0.3684210526315789,18,35,-17,0.15384615384615385,12,12,-1,-1,0.0,10,16,-6,0.16666666666666666,0,0,1,0,0,0,0,0,0.2,0.2,-3,58,0,0.3684210526315789,-0.012820512820512803,-11
1997-11-08,Southampton,Barnsley,4,1,H,13,13,41,-6,0.2631578947368421,13,20,-7,0.3076923076923077,13,10,-1,-1,0.0,10,36,-26,0.23076923076923078,0,0,0,0,0,0,0,0,0.6,0.2,3,42,-5,0.2631578947368421,0.07692307692307693,19
1997-11-09,Arsenal,Man United,3,2,H,13,24,68,30,0.5,27,13,14,0.46153846153846156,13,28,75,32,0.5526315789473685,29,7,22,0.6153846153846154,0,0,0,0,0,0,0,0,0.2,0.6,-4,-7,-2,-0.052631578947368474,-0.15384615384615385,-8
1997-11-09,Chelsea,West Ham,2,1,H,12,22,59,3,0.42105263157894735,27,15,12,0.5833333333333334,12,16,42,-9,0.2631578947368421,16,19,-3,0.4166666666666667,0,0,0,0,0,0,0,0,0.6,0.4,6,17,12,0.15789473684210525,0.16666666666666669,15
1997-11-10,Leicester,Wimbledon,0,1,A,13,22,47,-8,0.3157894736842105,19,13,6,0.46153846153846156,13,16,56,3,0.3947368421052632,15,15,0,0.3076923076923077,0,0,0,0,0,0,0,0,0.4,0.4,6,-9,-11,-0.07894736842105271,0.15384615384615385,6
1997-11-22,Aston Villa,Everton,2,1,H,14,15,61,13,0.4473684210526316,13,20,-7,0.2857142857142857,13,12,42,-13,0.2631578947368421,15,21,-6,0.23076923076923078,0,0,0,0,0,0,0,0,0.2,0.2,3,19,26,0.1842105263157895,0.054945054945054916,-1
1997-11-22,Blackburn,Chelsea,1,0,H,14,27,42,-1,0.2368421052631579,26,13,13,0.5,13,25,59,3,0.42105263157894735,29,16,13,0.6153846153846154,0,0,0,0,0,0,0,0,0.6,0.6,2,-17,-4,-0.18421052631578944,-0.11538461538461542,0
1997-11-22,Derby,Coventry,3,1,H,13,20,46,-13,0.2894736842105263,25,19,6,0.46153846153846156,14,17,41,-16,0.2368421052631579,12,16,-4,0.21428571428571427,0,0,0,0,0,0,0,0,0.2,0.2,3,5,3,0.05263157894736842,0.2472527472527473,10
1997-11-22,Leicester,Bolton,0,0,D,14,22,47,-8,0.3157894736842105,19,14,5,0.42857142857142855,13,12,-1,-1,0.0,10,21,-11,0.15384615384615385,0,0,0,0,0,0,0,0,0.2,0.2,10,48,-7,0.3157894736842105,0.2747252747252747,16
1997-11-22,Liverpool,Barnsley,0,1,A,13,22,68,25,0.5,25,13,12,0.46153846153846156,14,10,-1,-1,0.0,11,40,-29,0.21428571428571427,0,0,0,0,0,0,0,0,0.6,0.2,12,69,26,0.5,0.2472527472527473,41
1997-11-22,Newcastle,Southampton,2,1,H,11,18,68,33,0.5,14,15,-1,0.45454545454545453,14,16,41,-6,0.2631578947368421,17,21,-4,0.35714285714285715,0,0,0,0,1,0,0,0,0.2,0.8,2,27,39,0.2368421052631579,0.09740259740259738,3
1997-11-22,Sheffield Weds,Arsenal,2,0,H,14,12,57,-1,0.3684210526315789,23,35,-12,0.21428571428571427,14,27,68,30,0.5,30,15,15,0.5,0,0,0,0,0,0,0,0,0.4,0.4,-15,-11,-31,-0.13157894736842107,-0.2857142857142857,-27
1997-11-22,Wimbledon,Man United,2,5,A,14,19,56,3,0.3947368421052632,16,15,1,0.35714285714285715,14,28,75,32,0.5526315789473685,31,10,21,0.5714285714285714,0,0,0,0,0,0,0,0,0.6,0.6,-9,-19,-29,-0.15789473684210525,-0.21428571428571425,-20
1997-11-23,Leeds,West Ham,3,1,H,14,23,46,-10,0.2894736842105263,20,16,4,0.5,13,16,42,-9,0.2631578947368421,17,21,-4,0.38461538461538464,0,0,0,0,0,0,0,0,0.6,0.4,7,4,-1,0.026315789473684237,0.11538461538461536,8
1997-11-24,Tottenham,Crystal Palace,0,1,A,14,13,46,-7,0.34210526315789475,11,21,-10,0.21428571428571427,13,16,-1,-1,0.0,13,15,-2,0.3076923076923077,0,0,1,0,0,0,0,0,0.2,0.2,-3,47,-6,0.34210526315789475,-0.09340659340659344,-8
1997-11-26,Chelsea,Everton,2,0,H,14,25,59,3,0.42105263157894735,29,17,12,0.5714285714285714,14,12,42,-13,0.2631578947368421,16,23,-7,0.21428571428571427,0,0,0,0,0,0,1,0,0.6,0.2,13,17,16,0.15789473684210525,0.3571428571428571,19
1997-11-29,Barnsley,Leeds,2,3,A,15,13,-1,-1,0.0,12,40,-28,0.26666666666666666,15,26,46,-10,0.2894736842105263,23,17,6,0.5333333333333333,0,0,0,0,1,0,0,0,0.4,0.8,-13,-47,9,-0.2894736842105263,-0.26666666666666666,-34
1997-11-29,Bolton,Wimbledon,1,0,H,14,13,-1,-1,0.0,10,21,-11,0.14285714285714285,15,19,56,3,0.3947368421052632,18,20,-2,0.3333333333333333,0,0,0,0,0,0,0,0,0.2,0.4,-6,-57,-4,-0.3947368421052632,-0.19047619047619047,-9
1997-11-29,Chelsea,Derby,4,0,H,15,28,59,3,0.42105263157894735,31,17,14,0.6,14,23,46,-13,0.2894736842105263,28,20,8,0.5,0,0,0,0,0,0,0,0,0.6,0.4,5,13,16,0.13157894736842102,0.09999999999999998,6
1997-11-29,Coventry,Leicester,0,2,A,15,17,41,-16,0.2368421052631579,13,19,-6,0.2,15,23,47,-8,0.3157894736842105,19,14,5,0.4,0,0,0,0,0,0,0,0,0.2,0.2,-6,-6,-8,-0.0789473684210526,-0.2,-11
1997-11-29,Crystal Palace,Newcastle,1,2,A,14,19,-1,-1,0.0,14,15,-1,0.35714285714285715,12,21,68,33,0.5,16,16,0,0.5,0,0,0,0,0,0,0,0,0.4,0.2,-2,-69,-34,-0.5,-0.14285714285714285,-1
1997-11-29,Everton,Tottenham,0,2,A,15,12,42,-13,0.2631578947368421,16,25,-9,0.2,15,13,46,-7,0.34210526315789475,11,22,-11,0.2,0,0,1,0,0,0,1,0,0.0,0.2,-1,-4,-6,-0.07894736842105265,0.0,2
1997-11-29,Southampton,Sheffield Weds,2,3,A,15,16,41,-6,0.2631578947368421,18,23,-5,0.3333333333333333,15,15,57,-1,0.3684210526315789,25,35,-10,0.26666666666666666,0,0,0,0,0,0,0,0,0.6,0.4,1,-16,-5,-0.10526315789473684,0.06666666666666665,5
1997-11-29,West Ham,Aston Villa,2,1,H,14,16,42,-9,0.2631578947368421,18,24,-6,0.35714285714285715,15,18,61,13,0.4473684210526316,15,21,-6,0.3333333333333333,0,0,1,0,0,0,0,0,0.2,0.2,-2,-19,-22,-0.1842105263157895,0.023809523809523836,0
1997-11-30,Arsenal,Liverpool,0,1,A,15,27,68,30,0.5,30,17,13,0.4666666666666667,14,22,68,25,0.5,25,14,11,0.42857142857142855,0,0,0,0,0,0,0,0,0.2,0.4,5,0,5,0.0,0.038095238095238126,2
1997-11-30,Man United,Blackburn,4,0,H,15,31,75,32,0.5526315789473685,36,12,24,0.6,15,30,42,-1,0.2368421052631579,27,13,14,0.5333333333333333,0,0,0,0,0,0,0,0,0.6,0.6,1,33,33,0.31578947368421056,0.06666666666666665,10
1997-12-01,Bolton,Newcastle,1,0,H,15,16,-1,-1,0.0,11,21,-10,0.2,13,24,68,33,0.5,18,17,1,0.5384615384615384,0,0,0,0,0,0,0,0,0.4,0.4,-8,-69,-34,-0.5,-0.3384615384615384,-11
1997-12-03,West Ham,Crystal Palace,4,1,H,15,19,42,-9,0.2631578947368421,20,25,-5,0.4,15,19,-1,-1,0.0,15,17,-2,0.3333333333333333,0,0,0,0,0,0,0,0,0.4,0.4,0,43,-8,0.2631578947368421,0.06666666666666671,-3
1997-12-06,Aston Villa,Coventry,3,0,H,16,18,61,13,0.4473684210526316,16,23,-7,0.3125,16,17,41,-16,0.2368421052631579,13,21,-8,0.1875,0,0,0,0,0,0,0,0,0.2,0.2,1,20,29,0.21052631578947367,0.125,1
1997-12-06,Blackburn,Bolton,3,1,H,16,30,42,-1,0.2368421052631579,27,17,10,0.5,16,19,-1,-1,0.0,12,21,-9,0.25,0,0,0,0,0,0,0,0,0.4,0.4,11,43,0,0.2368421052631579,0.25,19
1997-12-06,Derby,West Ham,2,0,H,15,23,46,-13,0.2894736842105263,28,24,4,0.4666666666666667,16,22,42,-9,0.2631578947368421,24,26,-2,0.4375,0,0,0,0,0,0,0,0,0.4,0.4,1,4,-4,0.026315789473684237,0.029166666666666674,6
1997-12-06,Leeds,Everton,0,0,D,16,29,46,-10,0.2894736842105263,26,19,7,0.5625,16,12,42,-13,0.2631578947368421,16,27,-11,0.1875,1,0,0,0,0,0,1,1,0.8,0.0,17,4,3,0.026315789473684237,0.375,18
1997-12-06,Leicester,Crystal Palace,1,1,D,16,26,47,-8,0.3157894736842105,21,14,7,0.4375,16,19,-1,-1,0.0,16,21,-5,0.3125,0,0,0,0,0,0,0,0,0.4,0.4,7,48,-7,0.3157894736842105,0.125,12
1997-12-06,Liverpool,Man United,1,3,A,15,25,68,25,0.5,26,14,12,0.4666666666666667,16,34,75,32,0.5526315789473685,40,12,28,0.625,0,0,0,0,0,0,0,0,0.6,0.8,-9,-7,-7,-0.052631578947368474,-0.15833333333333333,-16
1997-12-06,Newcastle,Arsenal,0,1,A,14,24,68,33,0.5,18,18,0,0.5,16,27,68,30,0.5,30,18,12,0.4375,0,0,0,0,0,0,0,0,0.4,0.2,-3,0,3,0.0,0.0625,-12
1997-12-06,Tottenham,Chelsea,1,6,A,16,16,46,-7,0.34210526315789475,13,22,-9,0.25,16,31,59,3,0.42105263157894735,35,17,18,0.625,0,0,0,0,0,0,0,0,0.2,0.8,-15,-13,-10,-0.0789473684210526,-0.375,-27
1997-12-07,Wimbledon,Southampton,1,0,H,16,19,56,3,0.3947368421052632,18,21,-3,0.3125,16,16,41,-6,0.2631578947368421,20,26,-6,0.3125,0,0,0,0,0,0,0,0,0.4,0.6,3,15,9,0.13157894736842113,0.0,3
1997-12-08,Sheffield Weds,Barnsley,2,1,H,16,18,57,-1,0.3684210526315789,28,37,-9,0.3125,16,13,-1,-1,0.0,14,43,-29,0.25,1,0,0,0,0,0,0,0,0.6,0.2,5,58,0,0.3684210526315789,0.0625,20
1997-12-13,Arsenal,Blackburn,1,3,A,17,30,68,30,0.5,31,18,13,0.47058823529411764,17,33,42,-1,0.2368421052631579,30,18,12,0.5294117647058824,0,0,0,0,0,0,0,0,0.4,0.6,-3,26,31,0.2631578947368421,-0.05882352941176472,1
1997-12-13,Barnsley,Newcastle,2,2,D,17,13,-1,-1,0.0,15,45,-30,0.23529411764705882,15,24,68,33,0.5,18,19,-1,0.4666666666666667,0,0,0,0,0,0,0,0,0.2,0.4,-11,-69,-34,-0.5,-0.23137254901960785,-29
1997-12-13,Chelsea,Leeds,0,0,D,17,34,59,3,0.42105263157894735,41,18,23,0.6470588235294118,17,30,46,-10,0.2894736842105263,26,19,7,0.5294117647058824,1,0,0,0,0,0,0,0,0.8,0.8,4,13,13,0.13157894736842102,0.11764705882352944,16
1997-12-13,Coventry,Tottenham,4,0,H,17,17,41,-16,0.2368421052631579,13,24,-11,0.17647058823529413,17,16,46,-7,0.34210526315789475,14,28,-14,0.23529411764705882,0,0,1,0,0,0,0,0,0.2,0.2,1,-5,-9,-0.10526315789473684,-0.05882352941176469,3
1997-12-13,Crystal Palace,Liverpool,0,3,A,17,20,-1,-1,0.0,17,22,-5,0.29411764705882354,16,25,68,25,0.5,27,17,10,0.4375,0,0,0,0,0,0,0,0,0.2,0.4,-5,-69,-26,-0.5,-0.14338235294117646,-15
1997-12-13,Everton,Wimbledon,0,0,D,17,13,42,-13,0.2631578947368421,16,27,-11,0.17647058823529413,17,22,56,3,0.3947368421052632,19,21,-2,0.35294117647058826,0,0,0,0,0,0,0,0,0.0,0.4,-9,-14,-16,-0.13157894736842113,-0.17647058823529413,-9
1997-12-13,Southampton,Leicester,2,1,H,17,16,41,-6,0.2631578947368421,20,27,-7,0.29411764705882354,17,27,47,-8,0.3157894736842105,22,15,7,0.4117647058823529,0,0,1,0,0,0,0,0,0.4,0.2,-11,-6,2,-0.05263157894736842,-0.11764705882352938,-14
1997-12-13,West Ham,Sheffield Weds,1,0,H,17,22,42,-9,0.2631578947368421,24,28,-4,0.4117647058823529,17,21,57,-1,0.3684210526315789,30,38,-8,0.35294117647058826,0,0,0,0,1,0,0,0,0.4,0.8,1,-15,-8,-0.10526315789473684,0.05882352941176466,4
1997-12-14,Bolton,Derby,3,3,D,17,19,-1,-1,0.0,13,24,-11,0.23529411764705882,16,26,46,-13,0.2894736842105263,30,24,6,0.5,0,0,0,0,0,0,0,0,0.4,0.6,-7,-47,12,-0.2894736842105263,-0.2647058823529412,-17
1997-12-15,Man United,Aston Villa,1,0,H,17,37,75,32,0.5526315789473685,43,13,30,0.6470588235294118,17,21,61,13,0.4473684210526316,19,23,-4,0.35294117647058826,1,0,0,0,0,0,0,0,0.8,0.4,16,14,19,0.10526315789473689,0.29411764705882354,34
1997-12-17,Newcastle,Derby,0,0,D,16,25,68,33,0.5,20,21,-1,0.4375,17,27,46,-13,0.2894736842105263,33,27,6,0.47058823529411764,0,0,0,0,0,0,0,0,0.4,0.4,-2,22,46,0.21052631578947367,-0.03308823529411764,-7
1997-12-20,Aston Villa,Southampton,1,1,D,18,21,61,13,0.4473684210526316,19,24,-5,0.3333333333333333,18,19,41,-6,0.2631578947368421,22,28,-6,0.3333333333333333,0,0,0,0,0,0,0,0,0.4,0.4,2,20,19,0.1842105263157895,0.0,1
1997-12-20,Blackburn,West Ham,3,0,H,18,36,42,-1,0.2368421052631579,33,19,14,0.5555555555555556,18,25,42,-9,0.2631578947368421,25,28,-3,0.4444444444444444,0,0,0,0,0,0,0,0,0.8,0.6,11,0,8,-0.02631578947368418,0.11111111111111116,17
1997-12-20,Derby,Crystal Palace,0,0,D,18,28,46,-13,0.2894736842105263,33,27,6,0.4444444444444444,18,20,-1,-1,0.0,17,25,-8,0.2777777777777778,0,0,0,0,0,0,0,0,0.4,0.2,8,47,-12,0.2894736842105263,0.16666666666666663,14
1997-12-20,Leeds,Bolton,2,0,H,18,31,46,-10,0.2894736842105263,26,19,7,0.5,18,20,-1,-1,0.0,16,27,-11,0.2222222222222222,0,0,0,0,0,0,0,0,0.6,0.4,11,47,-9,0.2894736842105263,0.2777777777777778,18
1997-12-20,Leicester,Everton,0,1,A,18,27,47,-8,0.3157894736842105,23,17,6,0.3888888888888889,18,14,42,-13,0.2631578947368421,16,27,-11,0.16666666666666666,0,0,0,0,0,0,0,0,0.2,0.0,13,5,5,0.05263157894736842,0.22222222222222224,17
1997-12-20,Liverpool,Coventry,1,0,H,17,28,68,25,0.5,30,17,13,0.47058823529411764,18,20,41,-16,0.2368421052631579,17,24,-7,0.2222222222222222,0,0,0,0,0,0,0,0,0.6,0.2,8,27,41,0.2631578947368421,0.24836601307189543,20
1997-12-20,Sheffield Weds,Chelsea,1,4,A,18,21,57,-1,0.3684210526315789,30,39,-9,0.3333333333333333,18,35,59,3,0.42105263157894735,41,18,23,0.6111111111111112,0,0,0,0,0,0,0,0,0.8,0.6,-14,-2,-4,-0.05263157894736842,-0.27777777777777785,-32
1997-12-20,Tottenham,Barnsley,3,0,H,18,16,46,-7,0.34210526315789475,14,32,-18,0.2222222222222222,18,14,-1,-1,0.0,17,47,-30,0.2222222222222222,0,0,0,0,0,0,0,0,0.2,0.2,2,47,-6,0.34210526315789475,0.0,12
1997-12-21,Newcastle,Man United,0,1,A,17,26,68,33,0.5,20,21,-1,0.4117647058823529,18,40,75,32,0.5526315789473685,44,13,31,0.6666666666666666,0,0,0,0,1,0,0,0,0.2,0.8,-14,-7,1,-0.052631578947368474,-0.2549019607843137,-32
1997-12-26,Arsenal,Leicester,2,1,H,18,30,68,30,0.5,32,21,11,0.4444444444444444,19,27,47,-8,0.3157894736842105,23,18,5,0.3684210526315789,0,0,0,0,0,0,0,0,0.4,0.2,3,21,38,0.1842105263157895,0.07602339181286549,6
1997-12-26,Aston Villa,Tottenham,4,1,H,19,22,61,13,0.4473684210526316,20,25,-5,0.3157894736842105,19,19,46,-7,0.34210526315789475,17,32,-15,0.2631578947368421,0,0,0,0,0,0,0,0,0.4,0.4,3,15,20,0.10526315789473684,0.05263157894736842,10
1997-12-26,Bolton,Barnsley,1,1,D,19,20,-1,-1,0.0,16,29,-13,0.21052631578947367,19,14,-1,-1,0.0,17,50,-33,0.21052631578947367,0,0,0,0,0,0,0,0,0.4,0.2,6,0,0,0.0,0.0,20
1997-12-26,Chelsea,Wimbledon,1,1,D,19,38,59,3,0.42105263157894735,45,19,26,0.631578947368421,18,23,56,3,0.3947368421052632,19,21,-2,0.3333333333333333,0,0,0,0,0,0,0,0,0.8,0.4,15,3,0,0.026315789473684126,0.2982456140350877,28
1997-12-26,Crystal Palace,Southampton,1,1,D,19,21,-1,-1,0.0,17,25,-8,0.2631578947368421,19,20,41,-6,0.2631578947368421,23,29,-6,0.3157894736842105,0,0,0,0,0,0,0,0,0.0,0.2,1,-42,5,-0.2631578947368421,-0.05263157894736842,-2
1997-12-26,Derby,Newcastle,1,0,H,19,29,46,-13,0.2894736842105263,33,27,6,0.42105263157894735,18,26,68,33,0.5,20,22,-2,0.3888888888888889,0,0,0,0,0,0,0,0,0.2,0.0,3,-22,-46,-0.21052631578947367,0.03216374269005845,8
1997-12-26,Liverpool,Leeds,3,1,H,18,31,68,25,0.5,31,17,14,0.5,19,34,46,-10,0.2894736842105263,28,19,9,0.5263157894736842,0,0,0,0,0,0,0,0,0.6,0.6,-3,22,35,0.21052631578947367,-0.02631578947368418,5
1997-12-26,Man United,Everton,2,0,H,19,43,75,32,0.5526315789473685,45,13,32,0.6842105263157895,19,17,42,-13,0.2631578947368421,17,27,-10,0.21052631578947367,1,1,0,0,0,0,0,0,1.0,0.2,26,33,45,0.2894736842105264,0.4736842105263158,42
1997-12-26,Sheffield Weds,Blackburn,0,0,D,19,21,57,-1,0.3684210526315789,31,43,-12,0.3157894736842105,19,39,42,-1,0.2368421052631579,36,19,17,0.5789473684210527,0,0,0,0,1,0,0,0,0.6,0.8,-18,15,0,0.13157894736842102,-0.26315789473684215,-29
1997-12-26,West Ham,Coventry,1,0,H,19,25,42,-9,0.2631578947368421,25,31,-6,0.42105263157894735,19,20,41,-16,0.2368421052631579,17,25,-8,0.21052631578947367,0,0,0,0,0,0,0,0,0.6,0.2,5,1,7,0.02631578947368418,0.21052631578947367,2
1997-12-28,Barnsley,Derby,1,0,H,20,15,-1,-1,0.0,18,51,-33,0.2,20,32,46,-13,0.2894736842105263,34,27,7,0.45,0,0,0,0,0,0,0,0,0.0,0.4,-17,-47,12,-0.2894736842105263,-0.25,-40
1997-12-28,Blackburn,Crystal Palace,2,2,D,20,40,42,-1,0.2368421052631579,36,19,17,0.55,20,22,-1,-1,0.0,18,26,-8,0.25,0,0,0,0,0,0,0,0,0.6,0.0,18,43,0,0.2368421052631579,0.30000000000000004,25
1997-12-28,Coventry,Man United,3,2,H,20,20,41,-16,0.2368421052631579,17,26,-9,0.2,20,46,75,32,0.5526315789473685,47,13,34,0.7,0,0,0,0,1,1,0,0,0.2,1.0,-26,-34,-48,-0.31578947368421056,-0.49999999999999994,-43
1997-12-28,Everton,Bolton,3,2,H,20,17,42,-13,0.2631578947368421,17,29,-12,0.2,20,21,-1,-1,0.0,17,30,-13,0.2,0,0,0,0,0,0,0,0,0.2,0.2,-4,43,-12,0.2631578947368421,0.0,1
1997-12-28,Leeds,Aston Villa,1,1,D,20,34,46,-10,0.2894736842105263,29,22,7,0.5,20,25,61,13,0.4473684210526316,24,26,-2,0.35,0,0,0,0,0,0,0,0,0.4,0.4,9,-15,-23,-0.15789473684210525,0.15000000000000002,9
1997-12-28,Leicester,Sheffield Weds,1,1,D,20,27,47,-8,0.3157894736842105,24,20,4,0.35,20,22,57,-1,0.3684210526315789,31,43,-12,0.3,0,0,1,0,0,0,0,0,0.2,0.4,5,-10,-7,-0.05263157894736842,0.04999999999999999,16
1997-12-28,Newcastle,Liverpool,1,2,A,19,26,68,33,0.5,20,23,-3,0.3684210526315789,19,34,68,25,0.5,34,18,16,0.5263157894736842,0,0,0,0,1,0,0,0,0.0,0.8,-8,0,8,0.0,-0.15789473684210525,-19
1997-12-28,Tottenham,Arsenal,1,1,D,20,19,46,-7,0.34210526315789475,18,36,-18,0.25,19,33,68,30,0.5,34,22,12,0.47368421052631576,0,0,0,0,0,0,0,0,0.4,0.4,-14,-22,-37,-0.15789473684210525,-0.22368421052631576,-30
1997-12-28,Wimbledon,West Ham,1,2,A,19,24,56,3,0.3947368421052632,20,22,-2,0.3157894736842105,20,28,42,-9,0.2631578947368421,26,31,-5,0.45,0,0,0,0,0,0,0,0,0.2,0.6,-4,14,12,0.13157894736842113,-0.1342105263157895,3
1997-12-29,Southampton,Chelsea,1,0,H,20,21,41,-6,0.2631578947368421,24,30,-6,0.3,20,39,59,3,0.42105263157894735,46,20,26,0.6,0,0,0,0,0,0,0,0,0.2,0.6,-18,-18,-9,-0.15789473684210525,-0.3,-32
1998-01-10,Arsenal,Leeds,2,1,H,20,34,68,30,0.5,35,23,12,0.45,21,35,46,-10,0.2894736842105263,30,23,7,0.47619047619047616,0,0,0,0,0,0,0,0,0.4,0.2,-1,22,40,0.21052631578947367,-0.026190476190476153,5
1998-01-10,Aston Villa,Leicester,1,1,D,21,26,61,13,0.4473684210526316,25,27,-2,0.3333333333333333,21,28,47,-8,0.3157894736842105,25,21,4,0.3333333333333333,0,0,0,0,0,0,0,0,0.4,0.0,-2,14,21,0.13157894736842107,0.0,-6
1998-01-10,Bolton,Southampton,0,0,D,21,21,-1,-1,0.0,19,33,-14,0.19047619047619047,21,24,41,-6,0.2631578947368421,25,30,-5,0.3333333333333333,0,0,0,0,0,0,0,0,0.0,0.4,-3,-42,5,-0.2631578947368421,-0.14285714285714285,-9
1998-01-10,Chelsea,Coventry,3,1,H,21,39,59,3,0.42105263157894735,46,21,25,0.5714285714285714,21,23,41,-16,0.2368421052631579,20,28,-8,0.23809523809523808,0,0,0,0,0,0,0,0,0.4,0.4,16,18,19,0.18421052631578944,0.3333333333333333,33
1998-01-10,Crystal Palace,Everton,1,3,A,21,23,-1,-1,0.0,20,28,-8,0.23809523809523808,21,20,42,-13,0.2631578947368421,20,31,-11,0.23809523809523808,0,0,0,0,0,0,0,0,0.0,0.4,3,-43,12,-0.2631578947368421,0.0,3
1998-01-10,Liverpool,Wimbledon,2,0,H,20,37,68,25,0.5,36,19,17,0.55,20,24,56,3,0.3947368421052632,21,24,-3,0.3,1,0,0,0,0,0,0,0,0.8,0.2,13,12,22,0.10526315789473678,0.25000000000000006,20
1998-01-10,Man United,Tottenham,2,0,H,21,46,75,32,0.5526315789473685,49,16,33,0.6666666666666666,21,20,46,-7,0.34210526315789475,19,37,-18,0.23809523809523808,0,0,0,0,0,0,0,0,0.8,0.2,26,29,39,0.21052631578947373,0.42857142857142855,51
1998-01-10,Sheffield Weds,Newcastle,2,1,H,21,23,57,-1,0.3684210526315789,32,44,-12,0.2857142857142857,20,26,68,33,0.5,21,25,-4,0.35,0,0,0,0,0,0,1,0,0.2,0.0,-3,-11,-34,-0.13157894736842107,-0.06428571428571428,-8
1998-01-10,West Ham,Barnsley,6,0,H,21,31,42,-9,0.2631578947368421,28,32,-4,0.47619047619047616,21,18,-1,-1,0.0,19,51,-32,0.23809523809523808,0,0,0,0,0,0,0,0,0.6,0.2,13,43,-8,0.2631578947368421,0.23809523809523808,28
1998-01-11,Derby,Blackburn,3,1,H,21,32,46,-13,0.2894736842105263,34,28,6,0.42857142857142855,21,41,42,-1,0.2368421052631579,38,21,17,0.5238095238095238,0,0,0,0,0,0,0,0,0.2,0.6,-9,4,-12,0.05263157894736842,-0.09523809523809529,-11
1998-01-17,Barnsley,Crystal Palace,1,0,H,22,18,-1,-1,0.0,19,57,-38,0.22727272727272727,22,23,-1,-1,0.0,21,31,-10,0.22727272727272727,0,0,0,0,0,0,0,0,0.2,0.0,-5,0,0,0.0,0.0,-28
1998-01-17,Blackburn,Aston Villa,5,0,H,22,41,42,-1,0.2368421052631579,39,24,15,0.5,22,27,61,13,0.4473684210526316,26,28,-2,0.3181818181818182,0,0,0,0,0,0,0,0,0.4,0.2,14,-19,-14,-0.21052631578947367,0.18181818181818182,17
1998-01-17,Coventry,Arsenal,2,2,D,22,23,41,-16,0.2368421052631579,21,31,-10,0.22727272727272727,21,37,68,30,0.5,37,24,13,0.47619047619047616,0,0,0,0,0,0,0,0,0.4,0.6,-14,-27,-46,-0.2631578947368421,-0.2489177489177489,-23
1998-01-17,Leeds,Sheffield Weds,1,2,A,22,35,46,-10,0.2894736842105263,31,25,6,0.45454545454545453,22,26,57,-1,0.3684210526315789,34,45,-11,0.3181818181818182,0,0,0,0,0,0,0,0,0.2,0.2,9,-11,-9,-0.0789473684210526,0.13636363636363635,17
1998-01-17,Leicester,Liverpool,0,0,D,22,29,47,-8,0.3157894736842105,26,22,4,0.3181818181818182,21,40,68,25,0.5,38,19,19,0.5714285714285714,0,0,0,0,1,1,0,0,0.0,1.0,-11,-21,-33,-0.1842105263157895,-0.2532467532467532,-15
1998-01-17,Newcastle,Bolton,2,1,H,21,26,68,33,0.5,22,27,-5,0.3333333333333333,22,22,-1,-1,0.0,19,33,-14,0.18181818181818182,0,0,1,0,0,0,0,0,0.0,0.0,4,69,34,0.5,0.1515151515151515,9
1998-01-17,Tottenham,West Ham,1,0,H,22,20,46,-7,0.34210526315789475,19,39,-20,0.22727272727272727,22,34,42,-9,0.2631578947368421,34,32,2,0.5,0,0,0,0,1,0,0,0,0.2,0.8,-14,4,2,0.07894736842105265,-0.2727272727272727,-22
1998-01-17,Wimbledon,Derby,0,0,D,21,24,56,3,0.3947368421052632,21,26,-5,0.2857142857142857,22,35,46,-13,0.2894736842105263,37,29,8,0.45454545454545453,0,0,0,0,0,0,0,0,0.2,0.4,-11,10,16,0.10526315789473689,-0.16883116883116883,-13
1998-01-18,Everton,Chelsea,3,1,H,22,23,42,-13,0.2631578947368421,23,32,-9,0.2727272727272727,22,42,59,3,0.42105263157894735,49,22,27,0.5909090909090909,0,0,0,0,0,0,0,0,0.6,0.4,-19,-17,-16,-0.15789473684210525,-0.31818181818181823,-36
1998-01-19,Southampton,Man United,1,0,H,22,25,41,-6,0.2631578947368421,25,30,-5,0.3181818181818182,22,49,75,32,0.5526315789473685,51,16,35,0.6818181818181818,0,0,0,0,0,0,0,0,0.4,0.8,-24,-34,-38,-0.2894736842105264,-0.3636363636363636,-40
1998-01-20,Liverpool,Newcastle,1,0,H,22,41,68,25,0.5,38,19,19,0.5454545454545454,22,29,68,33,0.5,24,28,-4,0.36363636363636365,0,0,0,0,0,0,0,0,0.8,0.2,12,0,-8,0.0,0.18181818181818177,23
1998-01-31,Arsenal,Southampton,3,0,H,22,38,68,30,0.5,39,26,13,0.45454545454545453,23,28,41,-6,0.2631578947368421,26,30,-4,0.34782608695652173,0,0,0,0,0,0,0,0,0.4,0.4,10,27,36,0.2368421052631579,0.1067193675889328,17
1998-01-31,Bolton,Coventry,1,5,A,23,22,-1,-1,0.0,20,35,-15,0.17391304347826086,23,24,41,-16,0.2368421052631579,23,33,-10,0.21739130434782608,0,0,0,0,0,0,0,0,0.0,0.2,-2,-42,15,-0.2368421052631579,-0.043478260869565216,-5
1998-01-31,Chelsea,Barnsley,2,0,H,23,42,59,3,0.42105263157894735,50,25,25,0.5652173913043478,23,21,-1,-1,0.0,20,57,-37,0.2608695652173913,0,0,0,0,0,0,0,0,0.4,0.4,21,60,4,0.42105263157894735,0.3043478260869565,62
1998-01-31,Crystal Palace,Leeds,0,2,A,23,23,-1,-1,0.0,21,32,-11,0.21739130434782608,23,35,46,-10,0.2894736842105263,32,27,5,0.43478260869565216,0,0,0,0,0,0,0,0,0.0,0.2,-12,-47,9,-0.2894736842105263,-0.21739130434782608,-16
1998-01-31,Derby,Tottenham,2,1,H,23,36,46,-13,0.2894736842105263,37,29,8,0.43478260869565216,23,23,46,-7,0.34210526315789475,20,39,-19,0.2608695652173913,0,0,0,0,0,0,0,0,0.4,0.4,13,0,-6,-0.05263157894736842,0.17391304347826086,27
1998-01-31,Liverpool,Blackburn,0,0,D,23,44,68,25,0.5,39,19,20,0.5652173913043478,23,44,42,-1,0.2368421052631579,44,24,20,0.5217391304347826,0,0,0,0,0,0,0,0,0.8,0.4,0,26,26,0.2631578947368421,0.04347826086956519,0
1998-01-31,Man United,Leicester,0,1,A,23,49,75,32,0.5526315789473685,51,17,34,0.6521739130434783,23,30,47,-8,0.3157894736842105,26,22,4,0.30434782608695654,0,0,0,0,0,0,0,0,0.6,0.0,19,28,40,0.23684210526315796,0.34782608695652173,30
1998-01-31,Sheffield Weds,Wimbledon,1,1,D,23,29,57,-1,0.3684210526315789,36,46,-10,0.34782608695652173,22,25,56,3,0.3947368421052632,21,26,-5,0.2727272727272727,0,0,0,0,0,0,0,0,0.4,0.0,4,1,-4,-0.026315789473684292,0.07509881422924902,-5
1998-01-31,West Ham,Everton,2,2,D,23,34,42,-9,0.2631578947368421,34,33,1,0.4782608695652174,23,26,42,-13,0.2631578947368421,26,33,-7,0.30434782608695654,0,0,0,0,1,0,0,0,0.6,0.8,8,0,4,0.0,0.17391304347826086,8
1998-02-01,Aston Villa,Newcastle,0,1,A,23,27,61,13,0.4473684210526316,26,33,-7,0.30434782608695654,23,29,68,33,0.5,24,29,-5,0.34782608695652173,0,0,0,0,0,0,0,0,0.2,0.2,-2,-7,-20,-0.05263157894736842,-0.04347826086956519,-2
1998-02-07,Barnsley,Everton,2,2,D,24,21,-1,-1,0.0,20,59,-39,0.25,24,27,42,-13,0.2631578947368421,28,35,-7,0.2916666666666667,0,0,0,0,0,0,0,0,0.4,0.6,-6,-43,12,-0.2631578947368421,-0.041666666666666685,-32
1998-02-07,Blackburn,Tottenham,0,3,A,24,45,42,-1,0.2368421052631579,44,24,20,0.5,24,23,46,-7,0.34210526315789475,21,41,-20,0.25,0,0,0,0,0,0,0,0,0.2,0.2,22,-4,6,-0.10526315789473684,0.25,40
1998-02-07,Coventry,Sheffield Weds,1,0,H,24,27,41,-16,0.2368421052631579,28,34,-6,0.25,24,30,57,-1,0.3684210526315789,37,47,-10,0.3333333333333333,0,0,0,0,0,0,0,0,0.4,0.4,-3,-16,-15,-0.13157894736842102,-0.08333333333333331,4
1998-02-07,Derby,Aston Villa,0,1,A,24,39,46,-13,0.2894736842105263,39,30,9,0.4583333333333333,24,27,61,13,0.4473684210526316,26,34,-8,0.2916666666666667,0,0,0,0,0,0,0,0,0.6,0.2,12,-15,-26,-0.15789473684210525,0.16666666666666663,17
1998-02-07,Leicester,Leeds,1,0,H,24,33,47,-8,0.3157894736842105,27,22,5,0.3333333333333333,24,38,46,-10,0.2894736842105263,34,27,7,0.4583333333333333,0,0,0,0,0,0,0,0,0.2,0.2,-5,1,2,0.02631578947368418,-0.125,-2
1998-02-07,Liverpool,Southampton,2,3,A,24,45,68,25,0.5,39,19,20,0.5416666666666666,24,28,41,-6,0.2631578947368421,26,33,-7,0.3333333333333333,0,0,0,0,0,0,0,0,0.6,0.4,17,27,31,0.2368421052631579,0.20833333333333331,27
1998-02-07,Man United,Bolton,1,1,D,24,49,75,32,0.5526315789473685,51,18,33,0.625,24,22,-1,-1,0.0,21,40,-19,0.16666666666666666,0,0,0,0,0,0,0,0,0.4,0.0,27,76,33,0.5526315789473685,0.45833333333333337,52
1998-02-07,Newcastle,West Ham,0,1,A,24,32,68,33,0.5,25,29,-4,0.375,24,35,42,-9,0.2631578947368421,36,35,1,0.4583333333333333,0,0,0,0,0,0,0,0,0.4,0.6,-3,26,42,0.2368421052631579,-0.08333333333333331,-5
1998-02-08,Arsenal,Chelsea,2,0,H,23,41,68,30,0.5,42,26,16,0.4782608695652174,24,45,59,3,0.42105263157894735,52,25,27,0.5833333333333334,0,0,0,0,0,0,0,0,0.6,0.4,-4,9,27,0.07894736842105265,-0.10507246376811596,-11
1998-02-09,Crystal Palace,Wimbledon,0,3,A,24,23,-1,-1,0.0,21,34,-13,0.20833333333333334,23,26,56,3,0.3947368421052632,22,27,-5,0.2608695652173913,0,0,1,0,0,0,0,0,0.0,0.0,-3,-57,-4,-0.3947368421052632,-0.052536231884057955,-8
1998-02-14,Everton,Derby,1,2,A,25,28,42,-13,0.2631578947368421,30,37,-7,0.28,25,39,46,-13,0.2894736842105263,39,31,8,0.44,0,0,0,0,0,0,0,0,0.6,0.4,-11,-4,0,-0.026315789473684237,-0.15999999999999998,-15
1998-02-14,Sheffield Weds,Liverpool,3,3,D,25,30,57,-1,0.3684210526315789,37,48,-11,0.32,25,45,68,25,0.5,41,22,19,0.52,0,0,0,0,0,0,0,0,0.4,0.4,-15,-11,-26,-0.13157894736842107,-0.2,-30
1998-02-14,Tottenham,Leicester,1,1,D,25,26,46,-7,0.34210526315789475,24,41,-17,0.28,25,36,47,-8,0.3157894736842105,28,22,6,0.36,0,0,0,0,0,0,0,0,0.4,0.4,-10,-1,1,0.026315789473684237,-0.07999999999999996,-23
1998-02-18,Aston Villa,Man United,0,2,A,25,30,61,13,0.4473684210526316,27,34,-7,0.32,25,50,75,32,0.5526315789473685,52,19,33,0.6,0,0,0,0,0,0,0,0,0.2,0.2,-20,-14,-19,-0.10526315789473689,-0.27999999999999997,-40
1998-02-18,Southampton,Coventry,1,2,A,25,31,41,-6,0.2631578947368421,29,35,-6,0.36,25,30,41,-16,0.2368421052631579,29,34,-5,0.28,0,0,0,0,0,0,0,0,0.6,0.6,1,0,10,0.02631578947368418,0.07999999999999996,-1
1998-02-21,Arsenal,Crystal Palace,1,0,H,24,44,68,30,0.5,44,26,18,0.5,25,23,-1,-1,0.0,21,37,-16,0.2,0,0,0,0,0,0,1,0,0.6,0.0,21,69,31,0.5,0.3,34
1998-02-21,Bolton,West Ham,1,1,D,25,23,-1,-1,0.0,22,41,-19,0.16,25,38,42,-9,0.2631578947368421,37,35,2,0.48,0,0,0,0,0,0,0,0,0.0,0.6,-15,-43,8,-0.2631578947368421,-0.31999999999999995,-21
1998-02-21,Coventry,Barnsley,1,0,H,26,33,41,-16,0.2368421052631579,31,35,-4,0.3076923076923077,25,22,-1,-1,0.0,22,61,-39,0.24,1,0,0,0,0,0,0,0,0.6,0.4,11,42,-15,0.2368421052631579,0.06769230769230772,35
1998-02-21,Leicester,Chelsea,2,0,H,26,37,47,-8,0.3157894736842105,29,23,6,0.34615384615384615,25,45,59,3,0.42105263157894735,52,27,25,0.56,0,0,0,0,0,0,0,0,0.4,0.4,-8,-12,-11,-0.10526315789473684,-0.2138461538461539,-19
1998-02-21,Man United,Derby,2,0,H,26,53,75,32,0.5526315789473685,54,19,35,0.6153846153846154,26,42,46,-13,0.2894736842105263,41,32,9,0.46153846153846156,0,0,0,0,0,0,0,0,0.4,0.6,11,29,45,0.26315789473684215,0.15384615384615385,26
1998-02-21,Sheffield Weds,Tottenham,1,0,H,26,31,57,-1,0.3684210526315789,40,51,-11,0.3076923076923077,26,27,46,-7,0.34210526315789475,25,42,-17,0.2692307692307692,0,0,0,0,0,0,0,0,0.4,0.4,4,11,6,0.02631578947368418,0.03846153846153849,6
1998-02-21,Southampton,Blackburn,3,0,H,26,31,41,-6,0.2631578947368421,30,37,-7,0.34615384615384615,25,45,42,-1,0.2368421052631579,44,27,17,0.48,0,0,0,0,0,0,0,0,0.4,0.2,-14,-1,-5,0.02631578947368418,-0.13384615384615384,-24
1998-02-21,Wimbledon,Aston Villa,2,1,H,24,29,56,3,0.3947368421052632,25,27,-2,0.2916666666666667,26,30,61,13,0.4473684210526316,27,36,-9,0.3076923076923077,0,0,0,0,0,0,0,0,0.2,0.2,-1,-5,-10,-0.05263157894736836,-0.016025641025641024,7
1998-02-22,Newcastle,Leeds,1,1,D,25,32,68,33,0.5,25,30,-5,0.36,25,38,46,-10,0.2894736842105263,34,28,6,0.44,0,0,0,0,0,0,0,0,0.4,0.2,-6,22,43,0.21052631578947367,-0.08000000000000002,-11
1998-02-23,Liverpool,Everton,1,1,D,26,46,68,25,0.5,44,25,19,0.5,26,28,42,-13,0.2631578947368421,31,39,-8,0.2692307692307692,0,0,0,0,0,0,0,0,0.2,0.4,18,26,38,0.2368421052631579,0.23076923076923078,27
1998-02-28,Aston Villa,Liverpool,2,1,H,27,30,61,13,0.4473684210526316,28,38,-10,0.2962962962962963,27,47,68,25,0.5,45,26,19,0.48148148148148145,0,0,0,0,0,0,0,0,0.2,0.2,-17,-7,-12,-0.05263157894736842,-0.18518518518518517,-29
1998-02-28,Barnsley,Wimbledon,2,1,H,26,22,-1,-1,0.0,22,62,-40,0.23076923076923078,25,32,56,3,0.3947368421052632,27,28,-1,0.32,0,0,0,0,0,0,0,0,0.2,0.4,-10,-57,-4,-0.3947368421052632,-0.08923076923076922,-39
1998-02-28,Blackburn,Leicester,5,3,H,26,45,42,-1,0.2368421052631579,44,30,14,0.46153846153846156,27,40,47,-8,0.3157894736842105,31,23,8,0.37037037037037035,0,0,0,0,0,0,0,0,0.2,0.6,5,-5,7,-0.0789473684210526,0.09116809116809121,6
1998-02-28,Chelsea,Man United,0,1,A,26,45,59,3,0.42105263157894735,52,29,23,0.5384615384615384,27,56,75,32,0.5526315789473685,56,19,37,0.6296296296296297,0,0,0,0,0,0,0,0,0.4,0.4,-11,-16,-29,-0.13157894736842113,-0.09116809116809121,-14
1998-02-28,Crystal Palace,Coventry,0,3,A,26,23,-1,-1,0.0,21,38,-17,0.19230769230769232,27,36,41,-16,0.2368421052631579,32,35,-3,0.3333333333333333,0,0,1,1,1,0,0,0,0.0,0.8,-13,-42,15,-0.2368421052631579,-0.141025641025641,-14
1998-02-28,Derby,Sheffield Weds,3,0,H,27,42,46,-13,0.2894736842105263,41,34,7,0.4444444444444444,27,34,57,-1,0.3684210526315789,41,51,-10,0.3333333333333333,0,0,0,0,0,0,0,0,0.4,0.4,8,-11,-12,-0.0789473684210526,0.1111111111111111,17
1998-02-28,Everton,Newcastle,0,0,D,27,29,42,-13,0.2631578947368421,32,40,-8,0.25925925925925924,26,33,68,33,0.5,26,31,-5,0.34615384615384615,0,0,0,0,0,0,0,0,0.2,0.4,-4,-26,-46,-0.2368421052631579,-0.0868945868945869,-3
1998-02-28,Leeds,Southampton,0,1,A,26,39,46,-10,0.2894736842105263,35,29,6,0.4230769230769231,27,34,41,-6,0.2631578947368421,33,37,-4,0.37037037037037035,0,0,0,0,0,0,0,0,0.2,0.6,5,5,-4,0.026315789473684237,0.05270655270655272,10
1998-03-01,Tottenham,Bolton,1,0,H,27,27,46,-7,0.34210526315789475,25,43,-18,0.25925925925925924,26,24,-1,-1,0.0,23,42,-19,0.15384615384615385,0,0,0,0,0,0,0,0,0.4,0.0,3,47,-6,0.34210526315789475,0.10541310541310539,1
1998-03-02,West Ham,Arsenal,0,0,D,26,39,42,-9,0.2631578947368421,38,36,2,0.46153846153846156,25,47,68,30,0.5,45,26,19,0.52,0,0,0,0,1,0,0,0,0.4,0.8,-8,-26,-39,-0.2368421052631579,-0.058461538461538454,-17
1998-03-04,Leeds,Tottenham,1,0,H,27,39,46,-10,0.2894736842105263,35,30,5,0.4074074074074074,28,30,46,-7,0.34210526315789475,26,43,-17,0.2857142857142857,0,0,0,0,0,0,0,0,0.2,0.4,9,0,-3,-0.05263157894736842,0.12169312169312169,22
1998-03-07,Liverpool,Bolton,2,1,H,28,47,68,25,0.5,46,28,18,0.4642857142857143,27,24,-1,-1,0.0,23,43,-20,0.14814814814814814,0,0,0,0,0,0,0,0,0.0,0.0,23,69,26,0.5,0.31613756613756616,38
1998-03-07,Sheffield Weds,Man United,2,0,H,28,34,57,-1,0.3684210526315789,41,54,-13,0.32142857142857145,28,59,75,32,0.5526315789473685,57,19,38,0.6428571428571429,0,0,0,0,1,0,0,0,0.2,0.6,-25,-18,-33,-0.18421052631578955,-0.32142857142857145,-51
1998-03-07,Southampton,Everton,2,1,H,28,37,41,-6,0.2631578947368421,34,37,-3,0.39285714285714285,28,30,42,-13,0.2631578947368421,32,40,-8,0.25,0,0,0,0,0,0,0,0,0.6,0.0,7,-1,7,0.0,0.14285714285714285,5
1998-03-08,Chelsea,Aston Villa,0,1,A,27,45,59,3,0.42105263157894735,52,30,22,0.5185185185185185,28,33,61,13,0.4473684210526316,30,39,-9,0.32142857142857145,0,0,1,0,0,0,0,0,0.2,0.4,12,-2,-10,-0.026315789473684237,0.19708994708994704,31
1998-03-11,Aston Villa,Barnsley,0,1,A,29,36,61,13,0.4473684210526316,31,39,-8,0.3448275862068966,27,25,-1,-1,0.0,24,63,-39,0.25925925925925924,0,0,0,0,0,0,0,0,0.6,0.4,11,62,14,0.4473684210526316,0.08556832694763733,31
1998-03-11,Chelsea,Crystal Palace,6,2,H,28,45,59,3,0.42105263157894735,52,31,21,0.5,27,23,-1,-1,0.0,21,41,-20,0.18518518518518517,0,0,1,0,0,0,1,1,0.2,0.0,22,60,4,0.42105263157894735,0.3148148148148148,41
1998-03-11,Leeds,Blackburn,4,0,H,28,42,46,-10,0.2894736842105263,36,30,6,0.42857142857142855,27,48,42,-1,0.2368421052631579,49,33,16,0.48148148148148145,0,0,0,0,0,0,0,0,0.4,0.4,-6,4,-9,0.05263157894736842,-0.05291005291005291,-10
1998-03-11,West Ham,Man United,1,1,D,27,40,42,-9,0.2631578947368421,38,36,2,0.4444444444444444,29,59,75,32,0.5526315789473685,57,21,36,0.6206896551724138,0,0,0,0,0,0,0,0,0.2,0.6,-19,-33,-41,-0.2894736842105264,-0.1762452107279694,-34
1998-03-11,Wimbledon,Arsenal,0,1,A,26,32,56,3,0.3947368421052632,28,30,-2,0.3076923076923077,26,48,68,30,0.5,45,26,19,0.5,0,0,0,0,0,0,0,0,0.4,0.6,-16,-12,-27,-0.10526315789473678,-0.1923076923076923,-21
1998-03-14,Aston Villa,Crystal Palace,3,1,H,30,36,61,13,0.4473684210526316,31,40,-9,0.3333333333333333,28,23,-1,-1,0.0,23,47,-24,0.17857142857142858,0,0,0,0,0,0,1,1,0.4,0.0,13,62,14,0.4473684210526316,0.15476190476190474,15
1998-03-14,Barnsley,Southampton,4,3,H,28,28,-1,-1,0.0,25,63,-38,0.2857142857142857,29,40,41,-6,0.2631578947368421,36,38,-2,0.41379310344827586,0,0,0,0,1,0,0,0,0.4,0.8,-12,-42,5,-0.2631578947368421,-0.12807881773399016,-36
1998-03-14,Bolton,Sheffield Weds,3,2,H,28,24,-1,-1,0.0,24,45,-21,0.14285714285714285,29,37,57,-1,0.3684210526315789,43,54,-11,0.3448275862068966,0,0,0,0,0,0,0,0,0.0,0.4,-13,-58,0,-0.3684210526315789,-0.20197044334975373,-10
1998-03-14,Everton,Blackburn,1,0,H,29,30,42,-13,0.2631578947368421,33,42,-9,0.2413793103448276,28,48,42,-1,0.2368421052631579,49,37,12,0.4642857142857143,0,0,0,0,0,0,0,0,0.0,0.2,-18,0,-12,0.02631578947368418,-0.2229064039408867,-21
1998-03-14,Man United,Arsenal,0,1,A,30,60,75,32,0.5526315789473685,58,22,36,0.6,27,51,68,30,0.5,46,26,20,0.5185185185185185,0,0,0,0,0,0,0,0,0.6,0.8,9,7,2,0.052631578947368474,0.08148148148148149,16
1998-03-14,Newcastle,Coventry,0,0,D,27,34,68,33,0.5,26,31,-5,0.3333333333333333,28,39,41,-16,0.2368421052631579,35,35,0,0.35714285714285715,0,0,0,0,1,1,0,0,0.2,1.0,-5,27,49,0.2631578947368421,-0.023809523809523836,-5
1998-03-14,Tottenham,Liverpool,3,3,D,29,30,46,-7,0.34210526315789475,26,44,-18,0.27586206896551724,29,50,68,25,0.5,48,29,19,0.4827586206896552,0,0,0,0,0,0,0,0,0.4,0.2,-20,-22,-32,-0.15789473684210525,-0.20689655172413796,-37
1998-03-14,West Ham,Chelsea,2,1,H,28,41,42,-9,0.2631578947368421,39,37,2,0.42857142857142855,29,48,59,3,0.42105263157894735,58,33,25,0.5172413793103449,0,0,0,0,0,0,0,0,0.2,0.2,-7,-17,-12,-0.15789473684210525,-0.08866995073891631,-23
1998-03-14,Wimbledon,Leicester,2,1,H,27,32,56,3,0.3947368421052632,28,31,-3,0.2962962962962963,28,40,47,-8,0.3157894736842105,34,28,6,0.35714285714285715,0,0,0,0,0,0,0,0,0.4,0.6,-8,9,11,0.07894736842105271,-0.06084656084656087,-9
1998-03-15,Derby,Leeds,0,5,A,28,45,46,-13,0.2894736842105263,44,34,10,0.4642857142857143,29,45,46,-10,0.2894736842105263,40,30,10,0.4482758620689655,0,0,0,0,0,0,0,0,0.6,0.4,0,0,-3,0.0,0.016009852216748777,0
1998-03-18,Newcastle,Crystal Palace,1,2,A,28,35,68,33,0.5,26,31,-5,0.32142857142857145,29,23,-1,-1,0.0,24,50,-26,0.1724137931034483,0,0,0,0,0,0,1,1,0.2,0.0,12,69,34,0.5,0.14901477832512317,21
1998-03-28,Arsenal,Sheffield Weds,1,0,H,28,54,68,30,0.5,47,26,21,0.5357142857142857,30,37,57,-1,0.3684210526315789,45,57,-12,0.3333333333333333,0,0,0,0,0,0,0,0,0.8,0.4,17,11,31,0.13157894736842107,0.20238095238095238,33
1998-03-28,Barnsley,Liverpool,2,3,A,29,31,-1,-1,0.0,29,66,-37,0.3103448275862069,30,51,68,25,0.5,51,32,19,0.4666666666666667,1,0,0,0,0,0,0,0,0.6,0.2,-20,-69,-26,-0.5,-0.15632183908045977,-56
1998-03-28,Bolton,Leicester,2,0,H,29,27,-1,-1,0.0,27,47,-20,0.1724137931034483,29,40,47,-8,0.3157894736842105,35,30,5,0.3448275862068966,0,0,0,0,0,0,0,0,0.2,0.4,-13,-48,7,-0.3157894736842105,-0.1724137931034483,-25
1998-03-28,Coventry,Derby,1,0,H,29,40,41,-16,0.2368421052631579,35,35,0,0.3448275862068966,29,45,46,-13,0.2894736842105263,44,39,5,0.4482758620689655,0,0,0,0,0,0,0,0,0.8,0.4,-5,-5,-3,-0.05263157894736842,-0.10344827586206895,-5
1998-03-28,Crystal Palace,Tottenham,1,3,A,30,26,-1,-1,0.0,26,51,-25,0.2,30,31,46,-7,0.34210526315789475,29,47,-18,0.26666666666666666,0,0,0,0,0,0,0,0,0.2,0.2,-5,-47,6,-0.34210526315789475,-0.06666666666666665,-7
1998-03-28,Everton,Aston Villa,1,4,A,30,33,42,-13,0.2631578947368421,34,42,-8,0.26666666666666666,31,39,61,13,0.4473684210526316,34,41,-7,0.3548387096774194,0,0,0,0,0,0,0,0,0.2,0.6,-6,-19,-26,-0.1842105263157895,-0.08817204301075271,-1
1998-03-28,Man United,Wimbledon,2,0,H,31,60,75,32,0.5526315789473685,58,23,35,0.5806451612903226,28,35,56,3,0.3947368421052632,30,32,-2,0.32142857142857145,0,0,0,0,0,0,0,0,0.4,0.6,25,19,29,0.15789473684210525,0.25921658986175117,37
1998-03-28,Southampton,Newcastle,2,1,H,30,40,41,-6,0.2631578947368421,39,42,-3,0.4,29,35,68,33,0.5,27,33,-6,0.3103448275862069,0,0,0,0,0,0,0,0,0.6,0.0,5,-27,-39,-0.2368421052631579,0.08965517241379312,3
1998-03-30,West Ham,Leeds,3,0,H,29,44,42,-9,0.2631578947368421,41,38,3,0.4482758620689655,30,48,46,-10,0.2894736842105263,45,30,15,0.4666666666666667,0,0,0,0,1,0,0,0,0.4,0.6,-4,-4,1,-0.026315789473684237,-0.01839080459770115,-12
1998-03-31,Blackburn,Barnsley,2,1,H,29,48,42,-1,0.2368421052631579,49,38,11,0.4482758620689655,30,31,-1,-1,0.0,31,69,-38,0.3,0,0,0,0,0,0,0,0,0.2,0.6,17,43,0,0.2368421052631579,0.14827586206896554,49
1998-03-31,Bolton,Arsenal,0,1,A,30,30,-1,-1,0.0,29,47,-18,0.2,29,57,68,30,0.5,48,26,22,0.5517241379310345,0,0,0,0,1,0,0,0,0.4,0.8,-27,-69,-31,-0.5,-0.35172413793103446,-40
1998-03-31,Wimbledon,Newcastle,0,0,D,29,35,56,3,0.3947368421052632,30,34,-4,0.3103448275862069,30,35,68,33,0.5,28,35,-7,0.3,0,0,0,0,0,0,0,0,0.4,0.0,0,-12,-30,-0.10526315789473678,0.010344827586206917,3
1998-04-04,Aston Villa,West Ham,2,0,H,32,42,61,13,0.4473684210526316,38,42,-4,0.375,30,47,42,-9,0.2631578947368421,44,38,6,0.4666666666666667,0,0,0,0,0,0,0,0,0.8,0.4,-5,19,22,0.1842105263157895,-0.09166666666666667,-10
1998-04-04,Leeds,Barnsley,2,1,H,31,48,46,-10,0.2894736842105263,45,33,12,0.45161290322580644,31,31,-1,-1,0.0,32,71,-39,0.2903225806451613,0,0,0,0,0,0,0,0,0.6,0.6,17,47,-9,0.2894736842105263,0.16129032258064513,51
1998-04-04,Leicester,Coventry,1,1,D,30,40,47,-8,0.3157894736842105,35,32,3,0.3333333333333333,30,43,41,-16,0.2368421052631579,36,35,1,0.36666666666666664,0,0,1,0,0,0,0,0,0.2,0.8,-3,6,8,0.0789473684210526,-0.033333333333333326,2
1998-04-04,Sheffield Weds,Southampton,1,0,H,31,37,57,-1,0.3684210526315789,45,58,-13,0.3225806451612903,31,43,41,-6,0.2631578947368421,41,43,-2,0.41935483870967744,0,0,0,0,0,0,0,0,0.4,0.8,-6,16,5,0.10526315789473684,-0.09677419354838712,-11
1998-04-04,Tottenham,Everton,1,1,D,31,34,46,-7,0.34210526315789475,32,48,-16,0.2903225806451613,31,33,42,-13,0.2631578947368421,35,46,-11,0.25806451612903225,0,0,0,0,0,0,0,0,0.4,0.2,1,4,6,0.07894736842105265,0.03225806451612906,-5
1998-04-04,Wimbledon,Bolton,0,0,D,30,36,56,3,0.3947368421052632,30,34,-4,0.3,31,30,-1,-1,0.0,29,48,-19,0.1935483870967742,0,0,0,0,0,0,0,0,0.2,0.4,6,57,4,0.3947368421052632,0.1064516129032258,15
1998-04-05,Derby,Chelsea,0,1,A,30,45,46,-13,0.2894736842105263,44,40,4,0.43333333333333335,30,48,59,3,0.42105263157894735,59,35,24,0.5,0,0,0,0,0,0,0,0,0.4,0.2,-3,-13,-16,-0.13157894736842102,-0.06666666666666665,-20
1998-04-06,Blackburn,Man United,1,3,A,30,51,42,-1,0.2368421052631579,51,39,12,0.4666666666666667,32,63,75,32,0.5526315789473685,60,23,37,0.59375,0,0,0,0,0,0,0,0,0.4,0.4,-12,-33,-33,-0.31578947368421056,-0.12708333333333333,-25
1998-04-08,Leeds,Chelsea,3,1,H,32,51,46,-10,0.2894736842105263,47,34,13,0.46875,31,51,59,3,0.42105263157894735,60,35,25,0.5161290322580645,0,0,0,0,0,0,0,0,0.8,0.4,0,-13,-13,-0.13157894736842102,-0.0473790322580645,-12
1998-04-10,Man United,Liverpool,1,1,D,33,66,75,32,0.5526315789473685,63,24,39,0.6060606060606061,31,54,68,25,0.5,54,34,20,0.4838709677419355,0,0,0,0,0,0,0,0,0.4,0.4,12,7,7,0.052631578947368474,0.12218963831867058,19
1998-04-11,Arsenal,Newcastle,3,1,H,30,60,68,30,0.5,49,26,23,0.5666666666666667,31,36,68,33,0.5,28,35,-7,0.2903225806451613,1,0,0,0,0,0,0,0,0.8,0.0,24,0,-3,0.0,0.27634408602150534,30
1998-04-11,Barnsley,Sheffield Weds,2,1,H,32,31,-1,-1,0.0,33,73,-40,0.28125,32,40,57,-1,0.3684210526315789,46,58,-12,0.34375,0,0,1,0,0,0,0,0,0.4,0.4,-9,-58,0,-0.3684210526315789,-0.0625,-28
1998-04-11,Bolton,Blackburn,2,1,H,32,31,-1,-1,0.0,29,48,-19,0.1875,31,51,42,-1,0.2368421052631579,52,42,10,0.45161290322580644,0,0,0,0,0,0,0,0,0.4,0.4,-20,-43,0,-0.2368421052631579,-0.26411290322580644,-29
1998-04-11,Chelsea,Tottenham,2,0,H,32,51,59,3,0.42105263157894735,61,38,23,0.5,32,35,46,-7,0.34210526315789475,33,49,-16,0.28125,0,0,0,0,0,0,0,0,0.4,0.4,16,13,10,0.0789473684210526,0.21875,39
1998-04-11,Coventry,Aston Villa,1,2,A,31,44,41,-16,0.2368421052631579,37,36,1,0.3548387096774194,33,45,61,13,0.4473684210526316,40,42,-2,0.3939393939393939,0,0,0,0,1,0,0,0,0.6,0.8,-1,-20,-29,-0.21052631578947367,-0.03910068426197455,3
1998-04-11,Crystal Palace,Leicester,0,3,A,31,26,-1,-1,0.0,27,54,-27,0.1935483870967742,31,41,47,-8,0.3157894736842105,36,33,3,0.3225806451612903,0,0,0,0,0,0,0,0,0.2,0.2,-15,-48,7,-0.3157894736842105,-0.12903225806451613,-30
1998-04-11,Everton,Leeds,2,0,H,32,34,42,-13,0.2631578947368421,36,47,-11,0.25,33,54,46,-10,0.2894736842105263,50,35,15,0.48484848484848486,0,0,0,0,0,0,0,0,0.2,0.8,-20,-4,-3,-0.026315789473684237,-0.23484848484848486,-26
1998-04-11,Southampton,Wimbledon,0,1,A,32,43,41,-6,0.2631578947368421,41,44,-3,0.40625,31,37,56,3,0.3947368421052632,30,34,-4,0.2903225806451613,0,0,0,0,0,0,0,0,0.6,0.2,6,-15,-9,-0.13157894736842113,0.11592741935483869,1
1998-04-11,West Ham,Derby,0,0,D,31,47,42,-9,0.2631578947368421,44,40,4,0.45161290322580644,31,45,46,-13,0.2894736842105263,44,41,3,0.41935483870967744,0,0,0,0,0,0,1,0,0.4,0.2,2,-4,4,-0.026315789473684237,0.032258064516129004,1
1998-04-13,Blackburn,Arsenal,1,4,A,32,51,42,-1,0.2368421052631579,53,44,9,0.4375,31,63,68,30,0.5,52,27,25,0.5806451612903226,0,0,0,0,1,1,0,0,0.2,1.0,-12,-26,-31,-0.2631578947368421,-0.14314516129032262,-16
1998-04-13,Derby,Bolton,4,0,H,32,46,46,-13,0.2894736842105263,44,41,3,0.40625,33,34,-1,-1,0.0,31,49,-18,0.21212121212121213,0,0,0,0,0,0,0,0,0.2,0.6,12,47,-12,0.2894736842105263,0.19412878787878787,21
1998-04-13,Liverpool,Crystal Palace,2,1,H,32,55,68,25,0.5,55,35,20,0.46875,32,26,-1,-1,0.0,27,57,-30,0.1875,0,0,0,0,0,0,0,0,0.4,0.2,29,69,26,0.5,0.28125,50
1998-04-13,Newcastle,Barnsley,2,1,H,32,36,68,33,0.5,29,38,-9,0.28125,33,34,-1,-1,0.0,35,74,-39,0.30303030303030304,0,0,0,0,0,0,0,0,0.0,0.4,2,69,34,0.5,-0.02178030303030304,30
1998-04-13,Sheffield Weds,West Ham,1,1,D,33,40,57,-1,0.3684210526315789,47,60,-13,0.3333333333333333,32,48,42,-9,0.2631578947368421,44,40,4,0.4375,0,0,0,0,0,0,0,0,0.4,0.4,-8,15,8,0.10526315789473684,-0.10416666666666669,-17
1998-04-13,Tottenham,Coventry,1,1,D,33,35,46,-7,0.34210526315789475,33,51,-18,0.2727272727272727,32,44,41,-16,0.2368421052631579,38,38,0,0.34375,0,0,0,0,0,0,0,0,0.2,0.4,-9,5,9,0.10526315789473684,-0.07102272727272729,-18
1998-04-13,Wimbledon,Everton,0,0,D,32,40,56,3,0.3947368421052632,31,34,-3,0.3125,33,37,42,-13,0.2631578947368421,38,47,-9,0.2727272727272727,0,0,0,0,0,0,0,0,0.4,0.4,3,14,16,0.13157894736842113,0.03977272727272729,6
1998-04-14,Leicester,Southampton,3,3,D,32,44,47,-8,0.3157894736842105,39,33,6,0.34375,33,43,41,-6,0.2631578947368421,41,45,-4,0.3939393939393939,0,0,0,0,0,0,0,0,0.2,0.4,1,6,-2,0.05263157894736842,-0.05018939393939392,10
1998-04-18,Arsenal,Wimbledon,5,0,H,32,66,68,30,0.5,56,28,28,0.59375,33,41,56,3,0.3947368421052632,31,34,-3,0.30303030303030304,1,1,0,0,0,0,0,0,1.0,0.2,25,12,27,0.10526315789473678,0.29071969696969696,31
1998-04-18,Barnsley,Tottenham,1,1,D,34,34,-1,-1,0.0,36,76,-40,0.29411764705882354,34,36,46,-7,0.34210526315789475,34,52,-18,0.2647058823529412,0,0,0,0,0,0,0,0,0.2,0.2,-2,-47,6,-0.34210526315789475,0.02941176470588236,-22
1998-04-18,Bolton,Leeds,2,3,A,34,34,-1,-1,0.0,31,53,-22,0.20588235294117646,34,54,46,-10,0.2894736842105263,50,37,13,0.47058823529411764,0,0,0,0,0,0,0,0,0.4,0.6,-20,-47,9,-0.2894736842105263,-0.2647058823529412,-35
1998-04-18,Crystal Palace,Derby,3,1,H,33,26,-1,-1,0.0,28,59,-31,0.18181818181818182,33,49,46,-13,0.2894736842105263,48,41,7,0.42424242424242425,0,0,1,0,0,0,0,0,0.2,0.2,-23,-47,12,-0.2894736842105263,-0.24242424242424243,-38
1998-04-18,Everton,Leicester,1,1,D,34,38,42,-13,0.2631578947368421,38,47,-9,0.2647058823529412,33,45,47,-8,0.3157894736842105,42,36,6,0.3333333333333333,0,0,0,0,0,0,0,0,0.4,0.2,-7,-5,-5,-0.05263157894736842,-0.06862745098039214,-15
1998-04-18,Man United,Newcastle,1,1,D,34,67,75,32,0.5526315789473685,64,25,39,0.5882352941176471,33,39,68,33,0.5,31,39,-8,0.30303030303030304,0,0,0,0,0,0,0,0,0.4,0.2,28,7,-1,0.052631578947368474,0.28520499108734404,47
1998-04-18,Southampton,Aston Villa,1,2,A,34,44,41,-6,0.2631578947368421,44,48,-4,0.38235294117647056,34,48,61,13,0.4473684210526316,42,43,-1,0.4117647058823529,0,0,0,0,1,0,0,0,0.2,0.8,-4,-20,-19,-0.1842105263157895,-0.02941176470588236,-3
1998-04-18,West Ham,Blackburn,2,1,H,33,49,42,-9,0.2631578947368421,45,41,4,0.42424242424242425,33,51,42,-1,0.2368421052631579,54,48,6,0.42424242424242425,0,0,0,0,0,0,1,0,0.4,0.2,-2,0,-8,0.02631578947368418,0.0,-2
1998-04-19,Chelsea,Sheffield Weds,1,0,H,33,54,59,3,0.42105263157894735,63,38,25,0.5151515151515151,34,41,57,-1,0.3684210526315789,48,61,-13,0.3235294117647059,0,0,0,0,0,0,0,0,0.6,0.2,13,2,4,0.05263157894736842,0.19162210338680924,38
1998-04-19,Coventry,Liverpool,1,1,D,33,45,41,-16,0.2368421052631579,39,39,0,0.3333333333333333,33,58,68,25,0.5,57,36,21,0.48484848484848486,0,0,0,0,0,0,0,0,0.2,0.6,-13,-27,-41,-0.2631578947368421,-0.15151515151515155,-21
1998-04-25,Aston Villa,Bolton,1,3,A,35,51,61,13,0.4473684210526316,44,44,0,0.42857142857142855,35,34,-1,-1,0.0,33,56,-23,0.2,1,1,0,0,0,0,0,0,1.0,0.2,17,62,14,0.4473684210526316,0.22857142857142854,23
1998-04-25,Barnsley,Arsenal,0,2,A,35,35,-1,-1,0.0,37,77,-40,0.2857142857142857,33,69,68,30,0.5,61,28,33,0.6060606060606061,0,0,0,0,1,1,0,0,0.2,1.0,-34,-69,-31,-0.5,-0.3203463203463204,-73
1998-04-25,Blackburn,Wimbledon,0,0,D,34,51,42,-1,0.2368421052631579,55,50,5,0.4117647058823529,34,41,56,3,0.3947368421052632,31,39,-8,0.29411764705882354,0,0,1,0,0,0,0,0,0.2,0.2,10,-14,-4,-0.1578947368421053,0.11764705882352938,13
1998-04-25,Chelsea,Liverpool,4,1,H,34,57,59,3,0.42105263157894735,64,38,26,0.5294117647058824,34,59,68,25,0.5,58,37,21,0.47058823529411764,0,0,0,0,0,0,0,0,0.6,0.4,-2,-9,-22,-0.07894736842105265,0.05882352941176472,5
1998-04-25,Everton,Sheffield Weds,1,3,A,35,39,42,-13,0.2631578947368421,39,48,-9,0.2571428571428571,35,41,57,-1,0.3684210526315789,48,62,-14,0.3142857142857143,0,0,0,0,0,0,0,0,0.2,0.2,-2,-15,-12,-0.10526315789473684,-0.05714285714285716,5
1998-04-25,Leeds,Coventry,3,3,D,35,57,46,-10,0.2894736842105263,53,39,14,0.4857142857142857,34,46,41,-16,0.2368421052631579,40,40,0,0.3235294117647059,0,0,0,0,0,0,0,0,0.6,0.2,11,5,6,0.05263157894736842,0.1621848739495798,14
1998-04-25,Tottenham,Newcastle,2,0,H,35,37,46,-7,0.34210526315789475,35,53,-18,0.2571428571428571,34,40,68,33,0.5,32,40,-8,0.29411764705882354,0,0,0,0,0,0,0,0,0.2,0.2,-3,-22,-40,-0.15789473684210525,-0.03697478991596642,-10
1998-04-25,West Ham,Southampton,2,4,A,34,52,42,-9,0.2631578947368421,47,42,5,0.4411764705882353,35,44,41,-6,0.2631578947368421,45,50,-5,0.37142857142857144,0,0,0,0,0,0,0,0,0.4,0.2,8,1,-3,0.0,0.06974789915966384,10
1998-04-26,Derby,Leicester,0,4,A,34,49,46,-13,0.2894736842105263,49,44,5,0.4117647058823529,34,46,47,-8,0.3157894736842105,43,37,6,0.3235294117647059,0,0,0,0,0,0,0,0,0.2,0.2,3,-1,-5,-0.02631578947368418,0.08823529411764702,-1
1998-04-27,Crystal Palace,Man United,0,3,A,34,29,-1,-1,0.0,31,60,-29,0.20588235294117646,35,68,75,32,0.5526315789473685,65,26,39,0.5714285714285714,0,0,0,0,0,0,0,0,0.4,0.4,-39,-76,-33,-0.5526315789473685,-0.36554621848739494,-68
1998-04-29,Arsenal,Derby,1,0,H,34,72,68,30,0.5,63,28,35,0.6176470588235294,35,49,46,-13,0.2894736842105263,49,48,1,0.4,1,1,0,0,0,0,0,0,1.0,0.2,23,22,43,0.21052631578947367,0.21764705882352942,34
1998-04-29,Chelsea,Blackburn,0,1,A,35,60,59,3,0.42105263157894735,68,39,29,0.5428571428571428,35,52,42,-1,0.2368421052631579,55,50,5,0.4,1,0,0,0,0,0,0,0,0.8,0.0,8,17,4,0.18421052631578944,0.1428571428571428,24
1998-04-29,Coventry,Wimbledon,0,0,D,35,47,41,-16,0.2368421052631579,43,43,0,0.3142857142857143,35,42,56,3,0.3947368421052632,31,39,-8,0.2857142857142857,0,0,0,0,0,0,0,0,0.0,0.2,5,-15,-19,-0.1578947368421053,0.02857142857142858,8
1998-04-29,Leicester,Newcastle,0,0,D,35,49,47,-8,0.3157894736842105,47,37,10,0.34285714285714286,35,40,68,33,0.5,32,42,-10,0.2857142857142857,0,0,0,0,0,0,0,0,0.4,0.2,9,-21,-41,-0.1842105263157895,0.05714285714285716,20
1998-05-02,Bolton,Crystal Palace,5,2,H,36,37,-1,-1,0.0,36,57,-21,0.2222222222222222,35,29,-1,-1,0.0,31,63,-32,0.2,0,0,0,0,0,0,0,0,0.4,0.2,8,0,0,0.0,0.0222222222222222,11
1998-05-02,Coventry,Blackburn,2,0,H,36,48,41,-16,0.2368421052631579,43,43,0,0.3055555555555556,36,55,42,-1,0.2368421052631579,56,50,6,0.4166666666666667,0,0,0,0,0,0,0,0,0.0,0.2,-7,-1,-15,0.0,-0.1111111111111111,-6
1998-05-02,Leicester,Barnsley,1,0,H,36,50,47,-8,0.3157894736842105,47,37,10,0.3333333333333333,36,35,-1,-1,0.0,37,79,-42,0.2777777777777778,0,0,0,0,0,0,0,0,0.4,0.2,15,48,-7,0.3157894736842105,0.055555555555555525,52
1998-05-02,Liverpool,West Ham,5,0,H,35,59,68,25,0.5,59,41,18,0.45714285714285713,35,52,42,-9,0.2631578947368421,49,46,3,0.42857142857142855,0,0,0,0,0,0,0,0,0.4,0.2,7,26,34,0.2368421052631579,0.02857142857142858,15
1998-05-02,Newcastle,Chelsea,3,1,H,36,41,68,33,0.5,32,42,-10,0.2777777777777778,36,60,59,3,0.42105263157894735,68,40,28,0.5277777777777778,0,0,0,0,0,0,0,0,0.2,0.6,-19,9,30,0.07894736842105265,-0.25,-38
1998-05-02,Sheffield Weds,Aston Villa,1,3,A,36,44,57,-1,0.3684210526315789,51,63,-12,0.3333333333333333,36,51,61,13,0.4473684210526316,45,47,-2,0.4166666666666667,0,0,0,0,0,0,0,0,0.4,0.8,-7,-4,-14,-0.07894736842105265,-0.08333333333333337,-10
1998-05-02,Southampton,Derby,0,2,A,36,47,41,-6,0.2631578947368421,49,52,-3,0.3888888888888889,36,49,46,-13,0.2894736842105263,49,49,0,0.3888888888888889,0,0,0,0,0,0,1,0,0.2,0.2,-2,-5,7,-0.026315789473684237,0.0,-3
1998-05-02,Wimbledon,Tottenham,2,6,A,36,43,56,3,0.3947368421052632,31,39,-8,0.2777777777777778,36,40,46,-7,0.34210526315789475,37,53,-16,0.2777777777777778,0,0,0,0,0,0,0,0,0.2,0.2,3,10,10,0.052631578947368474,0.0,8
1998-05-03,Arsenal,Everton,4,0,H,35,75,68,30,0.5,64,28,36,0.6285714285714286,36,39,42,-13,0.2631578947368421,40,51,-11,0.25,1,1,0,0,0,0,0,0,1.0,0.2,36,26,43,0.2368421052631579,0.37857142857142856,47
1998-05-04,Man United,Leeds,3,0,H,36,71,75,32,0.5526315789473685,68,26,42,0.5833333333333334,36,58,46,-10,0.2894736842105263,56,42,14,0.4722222222222222,0,0,0,0,0,0,0,0,0.6,0.6,13,29,42,0.26315789473684215,0.11111111111111116,28
1998-05-05,Crystal Palace,West Ham,3,3,D,36,29,-1,-1,0.0,33,68,-35,0.19444444444444445,36,52,42,-9,0.2631578947368421,49,51,-2,0.4166666666666667,0,0,0,0,0,0,0,0,0.2,0.2,-23,-43,8,-0.2631578947368421,-0.22222222222222224,-33
1998-05-06,Liverpool,Arsenal,4,0,H,36,62,68,25,0.5,64,41,23,0.4722222222222222,36,78,68,30,0.5,68,28,40,0.6388888888888888,0,0,0,0,1,1,0,0,0.4,1.0,-16,0,-5,0.0,-0.16666666666666663,-17
1998-05-10,Aston Villa,Arsenal,1,0,H,37,54,61,13,0.4473684210526316,48,48,0,0.43243243243243246,37,78,68,30,0.5,68,32,36,0.6216216216216216,0,0,0,0,0,0,0,0,0.8,0.8,-24,-7,-17,-0.05263157894736842,-0.18918918918918914,-36
1998-05-10,Barnsley,Man United,0,2,A,37,35,-1,-1,0.0,37,80,-43,0.2702702702702703,37,74,75,32,0.5526315789473685,71,26,45,0.5945945945945946,0,0,0,0,0,0,0,0,0.2,0.6,-39,-76,-33,-0.5526315789473685,-0.32432432432432434,-88
1998-05-10,Blackburn,Newcastle,1,0,H,37,55,42,-1,0.2368421052631579,56,52,4,0.40540540540540543,37,44,68,33,0.5,35,43,-8,0.2972972972972973,0,0,0,0,0,0,0,0,0.2,0.4,11,-26,-34,-0.2631578947368421,0.10810810810810811,12
1998-05-10,Chelsea,Bolton,2,0,H,37,60,59,3,0.42105263157894735,69,43,26,0.5135135135135135,37,40,-1,-1,0.0,41,59,-18,0.24324324324324326,0,0,0,0,0,0,0,0,0.6,0.6,20,60,4,0.42105263157894735,0.27027027027027023,44
1998-05-10,Crystal Palace,Sheffield Weds,1,0,H,37,30,-1,-1,0.0,36,71,-35,0.1891891891891892,37,44,57,-1,0.3684210526315789,52,66,-14,0.32432432432432434,0,0,0,0,0,0,0,0,0.2,0.2,-14,-58,0,-0.3684210526315789,-0.13513513513513514,-21
1998-05-10,Derby,Liverpool,1,0,H,37,52,46,-13,0.2894736842105263,51,49,2,0.40540540540540543,37,65,68,25,0.5,68,41,27,0.4864864864864865,0,0,0,0,0,0,0,0,0.4,0.6,-13,-22,-38,-0.21052631578947367,-0.08108108108108109,-25
1998-05-10,Everton,Coventry,1,1,D,37,39,42,-13,0.2631578947368421,40,55,-15,0.24324324324324326,37,51,41,-16,0.2368421052631579,45,43,2,0.32432432432432434,0,0,0,0,0,0,0,0,0.2,0.2,-12,1,3,0.02631578947368418,-0.08108108108108109,-17
1998-05-10,Leeds,Wimbledon,1,1,D,37,58,46,-10,0.2894736842105263,56,45,11,0.4594594594594595,37,43,56,3,0.3947368421052632,33,45,-12,0.2702702702702703,0,0,0,0,0,0,0,0,0.4,0.0,15,-10,-13,-0.10526315789473689,0.1891891891891892,23
1998-05-10,Tottenham,Southampton,1,1,D,37,43,46,-7,0.34210526315789475,43,55,-12,0.2972972972972973,37,47,41,-6,0.2631578947368421,49,54,-5,0.3783783783783784,0,0,0,0,0,0,0,0,0.4,0.2,-4,5,-1,0.07894736842105265,-0.08108108108108109,-7
1998-05-10,West Ham,Leicester,4,3,H,37,53,42,-9,0.2631578947368421,52,54,-2,0.40540540540540543,37,53,47,-8,0.3157894736842105,48,37,11,0.35135135135135137,0,0,0,0,0,0,0,0,0.2,0.4,0,-5,-1,-0.05263157894736842,0.05405405405405406,-13
