Date,HomeTeam,AwayTeam,FTHG,FTAG,FTR,HT_match_played,HT_current_standing,HT_past_standing,HT_past_goal_diff,HT_past_win_rate,HT_goal_for,HT_goal_against,HT_goal_diff,HT_win_rate_season,AT_match_played,AT_current_standing,AT_past_standing,AT_past_goal_diff,AT_past_win_rate,AT_goal_for,AT_goal_against,AT_goal_diff,AT_win_rate_season,HT_3_win_streak,HT_5_win_streak,HT_3_lose_Streak,HT_5_lose_Streak,AT_3_win_streak,AT_5_win_streak,AT_3_lose_Streak,AT_5_lose_Streak,HT_5_win_rate,AT_5_win_rate,current_standing_diff,past_standing_diff,past_goal_diff_diff,past_win_rate_diff,win_rate_season_diff,goal_diff_diff
1999-08-07,Arsenal,Leicester,2,1,H,0,0,78,42,0.5789473684210527,0,0,0,,0,0,49,-6,0.3157894736842105,0,0,0,,0,0,0,0,0,0,0,0,,,0,29,48,0.26315789473684215,,0
1999-08-07,Chelsea,Sunderland,4,0,H,0,0,75,27,0.5263157894736842,0,0,0,,0,0,-1,-1,0.0,0,0,0,,0,0,0,0,0,0,0,0,,,0,76,28,0.5263157894736842,,0
1999-08-07,Coventry,Southampton,0,1,A,0,0,42,-12,0.2894736842105263,0,0,0,,0,0,41,-27,0.2894736842105263,0,0,0,,0,0,0,0,0,0,0,0,,,0,1,15,0.0,,0
1999-08-07,Leeds,Derby,0,0,D,0,0,67,28,0.4736842105263158,0,0,0,,0,0,52,-5,0.34210526315789475,0,0,0,,0,0,0,0,0,0,0,0,,,0,15,33,0.13157894736842107,,0
1999-08-07,Middlesbrough,Bradford,0,1,A,0,0,51,-6,0.3157894736842105,0,0,0,,0,0,-1,-1,0.0,0,0,0,,0,0,0,0,0,0,0,0,,,0,52,-5,0.3157894736842105,,0
1999-08-07,Newcastle,Aston Villa,0,1,A,0,0,46,-6,0.2894736842105263,0,0,0,,0,0,55,5,0.3947368421052632,0,0,0,,0,0,0,0,0,0,0,0,,,0,-9,-11,-0.10526315789473689,,0
1999-08-07,Sheffield Weds,Liverpool,1,2,A,0,0,46,-1,0.34210526315789475,0,0,0,,0,0,54,19,0.3947368421052632,0,0,0,,0,0,0,0,0,0,0,0,,,0,-8,-20,-0.052631578947368474,,0
1999-08-07,Watford,Wimbledon,2,3,A,0,0,-1,-1,0.0,0,0,0,,0,0,42,-23,0.2631578947368421,0,0,0,,0,0,0,0,0,0,0,0,,,0,-43,22,-0.2631578947368421,,0
1999-08-07,West Ham,Tottenham,1,0,H,0,0,57,-7,0.42105263157894735,0,0,0,,0,0,47,-3,0.2894736842105263,0,0,0,,0,0,0,0,0,0,0,0,,,0,10,-4,0.13157894736842102,,0
1999-08-08,Everton,Man United,1,1,D,0,0,43,-5,0.2894736842105263,0,0,0,,0,0,79,43,0.5789473684210527,0,0,0,,0,0,0,0,0,0,0,0,,,0,-36,-48,-0.2894736842105263,,0
1999-08-09,Tottenham,Newcastle,3,1,H,1,0,47,-3,0.2894736842105263,0,1,-1,0.0,1,0,46,-6,0.2894736842105263,0,1,-1,0.0,0,0,0,0,0,0,0,0,,,0,1,3,0.0,0.0,0
1999-08-10,Derby,Arsenal,1,2,A,1,1,52,-5,0.34210526315789475,0,0,0,0.0,1,3,78,42,0.5789473684210527,2,1,1,1.0,0,0,0,0,0,0,0,0,,,-2,-26,-47,-0.2368421052631579,-1.0,-1
1999-08-10,Sunderland,Watford,2,0,H,1,0,-1,-1,0.0,0,4,-4,0.0,1,0,-1,-1,0.0,2,3,-1,0.0,0,0,0,0,0,0,0,0,,,0,0,0,0.0,0.0,-3
1999-08-10,Wimbledon,Middlesbrough,2,3,A,1,3,42,-23,0.2631578947368421,3,2,1,1.0,1,0,51,-6,0.3157894736842105,0,1,-1,0.0,0,0,0,0,0,0,0,0,,,3,-9,-17,-0.05263157894736842,1.0,2
1999-08-11,Aston Villa,Everton,3,0,H,1,3,55,5,0.3947368421052632,1,0,1,1.0,1,1,43,-5,0.2894736842105263,1,1,0,0.0,0,0,0,0,0,0,0,0,,,2,12,10,0.10526315789473689,1.0,1
1999-08-11,Leicester,Coventry,1,0,H,1,0,49,-6,0.3157894736842105,1,2,-1,0.0,1,0,42,-12,0.2894736842105263,0,1,-1,0.0,0,0,0,0,0,0,0,0,,,0,7,6,0.02631578947368418,0.0,0
1999-08-11,Man United,Sheffield Weds,4,0,H,1,1,79,43,0.5789473684210527,1,1,0,0.0,1,0,46,-1,0.34210526315789475,1,2,-1,0.0,0,0,0,0,0,0,0,0,,,1,33,44,0.2368421052631579,0.0,1
1999-08-11,Southampton,Leeds,0,3,A,1,3,41,-27,0.2894736842105263,1,0,1,1.0,1,1,67,28,0.4736842105263158,0,0,0,0.0,0,0,0,0,0,0,0,0,,,2,-26,-55,-0.1842105263157895,1.0,1
1999-08-14,Bradford,Sheffield Weds,1,1,D,1,3,-1,-1,0.0,1,0,1,1.0,2,0,46,-1,0.34210526315789475,1,6,-5,0.0,0,0,0,0,0,0,0,0,,,3,-47,0,-0.34210526315789475,1.0,6
1999-08-14,Derby,Middlesbrough,1,3,A,2,1,52,-5,0.34210526315789475,1,2,-1,0.0,2,3,51,-6,0.3157894736842105,3,3,0,0.5,0,0,0,0,0,0,0,0,,,-2,1,1,0.026315789473684237,-0.5,-1
1999-08-14,Leicester,Chelsea,2,2,D,2,3,49,-6,0.3157894736842105,2,2,0,0.5,1,3,75,27,0.5263157894736842,4,0,4,1.0,0,0,0,0,0,0,0,0,,,0,-26,-33,-0.21052631578947367,-0.5,-4
1999-08-14,Liverpool,Watford,0,1,A,1,3,54,19,0.3947368421052632,2,1,1,1.0,2,0,-1,-1,0.0,2,5,-3,0.0,0,0,0,0,0,0,0,0,,,3,55,20,0.3947368421052632,1.0,4
1999-08-14,Man United,Leeds,2,0,H,2,4,79,43,0.5789473684210527,5,1,4,0.5,2,4,67,28,0.4736842105263158,3,0,3,0.5,0,0,0,0,0,0,0,0,,,0,12,15,0.10526315789473684,0.0,1
1999-08-14,Sunderland,Arsenal,0,0,D,2,3,-1,-1,0.0,2,4,-2,0.5,2,6,78,42,0.5789473684210527,4,2,2,1.0,0,0,0,0,0,0,0,0,,,-3,-79,-43,-0.5789473684210527,-0.5,-4
1999-08-14,Tottenham,Everton,3,2,H,2,3,47,-3,0.2894736842105263,3,2,1,0.5,2,1,43,-5,0.2894736842105263,1,4,-3,0.0,0,0,0,0,0,0,0,0,,,2,4,2,0.0,0.5,4
1999-08-14,Wimbledon,Coventry,1,1,D,2,3,42,-23,0.2631578947368421,5,5,0,0.5,2,0,42,-12,0.2894736842105263,0,2,-2,0.0,0,0,0,0,0,0,0,0,,,3,0,-11,-0.026315789473684237,0.5,2
1999-08-15,Southampton,Newcastle,4,2,H,2,3,41,-27,0.2894736842105263,1,3,-2,0.5,2,0,46,-6,0.2894736842105263,1,4,-3,0.0,0,0,0,0,0,0,0,0,,,3,-5,-21,0.0,0.5,1
1999-08-16,Aston Villa,West Ham,2,2,D,2,6,55,5,0.3947368421052632,4,0,4,1.0,1,3,57,-7,0.42105263157894735,1,0,1,1.0,0,0,0,0,0,0,0,0,,,3,-2,12,-0.026315789473684126,0.0,3
1999-08-21,Chelsea,Aston Villa,1,0,H,2,4,75,27,0.5263157894736842,6,2,4,0.5,3,7,55,5,0.3947368421052632,6,2,4,0.6666666666666666,0,0,0,0,0,0,0,0,,,-3,20,22,0.13157894736842096,-0.16666666666666663,0
1999-08-21,Coventry,Derby,2,0,H,3,1,42,-12,0.2894736842105263,1,3,-2,0.0,3,1,52,-5,0.34210526315789475,2,5,-3,0.0,0,0,0,0,0,0,0,0,,,0,-10,-7,-0.05263157894736842,0.0,1
1999-08-21,Everton,Southampton,4,1,H,3,1,43,-5,0.2894736842105263,3,7,-4,0.0,3,6,41,-27,0.2894736842105263,5,5,0,0.6666666666666666,0,0,0,0,0,0,0,0,,,-5,2,22,0.0,-0.6666666666666666,-4
1999-08-21,Leeds,Sunderland,2,1,H,3,4,67,28,0.4736842105263158,3,2,1,0.3333333333333333,3,4,-1,-1,0.0,2,4,-2,0.3333333333333333,0,0,0,0,0,0,0,0,,,0,68,29,0.4736842105263158,0.0,3
1999-08-21,Middlesbrough,Liverpool,1,0,H,3,6,51,-6,0.3157894736842105,6,4,2,0.6666666666666666,2,3,54,19,0.3947368421052632,2,2,0,0.5,0,0,0,0,0,0,0,0,,,3,-3,-25,-0.07894736842105271,0.16666666666666663,2
1999-08-21,Newcastle,Wimbledon,3,3,D,3,0,46,-6,0.2894736842105263,3,8,-5,0.0,3,4,42,-23,0.2631578947368421,6,6,0,0.3333333333333333,0,0,0,0,0,0,0,0,,,-4,4,17,0.026315789473684237,-0.3333333333333333,-5
1999-08-21,Sheffield Weds,Tottenham,1,2,A,3,1,46,-1,0.34210526315789475,2,7,-5,0.0,3,6,47,-3,0.2894736842105263,6,4,2,0.6666666666666666,0,0,0,0,0,0,0,0,,,-5,-1,2,0.05263157894736842,-0.6666666666666666,-7
1999-08-21,Watford,Bradford,1,0,H,3,3,-1,-1,0.0,3,5,-2,0.3333333333333333,2,4,-1,-1,0.0,2,1,1,0.5,0,0,0,0,0,0,0,0,,,-1,0,0,0.0,-0.16666666666666669,-3
1999-08-21,West Ham,Leicester,2,1,H,2,4,57,-7,0.42105263157894735,3,2,1,0.5,3,4,49,-6,0.3157894736842105,4,4,0,0.3333333333333333,0,0,0,0,0,0,0,0,,,0,8,-1,0.10526315789473684,0.16666666666666669,1
1999-08-22,Arsenal,Man United,1,2,A,3,7,78,42,0.5789473684210527,4,2,2,0.6666666666666666,3,7,79,43,0.5789473684210527,7,1,6,0.6666666666666666,0,0,0,0,0,0,0,0,,,0,-1,-1,0.0,0.0,-4
1999-08-23,Leeds,Liverpool,1,2,A,4,7,67,28,0.4736842105263158,5,3,2,0.5,3,3,54,19,0.3947368421052632,2,3,-1,0.3333333333333333,0,0,0,0,0,0,0,0,,,4,13,9,0.0789473684210526,0.16666666666666669,3
1999-08-24,Middlesbrough,Leicester,0,3,A,4,9,51,-6,0.3157894736842105,7,4,3,0.75,4,4,49,-6,0.3157894736842105,5,6,-1,0.25,1,0,0,0,0,0,0,0,,,5,2,0,0.0,0.5,4
1999-08-24,Watford,Aston Villa,0,1,A,4,6,-1,-1,0.0,4,5,-1,0.5,4,7,55,5,0.3947368421052632,6,3,3,0.5,0,0,0,0,0,0,0,0,,,-1,-56,-6,-0.3947368421052632,0.0,-4
1999-08-25,Arsenal,Bradford,2,0,H,4,7,78,42,0.5789473684210527,5,4,1,0.5,3,4,-1,-1,0.0,2,2,0,0.3333333333333333,0,0,0,0,0,0,0,0,,,3,79,43,0.5789473684210527,0.16666666666666669,1
1999-08-25,Coventry,Man United,1,2,A,4,4,42,-12,0.2894736842105263,3,3,0,0.25,4,10,79,43,0.5789473684210527,9,2,7,0.75,0,0,0,0,1,0,0,0,,,-6,-37,-55,-0.2894736842105263,-0.5,-7
1999-08-25,Everton,Wimbledon,4,0,H,4,4,43,-5,0.2894736842105263,7,8,-1,0.25,4,5,42,-23,0.2631578947368421,9,9,0,0.25,0,0,0,0,0,0,0,0,,,-1,1,18,0.026315789473684237,0.0,-1
1999-08-25,Newcastle,Sunderland,1,2,A,4,1,46,-6,0.2894736842105263,6,11,-5,0.0,4,4,-1,-1,0.0,3,6,-3,0.25,0,0,0,0,0,0,0,0,,,-3,47,-5,0.2894736842105263,-0.25,-2
1999-08-25,Sheffield Weds,Derby,0,2,A,4,1,46,-1,0.34210526315789475,3,9,-6,0.0,4,1,52,-5,0.34210526315789475,2,7,-5,0.0,0,0,0,0,0,0,1,0,,,0,-6,4,0.0,0.0,-1
1999-08-28,Aston Villa,Middlesbrough,1,0,H,5,10,55,5,0.3947368421052632,7,3,4,0.6,5,9,51,-6,0.3157894736842105,7,7,0,0.6,0,0,0,0,0,0,0,0,0.6,0.6,1,4,11,0.07894736842105271,0.0,4
1999-08-28,Bradford,West Ham,0,3,A,4,4,-1,-1,0.0,2,4,-2,0.25,3,7,57,-7,0.42105263157894735,5,3,2,0.6666666666666666,0,0,0,0,0,0,0,0,,,-3,-58,6,-0.42105263157894735,-0.41666666666666663,-4
1999-08-28,Derby,Everton,1,0,H,5,4,52,-5,0.34210526315789475,4,7,-3,0.2,5,7,43,-5,0.2894736842105263,11,8,3,0.4,0,0,0,0,0,0,0,0,0.2,0.4,-3,9,0,0.05263157894736842,-0.2,-6
1999-08-28,Liverpool,Arsenal,2,0,H,4,6,54,19,0.3947368421052632,4,4,0,0.5,5,10,78,42,0.5789473684210527,7,4,3,0.6,0,0,0,0,0,0,0,0,,0.6,-4,-24,-23,-0.18421052631578944,-0.09999999999999998,-3
1999-08-28,Southampton,Sheffield Weds,2,0,H,4,6,41,-27,0.2894736842105263,6,9,-3,0.5,5,1,46,-1,0.34210526315789475,3,11,-8,0.0,0,0,0,0,0,0,0,0,,0.0,5,-5,-26,-0.05263157894736842,0.5,5
1999-08-28,Tottenham,Leeds,1,2,A,4,9,47,-3,0.2894736842105263,8,5,3,0.75,5,7,67,28,0.4736842105263158,6,5,1,0.4,1,0,0,0,0,0,0,0,,0.4,2,-20,-31,-0.1842105263157895,0.35,2
1999-08-28,Wimbledon,Chelsea,0,1,A,5,5,42,-23,0.2631578947368421,9,13,-4,0.2,3,7,75,27,0.5263157894736842,7,2,5,0.6666666666666666,0,0,0,0,0,0,0,0,0.2,,-2,-33,-50,-0.2631578947368421,-0.4666666666666666,-9
1999-08-29,Sunderland,Coventry,1,1,D,5,7,-1,-1,0.0,5,7,-2,0.4,5,4,42,-12,0.2894736842105263,4,5,-1,0.2,0,0,0,0,0,0,0,0,0.4,0.2,3,-43,11,-0.2894736842105263,0.2,-1
1999-08-30,Leicester,Watford,1,0,H,5,7,49,-6,0.3157894736842105,8,6,2,0.4,5,6,-1,-1,0.0,4,6,-2,0.4,0,0,0,0,0,0,0,0,0.4,0.4,1,50,-5,0.3157894736842105,0.0,4
1999-08-30,Man United,Newcastle,5,1,H,5,13,79,43,0.5789473684210527,11,3,8,0.8,5,1,46,-6,0.2894736842105263,7,13,-6,0.0,1,0,0,0,0,0,0,0,0.8,0.0,12,33,49,0.2894736842105263,0.8,14
1999-09-11,Arsenal,Aston Villa,3,1,H,6,10,78,42,0.5789473684210527,7,6,1,0.5,6,13,55,5,0.3947368421052632,8,3,5,0.6666666666666666,0,0,0,0,0,0,0,0,0.4,0.6,-3,23,37,0.18421052631578944,-0.16666666666666663,-4
1999-09-11,Chelsea,Newcastle,1,0,H,4,10,75,27,0.5263157894736842,8,2,6,0.75,6,1,46,-6,0.2894736842105263,8,18,-10,0.0,0,0,0,0,0,0,0,0,,0.0,9,29,33,0.23684210526315785,0.75,16
1999-09-11,Coventry,Leeds,3,4,A,6,5,42,-12,0.2894736842105263,5,6,-1,0.16666666666666666,6,10,67,28,0.4736842105263158,8,6,2,0.5,0,0,0,0,0,0,0,0,0.2,0.6,-5,-25,-40,-0.1842105263157895,-0.33333333333333337,-3
1999-09-11,Liverpool,Man United,2,3,A,5,9,54,19,0.3947368421052632,6,4,2,0.6,6,16,79,43,0.5789473684210527,16,4,12,0.8333333333333334,0,0,0,0,1,1,0,0,0.6,1.0,-7,-25,-24,-0.18421052631578944,-0.2333333333333334,-10
1999-09-11,Middlesbrough,Southampton,3,2,H,6,9,51,-6,0.3157894736842105,7,8,-1,0.5,5,9,41,-27,0.2894736842105263,8,9,-1,0.6,0,0,0,0,0,0,0,0,0.6,0.6,0,10,21,0.02631578947368418,-0.09999999999999998,0
1999-09-11,Sheffield Weds,Everton,0,2,A,6,1,46,-1,0.34210526315789475,3,13,-10,0.0,6,7,43,-5,0.2894736842105263,11,9,2,0.3333333333333333,0,0,1,0,0,0,0,0,0.0,0.4,-6,3,4,0.05263157894736842,-0.3333333333333333,-12
1999-09-11,Sunderland,Leicester,2,0,H,6,8,-1,-1,0.0,6,8,-2,0.3333333333333333,6,10,49,-6,0.3157894736842105,9,6,3,0.5,0,0,0,0,0,0,0,0,0.4,0.6,-2,-50,5,-0.3157894736842105,-0.16666666666666669,-5
1999-09-11,West Ham,Watford,1,0,H,4,10,57,-7,0.42105263157894735,8,3,5,0.75,6,6,-1,-1,0.0,4,7,-3,0.3333333333333333,0,0,0,0,0,0,0,0,,0.4,4,58,-6,0.42105263157894735,0.4166666666666667,8
1999-09-11,Wimbledon,Derby,2,2,D,6,5,42,-23,0.2631578947368421,9,14,-5,0.16666666666666666,6,7,52,-5,0.34210526315789475,5,7,-2,0.3333333333333333,0,0,0,0,0,0,0,0,0.0,0.4,-2,-10,-18,-0.07894736842105265,-0.16666666666666666,-3
1999-09-12,Bradford,Tottenham,1,1,D,5,4,-1,-1,0.0,2,7,-5,0.2,5,9,47,-3,0.2894736842105263,9,7,2,0.6,0,0,1,0,0,0,0,0,0.2,0.6,-5,-48,2,-0.2894736842105263,-0.39999999999999997,-7
1999-09-18,Aston Villa,Bradford,1,0,H,7,13,55,5,0.3947368421052632,9,6,3,0.5714285714285714,6,5,-1,-1,0.0,3,8,-5,0.16666666666666666,0,0,0,0,0,0,0,0,0.4,0.0,8,56,6,0.3947368421052632,0.40476190476190477,8
1999-09-18,Derby,Sunderland,0,5,A,7,8,52,-5,0.34210526315789475,7,9,-2,0.2857142857142857,7,11,-1,-1,0.0,8,8,0,0.42857142857142855,0,0,0,0,0,0,0,0,0.4,0.4,-3,53,-4,0.34210526315789475,-0.14285714285714285,-2
1999-09-18,Leicester,Liverpool,2,2,D,7,10,49,-6,0.3157894736842105,9,8,1,0.42857142857142855,6,9,54,19,0.3947368421052632,8,7,1,0.5,0,0,0,0,0,0,0,0,0.4,0.4,1,-5,-25,-0.07894736842105271,-0.07142857142857145,0
1999-09-18,Man United,Wimbledon,1,1,D,7,19,79,43,0.5789473684210527,19,6,13,0.8571428571428571,7,6,42,-23,0.2631578947368421,11,16,-5,0.14285714285714285,1,1,0,0,0,0,0,0,1.0,0.0,13,37,66,0.31578947368421056,0.7142857142857142,18
1999-09-18,Southampton,Arsenal,0,1,A,6,9,41,-27,0.2894736842105263,10,12,-2,0.5,7,13,78,42,0.5789473684210527,10,7,3,0.5714285714285714,0,0,0,0,0,0,0,0,0.4,0.4,-4,-37,-69,-0.2894736842105263,-0.0714285714285714,-5
1999-09-18,Watford,Chelsea,1,0,H,7,6,-1,-1,0.0,4,8,-4,0.2857142857142857,5,13,75,27,0.5263157894736842,9,2,7,0.8,0,0,1,0,1,0,0,0,0.4,0.8,-7,-76,-28,-0.5263157894736842,-0.5142857142857143,-11
1999-09-19,Everton,West Ham,1,0,H,7,10,43,-5,0.2894736842105263,13,9,4,0.42857142857142855,5,13,57,-7,0.42105263157894735,9,3,6,0.8,0,0,0,0,1,0,0,0,0.6,0.8,-3,-14,2,-0.13157894736842102,-0.3714285714285715,-2
1999-09-19,Leeds,Middlesbrough,2,0,H,7,13,67,28,0.4736842105263158,12,9,3,0.5714285714285714,7,12,51,-6,0.3157894736842105,10,10,0,0.5714285714285714,0,0,0,0,0,0,0,0,0.6,0.6,1,16,34,0.1578947368421053,0.0,3
1999-09-19,Newcastle,Sheffield Weds,8,0,H,7,1,46,-6,0.2894736842105263,8,19,-11,0.0,7,1,46,-1,0.34210526315789475,3,15,-12,0.0,0,0,1,0,0,0,1,0,0.0,0.0,0,0,-5,-0.05263157894736842,0.0,1
1999-09-19,Tottenham,Coventry,3,2,H,6,10,47,-3,0.2894736842105263,10,8,2,0.5,7,5,42,-12,0.2894736842105263,8,10,-2,0.14285714285714285,0,0,0,0,0,0,0,0,0.6,0.2,5,5,9,0.0,0.35714285714285715,4
1999-09-25,Arsenal,Watford,1,0,H,8,16,78,42,0.5789473684210527,11,7,4,0.625,8,9,-1,-1,0.0,5,8,-3,0.375,0,0,0,0,0,0,0,0,0.6,0.4,7,79,43,0.5789473684210527,0.25,7
1999-09-25,Coventry,West Ham,1,0,H,8,5,42,-12,0.2894736842105263,10,13,-3,0.125,6,13,57,-7,0.42105263157894735,9,4,5,0.6666666666666666,0,0,0,0,0,0,0,0,0.2,0.6,-8,-15,-5,-0.13157894736842102,-0.5416666666666666,-8
1999-09-25,Derby,Bradford,0,1,A,8,8,52,-5,0.34210526315789475,7,14,-7,0.25,7,5,-1,-1,0.0,3,9,-6,0.14285714285714285,0,0,0,0,0,0,0,0,0.4,0.0,3,53,-4,0.34210526315789475,0.10714285714285715,-1
1999-09-25,Leeds,Newcastle,3,2,H,8,16,67,28,0.4736842105263158,14,9,5,0.625,8,4,46,-6,0.2894736842105263,16,19,-3,0.125,1,0,0,0,0,0,0,0,0.8,0.2,12,21,34,0.1842105263157895,0.5,8
1999-09-25,Leicester,Aston Villa,3,1,H,8,11,49,-6,0.3157894736842105,11,10,1,0.375,8,16,55,5,0.3947368421052632,10,6,4,0.625,0,0,0,0,0,0,0,0,0.4,0.6,-5,-6,-11,-0.07894736842105271,-0.25,-3
1999-09-25,Man United,Southampton,3,3,D,8,20,79,43,0.5789473684210527,20,7,13,0.75,7,9,41,-27,0.2894736842105263,10,13,-3,0.42857142857142855,0,0,0,0,0,0,0,0,0.8,0.4,11,38,70,0.2894736842105263,0.32142857142857145,16
1999-09-25,Middlesbrough,Chelsea,0,1,A,8,12,51,-6,0.3157894736842105,10,12,-2,0.5,6,13,75,27,0.5263157894736842,9,3,6,0.6666666666666666,0,0,0,0,0,0,0,0,0.4,0.6,-1,-24,-33,-0.21052631578947367,-0.16666666666666663,-8
1999-09-25,Sunderland,Sheffield Weds,1,0,H,8,14,-1,-1,0.0,13,8,5,0.5,8,1,46,-1,0.34210526315789475,3,23,-20,0.0,0,0,0,0,0,0,1,1,0.6,0.0,13,-47,0,-0.34210526315789475,0.5,25
1999-09-26,Wimbledon,Tottenham,1,1,D,8,7,42,-23,0.2631578947368421,12,17,-5,0.125,7,13,47,-3,0.2894736842105263,13,10,3,0.5714285714285714,0,0,0,0,0,0,0,0,0.0,0.6,-6,-5,-20,-0.026315789473684237,-0.4464285714285714,-8
1999-09-27,Liverpool,Everton,0,1,A,7,10,54,19,0.3947368421052632,10,9,1,0.42857142857142855,8,13,43,-5,0.2894736842105263,14,9,5,0.5,0,0,0,0,0,0,0,0,0.4,0.8,-3,11,24,0.10526315789473689,-0.07142857142857145,-4
1999-10-02,Aston Villa,Liverpool,0,0,D,9,16,55,5,0.3947368421052632,11,9,2,0.5555555555555556,8,10,54,19,0.3947368421052632,10,10,0,0.375,0,0,0,0,0,0,0,0,0.6,0.4,6,1,-14,0.0,0.18055555555555558,2
1999-10-02,Bradford,Sunderland,0,4,A,8,8,-1,-1,0.0,4,9,-5,0.25,9,17,-1,-1,0.0,14,8,6,0.5555555555555556,0,0,0,0,1,0,0,0,0.2,0.8,-9,0,0,0.0,-0.3055555555555556,-11
1999-10-02,Everton,Coventry,1,1,D,9,16,43,-5,0.2894736842105263,15,9,6,0.5555555555555556,9,8,42,-12,0.2894736842105263,11,13,-2,0.2222222222222222,1,0,0,0,0,0,0,0,0.8,0.2,8,1,7,0.0,0.33333333333333337,8
1999-10-02,Sheffield Weds,Wimbledon,5,1,H,9,1,46,-1,0.34210526315789475,3,24,-21,0.0,9,8,42,-23,0.2631578947368421,13,18,-5,0.1111111111111111,0,0,1,1,0,0,0,0,0.0,0.0,-7,4,22,0.07894736842105265,-0.1111111111111111,-16
1999-10-03,Chelsea,Man United,5,0,H,7,16,75,27,0.5263157894736842,10,3,7,0.7142857142857143,9,21,79,43,0.5789473684210527,23,10,13,0.6666666666666666,0,0,0,0,0,0,0,0,0.8,0.6,-5,-4,-16,-0.052631578947368474,0.04761904761904767,-6
1999-10-03,Newcastle,Middlesbrough,2,1,H,9,4,46,-6,0.2894736842105263,18,22,-4,0.1111111111111111,9,12,51,-6,0.3157894736842105,10,13,-3,0.4444444444444444,0,0,0,0,0,0,0,0,0.2,0.2,-8,-5,0,-0.02631578947368418,-0.3333333333333333,-1
1999-10-03,Tottenham,Leicester,2,3,A,8,14,47,-3,0.2894736842105263,14,11,3,0.5,9,14,49,-6,0.3157894736842105,14,11,3,0.4444444444444444,0,0,0,0,0,0,0,0,0.4,0.6,0,-2,3,-0.02631578947368418,0.05555555555555558,0
1999-10-03,Watford,Leeds,1,2,A,9,9,-1,-1,0.0,5,9,-4,0.3333333333333333,9,19,67,28,0.4736842105263158,17,11,6,0.6666666666666666,0,0,0,0,1,0,0,0,0.2,0.8,-10,-68,-29,-0.4736842105263158,-0.3333333333333333,-10
1999-10-03,West Ham,Arsenal,2,1,H,7,13,57,-7,0.42105263157894735,9,5,4,0.5714285714285714,9,19,78,42,0.5789473684210527,12,7,5,0.6666666666666666,0,0,0,0,1,0,0,0,0.6,0.8,-6,-21,-49,-0.1578947368421053,-0.09523809523809523,-1
1999-10-04,Southampton,Derby,3,3,D,8,10,41,-27,0.2894736842105263,13,16,-3,0.375,9,8,52,-5,0.34210526315789475,7,15,-8,0.2222222222222222,0,0,0,0,0,0,0,0,0.2,0.4,2,-11,-22,-0.05263157894736842,0.1527777777777778,5
1999-10-16,Arsenal,Everton,4,1,H,10,19,78,42,0.5789473684210527,13,9,4,0.6,10,17,43,-5,0.2894736842105263,16,10,6,0.5,0,0,0,0,0,0,0,0,0.6,0.6,2,35,47,0.2894736842105263,0.09999999999999998,-2
1999-10-16,Coventry,Newcastle,4,1,H,10,9,42,-12,0.2894736842105263,12,14,-2,0.2,10,7,46,-6,0.2894736842105263,20,23,-3,0.2,0,0,0,0,0,0,0,0,0.2,0.4,2,-4,-6,0.0,0.0,1
1999-10-16,Derby,Tottenham,0,1,A,10,9,52,-5,0.34210526315789475,10,18,-8,0.2,9,14,47,-3,0.2894736842105263,16,14,2,0.4444444444444444,0,0,0,0,0,0,0,0,0.2,0.2,-5,5,-2,0.05263157894736842,-0.2444444444444444,-10
1999-10-16,Leeds,Sheffield Weds,2,0,H,10,22,67,28,0.4736842105263158,19,12,7,0.7,10,4,46,-1,0.34210526315789475,8,25,-17,0.1,1,1,0,0,0,0,0,0,1.0,0.2,18,21,29,0.13157894736842107,0.6,24
1999-10-16,Leicester,Southampton,2,1,H,10,17,49,-6,0.3157894736842105,17,13,4,0.5,9,11,41,-27,0.2894736842105263,16,19,-3,0.3333333333333333,0,0,0,0,0,0,0,0,0.6,0.2,6,8,21,0.02631578947368418,0.16666666666666669,7
1999-10-16,Liverpool,Chelsea,1,0,H,9,11,54,19,0.3947368421052632,10,10,0,0.3333333333333333,8,19,75,27,0.5263157894736842,15,3,12,0.75,0,0,0,0,0,0,0,0,0.2,0.8,-8,-21,-8,-0.13157894736842096,-0.4166666666666667,-12
1999-10-16,Man United,Watford,4,1,H,10,21,79,43,0.5789473684210527,23,15,8,0.6,10,9,-1,-1,0.0,6,11,-5,0.3,0,0,0,0,0,0,0,0,0.4,0.2,12,80,44,0.5789473684210527,0.3,13
1999-10-16,Wimbledon,Bradford,3,2,H,10,8,42,-23,0.2631578947368421,14,23,-9,0.1,9,8,-1,-1,0.0,4,13,-9,0.2222222222222222,0,0,0,0,0,0,0,0,0.0,0.2,0,43,-22,0.2631578947368421,-0.1222222222222222,0
1999-10-17,Middlesbrough,West Ham,2,0,H,10,12,51,-6,0.3157894736842105,11,15,-4,0.4,8,16,57,-7,0.42105263157894735,11,6,5,0.625,0,0,1,0,0,0,0,0,0.2,0.6,-4,-6,1,-0.10526315789473684,-0.22499999999999998,-9
1999-10-18,Sunderland,Aston Villa,2,1,H,10,20,-1,-1,0.0,18,8,10,0.6,10,17,55,5,0.3947368421052632,11,9,2,0.5,1,0,0,0,0,0,0,0,0.8,0.4,3,-56,-6,-0.3947368421052632,0.09999999999999998,8
1999-10-23,Aston Villa,Wimbledon,1,1,D,11,17,55,5,0.3947368421052632,12,11,1,0.45454545454545453,11,11,42,-23,0.2631578947368421,17,25,-8,0.18181818181818182,0,0,0,0,0,0,0,0,0.2,0.2,6,13,28,0.13157894736842113,0.2727272727272727,9
1999-10-23,Bradford,Leicester,3,1,H,10,8,-1,-1,0.0,6,16,-10,0.2,11,20,49,-6,0.3157894736842105,19,14,5,0.5454545454545454,0,0,0,0,1,0,0,0,0.2,0.6,-12,-50,5,-0.3157894736842105,-0.3454545454545454,-15
1999-10-23,Chelsea,Arsenal,2,3,A,9,19,75,27,0.5263157894736842,15,4,11,0.6666666666666666,11,22,78,42,0.5789473684210527,17,10,7,0.6363636363636364,0,0,0,0,0,0,0,0,0.6,0.8,-3,-3,-15,-0.052631578947368474,0.030303030303030276,4
1999-10-23,Sheffield Weds,Coventry,0,0,D,11,4,46,-1,0.34210526315789475,8,27,-19,0.09090909090909091,11,12,42,-12,0.2894736842105263,16,15,1,0.2727272727272727,0,0,0,0,0,0,0,0,0.2,0.4,-8,4,11,0.05263157894736842,-0.1818181818181818,-20
1999-10-23,Southampton,Liverpool,1,1,D,10,11,41,-27,0.2894736842105263,17,21,-4,0.3,10,14,54,19,0.3947368421052632,11,10,1,0.4,0,0,0,0,0,0,0,0,0.0,0.2,-3,-13,-46,-0.10526315789473689,-0.10000000000000003,-5
1999-10-23,Tottenham,Man United,3,1,H,10,17,47,-3,0.2894736842105263,17,14,3,0.5,11,24,79,43,0.5789473684210527,27,16,11,0.6363636363636364,0,0,0,0,0,0,0,0,0.4,0.4,-7,-32,-46,-0.2894736842105263,-0.13636363636363635,-8
1999-10-24,Everton,Leeds,4,4,D,11,17,43,-5,0.2894736842105263,17,14,3,0.45454545454545453,11,25,67,28,0.4736842105263158,21,12,9,0.7272727272727273,0,0,0,0,1,1,0,0,0.6,1.0,-8,-24,-33,-0.1842105263157895,-0.27272727272727276,-6
1999-10-24,Watford,Middlesbrough,1,3,A,11,9,-1,-1,0.0,7,15,-8,0.2727272727272727,11,15,51,-6,0.3157894736842105,13,15,-2,0.45454545454545453,0,0,1,0,0,0,0,0,0.2,0.4,-6,-52,5,-0.3157894736842105,-0.18181818181818182,-6
1999-10-24,West Ham,Sunderland,1,1,D,9,16,57,-7,0.42105263157894735,11,8,3,0.5555555555555556,11,23,-1,-1,0.0,20,9,11,0.6363636363636364,0,0,0,0,1,1,0,0,0.4,1.0,-7,58,-6,0.42105263157894735,-0.08080808080808077,-8
1999-10-25,Newcastle,Derby,2,0,H,11,7,46,-6,0.2894736842105263,21,27,-6,0.18181818181818182,11,9,52,-5,0.34210526315789475,10,19,-9,0.18181818181818182,0,0,0,0,0,0,0,0,0.4,0.0,-2,-6,-1,-0.05263157894736842,0.0,3
1999-10-27,Liverpool,West Ham,1,0,H,11,15,54,19,0.3947368421052632,12,11,1,0.36363636363636365,10,17,57,-7,0.42105263157894735,12,9,3,0.5,0,0,0,0,0,0,0,0,0.2,0.2,-2,-3,26,-0.026315789473684126,-0.13636363636363635,-2
1999-10-30,Arsenal,Newcastle,0,0,D,12,25,78,42,0.5789473684210527,20,12,8,0.6666666666666666,12,10,46,-6,0.2894736842105263,23,27,-4,0.25,0,0,0,0,0,0,0,0,0.8,0.6,15,32,48,0.2894736842105263,0.41666666666666663,12
1999-10-30,Derby,Chelsea,3,1,H,12,9,52,-5,0.34210526315789475,10,21,-11,0.16666666666666666,10,19,75,27,0.5263157894736842,17,7,10,0.6,0,0,0,0,0,0,0,0,0.0,0.4,-10,-23,-32,-0.18421052631578944,-0.43333333333333335,-21
1999-10-30,Leeds,West Ham,1,0,H,12,26,67,28,0.4736842105263158,25,16,9,0.6666666666666666,11,17,57,-7,0.42105263157894735,12,10,2,0.45454545454545453,0,0,0,0,0,0,0,0,0.8,0.2,9,10,35,0.052631578947368474,0.2121212121212121,7
1999-10-30,Leicester,Sheffield Weds,3,0,H,12,20,49,-6,0.3157894736842105,20,17,3,0.5,12,5,46,-1,0.34210526315789475,8,27,-19,0.08333333333333333,0,0,0,0,0,0,0,0,0.6,0.2,15,3,-5,-0.026315789473684237,0.4166666666666667,22
1999-10-30,Man United,Aston Villa,3,0,H,12,24,79,43,0.5789473684210527,28,19,9,0.5833333333333334,12,18,55,5,0.3947368421052632,13,12,1,0.4166666666666667,0,0,0,0,0,0,0,0,0.2,0.2,6,24,38,0.18421052631578944,0.16666666666666669,8
1999-10-30,Middlesbrough,Everton,2,1,H,12,18,51,-6,0.3157894736842105,16,16,0,0.5,12,18,43,-5,0.2894736842105263,21,18,3,0.4166666666666667,0,0,0,0,0,0,0,0,0.4,0.4,0,8,-1,0.02631578947368418,0.08333333333333331,-3
1999-10-30,Wimbledon,Southampton,1,1,D,12,12,42,-23,0.2631578947368421,18,26,-8,0.16666666666666666,11,12,41,-27,0.2894736842105263,18,22,-4,0.2727272727272727,0,0,0,0,0,0,0,0,0.2,0.0,0,1,4,-0.026315789473684237,-0.10606060606060605,-4
1999-10-31,Coventry,Watford,4,0,H,12,13,42,-12,0.2894736842105263,16,15,1,0.25,12,9,-1,-1,0.0,8,18,-10,0.25,0,0,0,0,0,0,1,0,0.4,0.2,4,43,-11,0.2894736842105263,0.0,11
1999-10-31,Sunderland,Tottenham,2,1,H,12,24,-1,-1,0.0,21,10,11,0.5833333333333334,11,20,47,-3,0.2894736842105263,20,15,5,0.5454545454545454,0,0,0,0,0,0,0,0,0.8,0.6,4,-48,2,-0.2894736842105263,0.037878787878787956,6
1999-11-01,Liverpool,Bradford,3,1,H,12,18,54,19,0.3947368421052632,13,11,2,0.4166666666666667,11,11,-1,-1,0.0,9,17,-8,0.2727272727272727,0,0,0,0,0,0,0,0,0.4,0.4,7,55,20,0.3947368421052632,0.14393939393939398,10
1999-11-06,Aston Villa,Southampton,0,1,A,13,18,55,5,0.3947368421052632,13,15,-2,0.38461538461538464,12,13,41,-27,0.2894736842105263,19,23,-4,0.25,0,0,0,0,0,0,0,0,0.0,0.0,5,14,32,0.10526315789473689,0.13461538461538464,2
1999-11-06,Bradford,Coventry,1,1,D,12,11,-1,-1,0.0,10,20,-10,0.25,13,16,42,-12,0.2894736842105263,20,15,5,0.3076923076923077,0,0,0,0,0,0,0,0,0.4,0.6,-5,-43,11,-0.2894736842105263,-0.05769230769230771,-15
1999-11-06,Liverpool,Derby,2,0,H,13,21,54,19,0.3947368421052632,16,12,4,0.46153846153846156,13,12,52,-5,0.34210526315789475,13,22,-9,0.23076923076923078,0,0,0,0,0,0,0,0,0.6,0.2,9,2,24,0.052631578947368474,0.23076923076923078,13
1999-11-06,Man United,Leicester,2,0,H,13,27,79,43,0.5789473684210527,31,19,12,0.6153846153846154,13,23,49,-6,0.3157894736842105,23,17,6,0.5384615384615384,0,0,0,0,0,0,0,0,0.4,0.8,4,30,49,0.26315789473684215,0.07692307692307698,6
1999-11-06,Middlesbrough,Sunderland,1,1,D,13,21,51,-6,0.3157894736842105,18,17,1,0.5384615384615384,13,27,-1,-1,0.0,23,11,12,0.6153846153846154,1,0,0,0,0,0,0,0,0.6,0.8,-6,52,-5,0.3157894736842105,-0.07692307692307698,-11
1999-11-06,Sheffield Weds,Watford,2,2,D,13,5,46,-1,0.34210526315789475,8,30,-22,0.07692307692307693,13,9,-1,-1,0.0,8,22,-14,0.23076923076923078,0,0,0,0,0,0,1,1,0.2,0.0,-4,47,0,0.34210526315789475,-0.15384615384615385,-8
1999-11-07,Chelsea,West Ham,0,0,D,11,19,75,27,0.5263157894736842,18,10,8,0.5454545454545454,12,17,57,-7,0.42105263157894735,12,11,1,0.4166666666666667,0,0,1,0,0,0,0,0,0.4,0.2,2,18,34,0.10526315789473684,0.12878787878787873,7
1999-11-07,Newcastle,Everton,1,1,D,13,11,46,-6,0.2894736842105263,23,27,-4,0.23076923076923078,13,18,43,-5,0.2894736842105263,22,20,2,0.38461538461538464,0,0,0,0,0,0,0,0,0.4,0.2,-7,3,-1,0.0,-0.15384615384615385,-6
1999-11-07,Tottenham,Arsenal,2,1,H,12,20,47,-3,0.2894736842105263,21,17,4,0.5,13,26,78,42,0.5789473684210527,20,12,8,0.6153846153846154,0,0,0,0,0,0,0,0,0.4,0.6,-6,-31,-45,-0.2894736842105263,-0.11538461538461542,-4
1999-11-07,Wimbledon,Leeds,2,0,H,13,13,42,-23,0.2631578947368421,19,27,-8,0.15384615384615385,13,29,67,28,0.4736842105263158,26,16,10,0.6923076923076923,0,0,0,0,0,0,0,0,0.2,0.8,-16,-25,-51,-0.21052631578947373,-0.5384615384615384,-18
1999-11-20,Arsenal,Middlesbrough,5,1,H,14,26,78,42,0.5789473684210527,21,14,7,0.5714285714285714,14,22,51,-6,0.3157894736842105,19,18,1,0.5,0,0,0,0,0,0,0,0,0.4,0.6,4,27,48,0.26315789473684215,0.0714285714285714,6
1999-11-20,Derby,Man United,1,2,A,14,12,52,-5,0.34210526315789475,13,24,-11,0.21428571428571427,14,30,79,43,0.5789473684210527,33,19,14,0.6428571428571429,0,0,0,0,0,0,0,0,0.2,0.6,-18,-27,-48,-0.2368421052631579,-0.4285714285714286,-25
1999-11-20,Everton,Chelsea,1,1,D,14,19,43,-5,0.2894736842105263,23,21,2,0.35714285714285715,12,20,75,27,0.5263157894736842,18,10,8,0.5,0,0,0,0,0,0,0,0,0.0,0.2,-1,-32,-32,-0.23684210526315785,-0.14285714285714285,-6
1999-11-20,Leeds,Bradford,2,1,H,14,29,67,28,0.4736842105263158,26,18,8,0.6428571428571429,13,12,-1,-1,0.0,11,21,-10,0.23076923076923078,0,0,0,0,0,0,0,0,0.6,0.2,17,68,29,0.4736842105263158,0.4120879120879121,18
1999-11-20,Leicester,Wimbledon,2,1,H,14,23,49,-6,0.3157894736842105,23,19,4,0.5,14,16,42,-23,0.2631578947368421,21,27,-6,0.21428571428571427,0,0,0,0,0,0,0,0,0.6,0.4,7,7,17,0.05263157894736842,0.2857142857142857,10
1999-11-20,Southampton,Tottenham,0,1,A,13,16,41,-27,0.2894736842105263,20,23,-3,0.3076923076923077,13,23,47,-3,0.2894736842105263,23,18,5,0.5384615384615384,0,0,0,0,0,0,0,0,0.2,0.6,-7,-6,-24,0.0,-0.23076923076923073,-8
1999-11-20,Sunderland,Liverpool,0,2,A,14,28,-1,-1,0.0,24,12,12,0.5714285714285714,14,24,54,19,0.3947368421052632,18,12,6,0.5,0,0,0,0,1,0,0,0,0.6,0.8,4,-55,-20,-0.3947368421052632,0.0714285714285714,6
1999-11-20,Watford,Newcastle,1,1,D,14,10,-1,-1,0.0,10,24,-14,0.21428571428571427,14,12,46,-6,0.2894736842105263,24,28,-4,0.21428571428571427,0,0,0,0,0,0,0,0,0.0,0.4,-2,-47,5,-0.2894736842105263,0.0,-10
1999-11-21,West Ham,Sheffield Weds,4,3,H,13,18,57,-7,0.42105263157894735,12,11,1,0.38461538461538464,14,6,46,-1,0.34210526315789475,10,32,-22,0.07142857142857142,0,0,0,0,0,0,0,0,0.0,0.2,12,11,-6,0.0789473684210526,0.3131868131868132,23
1999-11-22,Coventry,Aston Villa,2,1,H,14,17,42,-12,0.2894736842105263,21,16,5,0.2857142857142857,14,18,55,5,0.3947368421052632,13,16,-3,0.35714285714285715,0,0,0,0,0,0,0,0,0.4,0.0,-1,-13,-17,-0.10526315789473689,-0.07142857142857145,8
1999-11-27,Coventry,Leicester,0,1,A,15,20,42,-12,0.2894736842105263,23,17,6,0.3333333333333333,15,26,49,-6,0.3157894736842105,25,20,5,0.5333333333333333,0,0,0,0,0,0,0,0,0.6,0.6,-6,-7,-6,-0.02631578947368418,-0.2,1
1999-11-27,Everton,Aston Villa,0,0,D,15,20,43,-5,0.2894736842105263,24,22,2,0.3333333333333333,15,18,55,5,0.3947368421052632,14,18,-4,0.3333333333333333,0,0,0,0,0,0,1,0,0.0,0.0,2,-12,-10,-0.10526315789473689,0.0,6
1999-11-27,Middlesbrough,Wimbledon,0,0,D,15,22,51,-6,0.3157894736842105,20,23,-3,0.4666666666666667,15,16,42,-23,0.2631578947368421,22,29,-7,0.2,0,0,0,0,0,0,0,0,0.6,0.4,6,9,17,0.05263157894736842,0.26666666666666666,4
1999-11-27,Watford,Sunderland,2,3,A,15,11,-1,-1,0.0,11,25,-14,0.2,15,28,-1,-1,0.0,24,14,10,0.5333333333333333,0,0,0,0,0,0,0,0,0.0,0.4,-17,0,0,0.0,-0.3333333333333333,-24
1999-11-27,West Ham,Liverpool,1,0,H,14,21,57,-7,0.42105263157894735,16,14,2,0.42857142857142855,15,27,54,19,0.3947368421052632,20,12,8,0.5333333333333333,0,0,0,0,1,0,0,0,0.2,0.8,-6,3,-26,0.026315789473684126,-0.10476190476190478,-6
1999-11-28,Arsenal,Derby,2,1,H,15,29,78,42,0.5789473684210527,26,15,11,0.6,15,12,52,-5,0.34210526315789475,14,26,-12,0.2,0,0,0,0,0,0,0,0,0.6,0.2,17,26,47,0.2368421052631579,0.39999999999999997,23
1999-11-28,Chelsea,Bradford,1,0,H,13,21,75,27,0.5263157894736842,19,11,8,0.46153846153846156,14,12,-1,-1,0.0,12,23,-11,0.21428571428571427,0,0,0,0,0,0,0,0,0.0,0.2,9,76,28,0.5263157894736842,0.2472527472527473,19
1999-11-28,Leeds,Southampton,1,0,H,15,32,67,28,0.4736842105263158,28,19,9,0.6666666666666666,14,16,41,-27,0.2894736842105263,20,24,-4,0.2857142857142857,0,0,0,0,0,0,0,0,0.6,0.2,16,26,55,0.1842105263157895,0.38095238095238093,13
1999-11-28,Newcastle,Tottenham,2,1,H,15,13,46,-6,0.2894736842105263,25,29,-4,0.2,14,26,47,-3,0.2894736842105263,24,18,6,0.5714285714285714,0,0,0,0,0,0,0,0,0.2,0.8,-13,-1,-3,0.0,-0.3714285714285714,-10
1999-12-04,Aston Villa,Newcastle,0,1,A,16,19,55,5,0.3947368421052632,14,18,-4,0.3125,16,16,46,-6,0.2894736842105263,27,30,-3,0.25,0,0,0,0,0,0,0,0,0.0,0.4,3,9,11,0.10526315789473689,0.0625,-1
1999-12-04,Bradford,Middlesbrough,1,1,D,15,12,-1,-1,0.0,12,24,-12,0.2,16,23,51,-6,0.3157894736842105,20,23,-3,0.4375,0,0,0,0,0,0,0,0,0.2,0.4,-11,-52,5,-0.3157894736842105,-0.2375,-9
1999-12-04,Leicester,Arsenal,0,3,A,16,29,49,-6,0.3157894736842105,26,20,6,0.5625,16,32,78,42,0.5789473684210527,28,16,12,0.625,0,0,0,0,0,0,0,0,0.6,0.6,-3,-29,-48,-0.26315789473684215,-0.0625,-6
1999-12-04,Man United,Everton,5,1,H,15,33,79,43,0.5789473684210527,35,20,15,0.6666666666666666,16,21,43,-5,0.2894736842105263,24,22,2,0.3125,1,0,0,0,0,0,0,0,0.8,0.0,12,36,48,0.2894736842105263,0.35416666666666663,13
1999-12-04,Southampton,Coventry,0,0,D,15,16,41,-27,0.2894736842105263,20,25,-5,0.26666666666666666,16,20,42,-12,0.2894736842105263,23,18,5,0.3125,0,0,0,0,0,0,0,0,0.2,0.4,-4,-1,-15,0.0,-0.04583333333333334,-10
1999-12-04,Sunderland,Chelsea,4,1,H,16,31,-1,-1,0.0,27,16,11,0.5625,14,24,75,27,0.5263157894736842,20,11,9,0.5,0,0,0,0,0,0,0,0,0.4,0.2,7,-76,-28,-0.5263157894736842,0.0625,2
1999-12-04,Wimbledon,Watford,5,0,H,16,17,42,-23,0.2631578947368421,22,29,-7,0.1875,16,11,-1,-1,0.0,13,28,-15,0.1875,0,0,0,0,0,0,0,0,0.2,0.0,6,43,-22,0.2631578947368421,0.0,8
1999-12-05,Derby,Leeds,0,1,A,16,12,52,-5,0.34210526315789475,15,28,-13,0.1875,16,35,67,28,0.4736842105263158,29,19,10,0.6875,0,0,1,0,0,0,0,0,0.2,0.6,-23,-15,-33,-0.13157894736842107,-0.5,-23
1999-12-05,Liverpool,Sheffield Weds,4,1,H,16,27,54,19,0.3947368421052632,20,13,7,0.5,15,6,46,-1,0.34210526315789475,13,36,-23,0.06666666666666667,0,0,0,0,0,0,0,0,0.8,0.0,21,8,20,0.052631578947368474,0.43333333333333335,30
1999-12-06,Tottenham,West Ham,0,0,D,15,26,47,-3,0.2894736842105263,25,20,5,0.5333333333333333,15,24,57,-7,0.42105263157894735,17,14,3,0.4666666666666667,0,0,0,0,0,0,0,0,0.6,0.4,2,-10,4,-0.13157894736842102,0.06666666666666665,2
1999-12-18,Arsenal,Wimbledon,1,1,D,17,35,78,42,0.5789473684210527,31,16,15,0.6470588235294118,17,20,42,-23,0.2631578947368421,27,29,-2,0.23529411764705882,1,0,0,0,0,0,0,0,0.6,0.4,15,36,65,0.31578947368421056,0.411764705882353,17
1999-12-18,Aston Villa,Sheffield Weds,2,1,H,17,19,55,5,0.3947368421052632,14,19,-5,0.29411764705882354,16,6,46,-1,0.34210526315789475,14,40,-26,0.0625,0,0,0,0,0,0,0,0,0.0,0.0,13,9,6,0.052631578947368474,0.23161764705882354,21
1999-12-18,Bradford,Newcastle,2,0,H,16,13,-1,-1,0.0,13,25,-12,0.1875,17,19,46,-6,0.2894736842105263,28,30,-2,0.29411764705882354,0,0,0,0,0,0,0,0,0.0,0.4,-6,-47,5,-0.2894736842105263,-0.10661764705882354,-10
1999-12-18,Leicester,Derby,0,1,A,17,29,49,-6,0.3157894736842105,26,23,3,0.5294117647058824,17,12,52,-5,0.34210526315789475,15,29,-14,0.17647058823529413,0,0,0,0,0,0,1,0,0.6,0.2,17,-3,-1,-0.026315789473684237,0.3529411764705882,17
1999-12-18,Liverpool,Coventry,2,0,H,17,30,54,19,0.3947368421052632,24,14,10,0.5294117647058824,17,21,42,-12,0.2894736842105263,23,18,5,0.29411764705882354,0,0,0,0,0,0,0,0,0.8,0.4,9,12,31,0.10526315789473689,0.23529411764705882,5
1999-12-18,Middlesbrough,Tottenham,2,1,H,17,24,51,-6,0.3157894736842105,21,24,-3,0.4117647058823529,16,27,47,-3,0.2894736842105263,25,20,5,0.5,0,0,0,0,0,0,0,0,0.2,0.4,-3,4,-3,0.02631578947368418,-0.08823529411764708,-8
1999-12-18,Sunderland,Southampton,2,0,H,17,34,-1,-1,0.0,31,17,14,0.5882352941176471,16,17,41,-27,0.2894736842105263,20,25,-5,0.25,0,0,0,0,0,0,0,0,0.6,0.2,17,-42,26,-0.2894736842105263,0.3382352941176471,19
1999-12-18,Watford,Everton,1,3,A,17,11,-1,-1,0.0,13,33,-20,0.17647058823529413,17,21,43,-5,0.2894736842105263,25,27,-2,0.29411764705882354,0,0,0,0,0,0,0,0,0.0,0.0,-10,-44,4,-0.2894736842105263,-0.11764705882352941,-18
1999-12-18,West Ham,Man United,2,4,A,16,25,57,-7,0.42105263157894735,17,14,3,0.4375,16,36,79,43,0.5789473684210527,40,21,19,0.6875,0,0,0,0,1,0,0,0,0.4,0.8,-11,-22,-50,-0.1578947368421053,-0.25,-16
1999-12-19,Chelsea,Leeds,0,2,A,15,24,75,27,0.5263157894736842,21,15,6,0.4666666666666667,17,38,67,28,0.4736842105263158,30,19,11,0.7058823529411765,0,0,0,0,1,0,0,0,0.2,0.8,-14,8,-1,0.05263157894736836,-0.23921568627450984,-5
1999-12-26,Coventry,Arsenal,3,2,H,18,21,42,-12,0.2894736842105263,23,20,3,0.2777777777777778,18,36,78,42,0.5789473684210527,32,17,15,0.6111111111111112,0,0,0,0,0,0,0,0,0.2,0.6,-15,-36,-54,-0.2894736842105263,-0.33333333333333337,-12
1999-12-26,Derby,Aston Villa,0,2,A,18,15,52,-5,0.34210526315789475,16,29,-13,0.2222222222222222,18,22,55,5,0.3947368421052632,16,20,-4,0.3333333333333333,0,0,0,0,0,0,0,0,0.2,0.2,-7,-3,-10,-0.052631578947368474,-0.1111111111111111,-9
1999-12-26,Everton,Sunderland,5,0,H,18,24,43,-5,0.2894736842105263,28,28,0,0.3333333333333333,18,37,-1,-1,0.0,33,17,16,0.6111111111111112,0,0,0,0,1,0,0,0,0.2,0.6,-13,44,-4,0.2894736842105263,-0.27777777777777785,-16
1999-12-26,Leeds,Leicester,2,1,H,18,41,67,28,0.4736842105263158,32,19,13,0.7222222222222222,18,29,49,-6,0.3157894736842105,26,24,2,0.5,1,0,0,0,0,0,0,0,0.8,0.4,12,18,34,0.1578947368421053,0.2222222222222222,11
1999-12-26,Man United,Bradford,4,0,H,17,39,79,43,0.5789473684210527,44,23,21,0.7058823529411765,17,16,-1,-1,0.0,15,25,-10,0.23529411764705882,1,1,0,0,0,0,0,0,1.0,0.2,23,80,44,0.5789473684210527,0.4705882352941177,31
1999-12-26,Newcastle,Liverpool,2,2,D,18,19,46,-6,0.2894736842105263,28,32,-4,0.2777777777777778,18,33,54,19,0.3947368421052632,26,14,12,0.5555555555555556,0,0,0,0,0,0,0,0,0.4,0.8,-14,-8,-25,-0.10526315789473689,-0.2777777777777778,-16
1999-12-26,Sheffield Weds,Middlesbrough,1,0,H,17,6,46,-1,0.34210526315789475,15,42,-27,0.058823529411764705,18,27,51,-6,0.3157894736842105,23,25,-2,0.4444444444444444,0,0,1,0,0,0,0,0,0.0,0.2,-21,-5,5,0.026315789473684237,-0.3856209150326797,-25
1999-12-26,Southampton,Chelsea,1,2,A,17,17,41,-27,0.2894736842105263,20,27,-7,0.23529411764705882,16,24,75,27,0.5263157894736842,21,17,4,0.4375,0,0,0,0,0,0,0,0,0.2,0.2,-7,-34,-54,-0.23684210526315785,-0.20220588235294118,-11
1999-12-26,Tottenham,Watford,4,0,H,17,27,47,-3,0.2894736842105263,26,22,4,0.47058823529411764,18,11,-1,-1,0.0,14,36,-22,0.16666666666666666,0,0,0,0,0,0,1,0,0.4,0.0,16,48,-2,0.2894736842105263,0.303921568627451,26
1999-12-26,Wimbledon,West Ham,2,2,D,18,21,42,-23,0.2631578947368421,28,30,-2,0.2222222222222222,17,25,57,-7,0.42105263157894735,19,18,1,0.4117647058823529,0,0,0,0,0,0,0,0,0.4,0.4,-4,-15,-16,-0.15789473684210525,-0.1895424836601307,-3
1999-12-28,Arsenal,Leeds,2,0,H,19,36,78,42,0.5789473684210527,34,20,14,0.5789473684210527,19,44,67,28,0.4736842105263158,34,20,14,0.7368421052631579,0,0,0,0,1,1,0,0,0.6,1.0,-8,11,14,0.10526315789473684,-0.1578947368421052,0
1999-12-28,Bradford,Everton,0,0,D,18,16,-1,-1,0.0,15,29,-14,0.2222222222222222,19,27,43,-5,0.2894736842105263,33,28,5,0.3684210526315789,0,0,0,0,0,0,0,0,0.2,0.4,-11,-44,4,-0.2894736842105263,-0.14619883040935672,-19
1999-12-28,Leicester,Newcastle,1,2,A,19,29,49,-6,0.3157894736842105,27,26,1,0.47368421052631576,19,20,46,-6,0.2894736842105263,30,34,-4,0.2631578947368421,0,0,1,0,0,0,0,0,0.4,0.4,9,3,0,0.02631578947368418,0.21052631578947367,5
1999-12-28,Liverpool,Wimbledon,3,1,H,19,34,54,19,0.3947368421052632,28,16,12,0.5263157894736842,19,22,42,-23,0.2631578947368421,30,32,-2,0.21052631578947367,0,0,0,0,0,0,0,0,0.6,0.2,12,12,42,0.13157894736842113,0.3157894736842105,14
1999-12-28,Sunderland,Man United,2,2,D,19,37,-1,-1,0.0,33,22,11,0.5789473684210527,18,42,79,43,0.5789473684210527,48,23,25,0.7222222222222222,0,0,0,0,1,1,0,0,0.6,1.0,-5,-80,-44,-0.5789473684210527,-0.14327485380116955,-14
1999-12-28,Watford,Southampton,3,2,H,19,11,-1,-1,0.0,14,40,-26,0.15789473684210525,18,17,41,-27,0.2894736842105263,21,29,-8,0.2222222222222222,0,0,1,0,0,0,0,0,0.0,0.0,-6,-42,26,-0.2894736842105263,-0.06432748538011696,-18
1999-12-28,West Ham,Derby,1,1,D,18,26,57,-7,0.42105263157894735,21,20,1,0.3888888888888889,19,15,52,-5,0.34210526315789475,16,31,-15,0.21052631578947367,0,0,0,0,0,0,0,0,0.4,0.2,11,5,-2,0.0789473684210526,0.17836257309941522,16
1999-12-29,Aston Villa,Tottenham,1,1,D,19,25,55,5,0.3947368421052632,18,20,-2,0.3684210526315789,18,30,47,-3,0.2894736842105263,30,22,8,0.5,0,0,0,0,0,0,0,0,0.4,0.4,-5,8,8,0.10526315789473689,-0.13157894736842107,-10
1999-12-29,Chelsea,Sheffield Weds,3,0,H,17,27,75,27,0.5263157894736842,23,18,5,0.47058823529411764,18,9,46,-1,0.34210526315789475,16,42,-26,0.1111111111111111,0,0,0,0,0,0,0,0,0.4,0.2,18,29,28,0.18421052631578944,0.35947712418300654,31
2000-01-03,Derby,Watford,2,0,H,20,16,52,-5,0.34210526315789475,17,32,-15,0.2,20,14,-1,-1,0.0,17,42,-25,0.2,0,0,0,0,0,0,0,0,0.2,0.2,2,53,-4,0.34210526315789475,0.0,10
2000-01-03,Everton,Leicester,2,2,D,20,28,43,-5,0.2894736842105263,33,28,5,0.35,20,29,49,-6,0.3157894736842105,28,28,0,0.45,0,0,0,0,0,0,1,0,0.4,0.2,-1,-6,1,-0.02631578947368418,-0.10000000000000003,5
2000-01-03,Leeds,Aston Villa,1,2,A,20,44,67,28,0.4736842105263158,34,22,12,0.7,20,26,55,5,0.3947368421052632,19,21,-2,0.35,0,0,0,0,0,0,0,0,0.8,0.4,18,12,23,0.0789473684210526,0.35,14
2000-01-03,Newcastle,West Ham,2,2,D,20,23,46,-6,0.2894736842105263,32,35,-3,0.3,19,27,57,-7,0.42105263157894735,22,21,1,0.3684210526315789,0,0,0,0,0,0,0,0,0.6,0.2,-4,-11,1,-0.13157894736842102,-0.06842105263157894,-4
2000-01-03,Sheffield Weds,Arsenal,1,1,D,19,9,46,-1,0.34210526315789475,16,45,-29,0.10526315789473684,20,39,78,42,0.5789473684210527,36,20,16,0.6,0,0,0,0,0,0,0,0,0.2,0.6,-30,-32,-43,-0.2368421052631579,-0.49473684210526314,-45
2000-01-03,Southampton,Bradford,1,0,H,19,17,41,-27,0.2894736842105263,23,32,-9,0.21052631578947367,19,17,-1,-1,0.0,15,29,-14,0.21052631578947367,0,0,1,0,0,0,0,0,0.0,0.2,0,42,-26,0.2894736842105263,0.0,5
2000-01-03,Tottenham,Liverpool,1,0,H,19,31,47,-3,0.2894736842105263,31,23,8,0.47368421052631576,20,37,54,19,0.3947368421052632,31,17,14,0.55,0,0,0,0,0,0,0,0,0.2,0.6,-6,-7,-22,-0.10526315789473689,-0.07631578947368428,-6
2000-01-03,Wimbledon,Sunderland,1,0,H,20,22,42,-23,0.2631578947368421,31,35,-4,0.2,20,38,-1,-1,0.0,35,24,11,0.55,0,0,0,0,0,0,0,0,0.2,0.6,-16,43,-22,0.2631578947368421,-0.35000000000000003,-15
2000-01-04,Coventry,Chelsea,2,2,D,19,24,42,-12,0.2894736842105263,26,22,4,0.3157894736842105,18,30,75,27,0.5263157894736842,26,18,8,0.5,0,0,0,0,0,0,0,0,0.4,0.6,-6,-33,-39,-0.23684210526315785,-0.1842105263157895,-4
2000-01-08,Bradford,Chelsea,1,1,D,20,17,-1,-1,0.0,15,30,-15,0.2,19,31,75,27,0.5263157894736842,28,20,8,0.47368421052631576,0,0,0,0,0,0,0,0,0.2,0.4,-14,-76,-28,-0.5263157894736842,-0.27368421052631575,-23
2000-01-12,Chelsea,Tottenham,1,0,H,20,32,75,27,0.5263157894736842,29,21,8,0.45,20,34,47,-3,0.2894736842105263,32,23,9,0.5,0,0,0,0,0,0,0,0,0.4,0.4,-2,28,30,0.23684210526315785,-0.04999999999999999,-1
2000-01-15,Arsenal,Sunderland,4,1,H,21,40,78,42,0.5789473684210527,37,21,16,0.5714285714285714,21,38,-1,-1,0.0,35,25,10,0.5238095238095238,0,0,0,0,0,0,0,0,0.4,0.4,2,79,43,0.5789473684210527,0.04761904761904756,6
2000-01-15,Chelsea,Leicester,1,1,D,21,35,75,27,0.5263157894736842,30,21,9,0.47619047619047616,21,30,49,-6,0.3157894736842105,30,30,0,0.42857142857142855,0,0,0,0,0,0,0,0,0.6,0.0,5,26,33,0.21052631578947367,0.047619047619047616,9
2000-01-15,Coventry,Wimbledon,2,0,H,20,25,42,-12,0.2894736842105263,28,24,4,0.3,21,25,42,-23,0.2631578947368421,32,35,-3,0.23809523809523808,0,0,0,0,0,0,0,0,0.2,0.4,0,0,11,0.026315789473684237,0.06190476190476191,7
2000-01-15,Everton,Tottenham,2,2,D,21,29,43,-5,0.2894736842105263,35,30,5,0.3333333333333333,21,34,47,-3,0.2894736842105263,32,24,8,0.47619047619047616,0,0,0,0,0,0,0,0,0.4,0.4,-5,-4,-2,0.0,-0.14285714285714285,-3
2000-01-15,Middlesbrough,Derby,1,4,A,19,27,51,-6,0.3157894736842105,23,26,-3,0.42105263157894735,21,19,52,-5,0.34210526315789475,19,32,-13,0.23809523809523808,0,0,0,0,0,0,0,0,0.2,0.4,8,-1,-1,-0.026315789473684237,0.18295739348370926,10
2000-01-15,Sheffield Weds,Bradford,2,0,H,20,10,46,-1,0.34210526315789475,17,46,-29,0.1,21,18,-1,-1,0.0,16,31,-15,0.19047619047619047,0,0,0,0,0,0,0,0,0.2,0.2,-8,47,0,0.34210526315789475,-0.09047619047619046,-14
2000-01-15,Watford,Liverpool,2,3,A,21,14,-1,-1,0.0,17,44,-27,0.19047619047619047,21,37,54,19,0.3947368421052632,31,18,13,0.5238095238095238,0,0,0,0,0,0,0,0,0.2,0.6,-23,-55,-20,-0.3947368421052632,-0.33333333333333337,-40
2000-01-15,West Ham,Aston Villa,1,1,D,20,28,57,-7,0.42105263157894735,24,23,1,0.35,21,29,55,5,0.3947368421052632,21,22,-1,0.38095238095238093,0,0,0,0,0,0,0,0,0.0,0.6,-1,2,-12,0.026315789473684126,-0.030952380952380953,2
2000-01-16,Newcastle,Southampton,5,0,H,21,24,46,-6,0.2894736842105263,34,37,-3,0.2857142857142857,20,20,41,-27,0.2894736842105263,24,32,-8,0.25,0,0,0,0,0,0,0,0,0.4,0.2,4,5,21,0.0,0.0357142857142857,5
2000-01-22,Aston Villa,Chelsea,0,0,D,22,30,55,5,0.3947368421052632,22,23,-1,0.36363636363636365,22,36,75,27,0.5263157894736842,31,22,9,0.45454545454545453,0,0,0,0,0,0,0,0,0.6,0.4,-6,-20,-22,-0.13157894736842096,-0.09090909090909088,-10
2000-01-22,Bradford,Watford,3,2,H,22,18,-1,-1,0.0,16,33,-17,0.18181818181818182,22,14,-1,-1,0.0,19,47,-28,0.18181818181818182,0,0,0,0,0,0,0,0,0.0,0.2,4,0,0,0.0,0.0,11
2000-01-22,Derby,Coventry,0,0,D,22,22,52,-5,0.34210526315789475,23,33,-10,0.2727272727272727,21,28,42,-12,0.2894736842105263,30,24,6,0.3333333333333333,0,0,0,0,0,0,0,0,0.6,0.4,-6,10,7,0.05263157894736842,-0.06060606060606061,-16
2000-01-22,Leicester,West Ham,1,3,A,22,31,49,-6,0.3157894736842105,31,31,0,0.4090909090909091,21,29,57,-7,0.42105263157894735,25,24,1,0.3333333333333333,0,0,0,0,0,0,0,0,0.0,0.0,2,-8,1,-0.10526315789473684,0.0757575757575758,-1
2000-01-22,Liverpool,Middlesbrough,0,0,D,22,40,54,19,0.3947368421052632,34,20,14,0.5454545454545454,20,27,51,-6,0.3157894736842105,24,30,-6,0.4,0,0,0,0,0,0,0,0,0.6,0.2,13,3,25,0.07894736842105271,0.1454545454545454,20
2000-01-22,Southampton,Everton,2,0,H,21,20,41,-27,0.2894736842105263,24,37,-13,0.23809523809523808,22,30,43,-5,0.2894736842105263,37,32,5,0.3181818181818182,0,0,0,0,0,0,0,0,0.2,0.4,-10,-2,-22,0.0,-0.0800865800865801,-18
2000-01-22,Tottenham,Sheffield Weds,0,1,A,22,35,47,-3,0.2894736842105263,34,26,8,0.45454545454545453,21,13,46,-1,0.34210526315789475,19,46,-27,0.14285714285714285,0,0,0,0,0,0,0,0,0.4,0.4,22,1,-2,-0.05263157894736842,0.3116883116883117,35
2000-01-22,Wimbledon,Newcastle,2,0,H,22,25,42,-23,0.2631578947368421,32,37,-5,0.22727272727272727,22,27,46,-6,0.2894736842105263,39,37,2,0.3181818181818182,0,0,0,0,0,0,0,0,0.2,0.4,-2,-4,-17,-0.026315789473684237,-0.09090909090909091,-7
2000-01-23,Sunderland,Leeds,1,2,A,22,38,-1,-1,0.0,36,29,7,0.5,21,44,67,28,0.4736842105263158,35,24,11,0.6666666666666666,0,0,0,0,0,0,0,0,0.2,0.6,-6,-68,-29,-0.4736842105263158,-0.16666666666666663,-4
2000-01-24,Man United,Arsenal,1,1,D,19,43,79,43,0.5789473684210527,50,25,25,0.6842105263157895,22,43,78,42,0.5789473684210527,41,22,19,0.5909090909090909,0,0,0,0,0,0,0,0,0.8,0.4,0,1,1,0.0,0.09330143540669855,6
2000-01-29,Man United,Middlesbrough,1,0,H,20,44,79,43,0.5789473684210527,51,26,25,0.65,21,28,51,-6,0.3157894736842105,24,30,-6,0.38095238095238093,0,0,0,0,0,0,0,0,0.6,0.2,16,28,49,0.26315789473684215,0.2690476190476191,31
2000-02-02,Sheffield Weds,Man United,0,1,A,22,16,46,-1,0.34210526315789475,20,46,-26,0.18181818181818182,21,47,79,43,0.5789473684210527,52,26,26,0.6666666666666666,0,0,0,0,0,0,0,0,0.6,0.6,-31,-33,-44,-0.2368421052631579,-0.4848484848484848,-52
2000-02-05,Aston Villa,Watford,4,0,H,23,31,55,5,0.3947368421052632,22,23,-1,0.34782608695652173,23,14,-1,-1,0.0,21,50,-29,0.17391304347826086,0,0,0,0,0,0,1,0,0.4,0.2,17,56,6,0.3947368421052632,0.17391304347826086,28
2000-02-05,Bradford,Arsenal,2,1,H,23,21,-1,-1,0.0,19,35,-16,0.21739130434782608,23,44,78,42,0.5789473684210527,42,23,19,0.5652173913043478,0,0,0,0,0,0,0,0,0.2,0.4,-23,-79,-43,-0.5789473684210527,-0.34782608695652173,-35
2000-02-05,Derby,Sheffield Weds,3,3,D,23,23,52,-5,0.34210526315789475,23,33,-10,0.2608695652173913,23,16,46,-1,0.34210526315789475,20,47,-27,0.17391304347826086,0,0,0,0,0,0,0,0,0.4,0.4,7,6,-4,0.0,0.08695652173913043,17
2000-02-05,Leicester,Middlesbrough,2,1,H,23,31,49,-6,0.3157894736842105,32,34,-2,0.391304347826087,22,28,51,-6,0.3157894736842105,24,31,-7,0.36363636363636365,0,0,0,0,0,0,0,0,0.0,0.2,3,-2,0,0.0,0.027667984189723327,5
2000-02-05,Liverpool,Leeds,3,1,H,23,41,54,19,0.3947368421052632,34,20,14,0.5217391304347826,22,47,67,28,0.4736842105263158,37,25,12,0.6818181818181818,0,0,0,0,0,0,0,0,0.4,0.6,-6,-13,-9,-0.0789473684210526,-0.16007905138339917,2
2000-02-05,Man United,Coventry,3,2,H,22,50,79,43,0.5789473684210527,53,26,27,0.6818181818181818,22,29,42,-12,0.2894736842105263,30,24,6,0.3181818181818182,0,0,0,0,0,0,0,0,0.6,0.4,21,37,55,0.2894736842105263,0.3636363636363636,21
2000-02-05,Southampton,West Ham,2,1,H,22,23,41,-27,0.2894736842105263,26,37,-11,0.2727272727272727,22,32,57,-7,0.42105263157894735,28,25,3,0.36363636363636365,0,0,0,0,0,0,0,0,0.4,0.2,-9,-16,-20,-0.13157894736842102,-0.09090909090909094,-14
2000-02-05,Sunderland,Newcastle,2,2,D,23,38,-1,-1,0.0,37,31,6,0.4782608695652174,23,27,46,-6,0.2894736842105263,39,39,0,0.30434782608695654,0,0,1,0,0,0,0,0,0.0,0.4,11,-47,5,-0.2894736842105263,0.17391304347826086,6
2000-02-05,Tottenham,Chelsea,0,1,A,23,35,47,-3,0.2894736842105263,34,27,7,0.43478260869565216,23,37,75,27,0.5263157894736842,31,22,9,0.43478260869565216,0,0,0,0,0,0,0,0,0.2,0.2,-2,-28,-30,-0.23684210526315785,0.0,-2
2000-02-06,Wimbledon,Everton,0,3,A,23,28,42,-23,0.2631578947368421,34,37,-3,0.2608695652173913,23,30,43,-5,0.2894736842105263,37,34,3,0.30434782608695654,0,0,0,0,0,0,0,0,0.4,0.2,-2,-1,-18,-0.026315789473684237,-0.043478260869565244,-6
2000-02-12,Chelsea,Wimbledon,3,1,H,24,40,75,27,0.5263157894736842,32,22,10,0.4583333333333333,24,28,42,-23,0.2631578947368421,34,40,-6,0.25,0,0,0,0,0,0,0,0,0.4,0.4,12,33,50,0.2631578947368421,0.20833333333333331,16
2000-02-12,Coventry,Sunderland,3,2,H,23,29,42,-12,0.2894736842105263,32,27,5,0.30434782608695654,24,39,-1,-1,0.0,39,33,6,0.4583333333333333,0,0,0,0,0,0,0,0,0.4,0.0,-10,43,-11,0.2894736842105263,-0.15398550724637677,-1
2000-02-12,Everton,Derby,2,1,H,24,33,43,-5,0.2894736842105263,40,34,6,0.3333333333333333,24,24,52,-5,0.34210526315789475,26,36,-10,0.25,0,0,0,0,0,0,0,0,0.2,0.4,9,-9,0,-0.05263157894736842,0.08333333333333331,16
2000-02-12,Leeds,Tottenham,1,0,H,23,47,67,28,0.4736842105263158,38,28,10,0.6521739130434783,24,35,47,-3,0.2894736842105263,34,28,6,0.4166666666666667,0,0,0,0,0,0,0,0,0.4,0.2,12,20,31,0.1842105263157895,0.23550724637681159,4
2000-02-12,Newcastle,Man United,3,0,H,24,28,46,-6,0.2894736842105263,41,41,0,0.2916666666666667,23,53,79,43,0.5789473684210527,56,28,28,0.6956521739130435,0,0,0,0,1,0,0,0,0.4,0.6,-25,-33,-49,-0.2894736842105263,-0.4039855072463768,-28
2000-02-12,Sheffield Weds,Southampton,0,1,A,24,17,46,-1,0.34210526315789475,23,50,-27,0.16666666666666666,23,26,41,-27,0.2894736842105263,28,38,-10,0.30434782608695654,0,0,0,0,0,0,0,0,0.4,0.6,-9,5,26,0.05263157894736842,-0.13768115942028988,-17
2000-02-12,Watford,Leicester,1,1,D,24,14,-1,-1,0.0,21,54,-33,0.16666666666666666,24,34,49,-6,0.3157894736842105,34,35,-1,0.4166666666666667,0,0,1,0,0,0,0,0,0.2,0.2,-20,-50,5,-0.3157894736842105,-0.25,-32
2000-02-12,West Ham,Bradford,5,4,H,23,32,57,-7,0.42105263157894735,29,27,2,0.34782608695652173,24,24,-1,-1,0.0,21,36,-15,0.25,0,0,0,0,0,0,0,0,0.2,0.4,8,58,-6,0.42105263157894735,0.09782608695652173,17
2000-02-13,Arsenal,Liverpool,0,1,A,24,44,78,42,0.5789473684210527,43,25,18,0.5416666666666666,24,44,54,19,0.3947368421052632,37,21,16,0.5416666666666666,0,0,0,0,0,0,0,0,0.4,0.6,0,24,23,0.18421052631578944,0.0,2
2000-02-14,Middlesbrough,Aston Villa,0,4,A,23,28,51,-6,0.3157894736842105,25,33,-8,0.34782608695652173,24,34,55,5,0.3947368421052632,26,23,3,0.375,0,0,0,0,0,0,0,0,0.0,0.4,-6,-4,-11,-0.07894736842105271,-0.02717391304347827,-11
2000-02-19,Middlesbrough,Coventry,2,0,H,24,28,51,-6,0.3157894736842105,25,37,-12,0.3333333333333333,24,32,42,-12,0.2894736842105263,35,29,6,0.3333333333333333,0,0,1,0,0,0,0,0,0.0,0.4,-4,9,6,0.02631578947368418,0.0,-18
2000-02-20,Leeds,Man United,0,1,A,24,50,67,28,0.4736842105263158,39,28,11,0.6666666666666666,24,53,79,43,0.5789473684210527,56,31,25,0.6666666666666666,0,0,0,0,0,0,0,0,0.4,0.6,-3,-12,-15,-0.10526315789473684,0.0,-14
2000-02-26,Arsenal,Southampton,3,1,H,25,44,78,42,0.5789473684210527,43,26,17,0.52,24,29,41,-27,0.2894736842105263,29,38,-9,0.3333333333333333,0,0,0,0,1,0,0,0,0.2,0.8,15,37,69,0.2894736842105263,0.1866666666666667,26
2000-02-26,Bradford,Aston Villa,1,1,D,25,24,-1,-1,0.0,25,41,-16,0.24,25,37,55,5,0.3947368421052632,30,23,7,0.4,0,0,0,0,0,0,0,0,0.4,0.6,-13,-56,-6,-0.3947368421052632,-0.16000000000000003,-23
2000-02-26,Chelsea,Watford,2,1,H,25,43,75,27,0.5263157894736842,35,23,12,0.48,25,15,-1,-1,0.0,22,55,-33,0.16,0,0,0,0,0,0,0,0,0.6,0.0,28,76,28,0.5263157894736842,0.31999999999999995,45
2000-02-26,Coventry,Tottenham,0,1,A,25,32,42,-12,0.2894736842105263,35,31,4,0.32,25,35,47,-3,0.2894736842105263,34,29,5,0.4,0,0,0,0,0,0,1,0,0.4,0.0,-3,-5,-9,0.0,-0.08000000000000002,-1
2000-02-26,Middlesbrough,Leeds,0,0,D,25,31,51,-6,0.3157894736842105,27,37,-10,0.36,25,50,67,28,0.4736842105263158,39,29,10,0.64,0,0,0,0,0,0,0,0,0.2,0.4,-19,-16,-34,-0.1578947368421053,-0.28,-20
2000-02-26,Sheffield Weds,Newcastle,0,2,A,25,17,46,-1,0.34210526315789475,23,51,-28,0.16,25,31,46,-6,0.2894736842105263,44,41,3,0.32,0,0,0,0,0,0,0,0,0.4,0.4,-14,0,5,0.05263157894736842,-0.16,-31
2000-02-26,Sunderland,Derby,1,1,D,25,39,-1,-1,0.0,41,36,5,0.44,25,24,52,-5,0.34210526315789475,27,38,-11,0.24,0,0,0,0,0,0,0,0,0.0,0.4,15,-53,4,-0.34210526315789475,0.2,16
2000-02-26,West Ham,Everton,0,4,A,24,35,57,-7,0.42105263157894735,34,31,3,0.375,25,36,43,-5,0.2894736842105263,42,35,7,0.36,0,0,0,0,0,0,0,0,0.4,0.4,-1,14,-2,0.13157894736842102,0.015000000000000013,-4
2000-02-26,Wimbledon,Man United,2,2,D,25,28,42,-23,0.2631578947368421,35,43,-8,0.24,25,56,79,43,0.5789473684210527,57,31,26,0.68,0,0,0,0,0,0,0,0,0.4,0.8,-28,-37,-66,-0.31578947368421056,-0.44000000000000006,-34
2000-03-04,Derby,Wimbledon,4,0,H,26,25,52,-5,0.34210526315789475,28,39,-11,0.23076923076923078,26,29,42,-23,0.2631578947368421,37,45,-8,0.23076923076923078,0,0,0,0,0,0,0,0,0.2,0.2,-4,10,18,0.07894736842105265,0.0,-3
2000-03-04,Everton,Sheffield Weds,1,1,D,26,39,43,-5,0.2894736842105263,46,35,11,0.38461538461538464,26,17,46,-1,0.34210526315789475,23,53,-30,0.15384615384615385,1,0,0,0,0,0,0,0,0.6,0.2,22,-3,-4,-0.05263157894736842,0.23076923076923078,41
2000-03-04,Man United,Liverpool,1,1,D,26,57,79,43,0.5789473684210527,59,33,26,0.6538461538461539,25,47,54,19,0.3947368421052632,38,21,17,0.56,0,0,0,0,0,0,0,0,0.6,0.6,10,25,24,0.18421052631578944,0.0938461538461538,9
2000-03-04,Newcastle,Chelsea,0,1,A,26,34,46,-6,0.2894736842105263,46,41,5,0.34615384615384615,26,46,75,27,0.5263157894736842,37,24,13,0.5,0,0,0,0,1,0,0,0,0.6,0.6,-12,-29,-33,-0.23684210526315785,-0.15384615384615385,-8
2000-03-04,Southampton,Middlesbrough,1,1,D,25,29,41,-27,0.2894736842105263,30,41,-11,0.32,26,32,51,-6,0.3157894736842105,27,37,-10,0.34615384615384615,0,0,0,0,0,0,0,0,0.6,0.2,-3,-10,-21,-0.02631578947368418,-0.02615384615384614,-1
2000-03-04,Tottenham,Bradford,1,1,D,26,38,47,-3,0.2894736842105263,35,29,6,0.4230769230769231,26,25,-1,-1,0.0,26,42,-16,0.23076923076923078,0,0,0,0,0,0,0,0,0.2,0.4,13,48,-2,0.2894736842105263,0.1923076923076923,22
2000-03-04,Watford,West Ham,1,2,A,26,15,-1,-1,0.0,23,57,-34,0.15384615384615385,25,35,57,-7,0.42105263157894735,34,35,-1,0.36,0,0,0,0,0,0,0,0,0.0,0.4,-20,-58,6,-0.42105263157894735,-0.20615384615384613,-33
2000-03-05,Aston Villa,Arsenal,1,1,D,26,38,55,5,0.3947368421052632,31,24,7,0.38461538461538464,26,47,78,42,0.5789473684210527,46,27,19,0.5384615384615384,0,0,0,0,0,0,0,0,0.4,0.4,-9,-23,-37,-0.18421052631578944,-0.1538461538461538,-12
2000-03-05,Leeds,Coventry,3,0,H,26,51,67,28,0.4736842105263158,39,29,10,0.6153846153846154,26,32,42,-12,0.2894736842105263,35,32,3,0.3076923076923077,0,0,0,0,0,0,0,0,0.4,0.2,19,25,40,0.1842105263157895,0.3076923076923077,7
2000-03-05,Leicester,Sunderland,5,2,H,25,35,49,-6,0.3157894736842105,35,36,-1,0.4,26,40,-1,-1,0.0,42,37,5,0.4230769230769231,0,0,0,0,0,0,0,0,0.2,0.0,-5,50,-5,0.3157894736842105,-0.02307692307692305,-6
2000-03-08,West Ham,Southampton,2,0,H,26,38,57,-7,0.42105263157894735,36,36,0,0.38461538461538464,26,30,41,-27,0.2894736842105263,31,42,-11,0.3076923076923077,0,0,0,0,0,0,0,0,0.6,0.6,8,16,20,0.13157894736842102,0.07692307692307693,11
2000-03-11,Aston Villa,Coventry,1,0,H,27,39,55,5,0.3947368421052632,32,25,7,0.37037037037037035,27,32,42,-12,0.2894736842105263,35,35,0,0.2962962962962963,0,0,0,0,0,0,1,0,0.4,0.2,7,13,17,0.10526315789473689,0.07407407407407407,7
2000-03-11,Chelsea,Everton,1,1,D,27,49,75,27,0.5263157894736842,38,24,14,0.5185185185185185,27,40,43,-5,0.2894736842105263,47,36,11,0.37037037037037035,1,0,0,0,0,0,0,0,0.8,0.6,9,32,32,0.23684210526315785,0.14814814814814814,3
2000-03-11,Liverpool,Sunderland,1,1,D,26,48,54,19,0.3947368421052632,39,22,17,0.5384615384615384,27,40,-1,-1,0.0,44,42,2,0.4074074074074074,0,0,0,0,0,0,0,0,0.6,0.0,8,55,20,0.3947368421052632,0.13105413105413105,15
2000-03-11,Man United,Derby,3,1,H,27,58,79,43,0.5789473684210527,60,34,26,0.6296296296296297,27,28,52,-5,0.34210526315789475,32,39,-7,0.25925925925925924,0,0,0,0,0,0,0,0,0.4,0.2,30,27,48,0.2368421052631579,0.3703703703703704,33
2000-03-11,Newcastle,Watford,1,0,H,27,34,46,-6,0.2894736842105263,46,42,4,0.3333333333333333,27,15,-1,-1,0.0,24,59,-35,0.14814814814814814,0,0,0,0,0,0,0,0,0.4,0.0,19,47,-5,0.2894736842105263,0.18518518518518517,39
2000-03-11,Sheffield Weds,West Ham,3,1,H,27,18,46,-1,0.34210526315789475,24,54,-30,0.14814814814814814,27,41,57,-7,0.42105263157894735,38,36,2,0.4074074074074074,0,0,0,0,0,0,0,0,0.0,0.6,-23,-11,6,-0.0789473684210526,-0.25925925925925924,-32
2000-03-11,Tottenham,Southampton,7,2,H,27,39,47,-3,0.2894736842105263,36,30,6,0.4074074074074074,27,30,41,-27,0.2894736842105263,31,44,-13,0.2962962962962963,0,0,0,0,0,0,0,0,0.2,0.4,9,6,24,0.0,0.1111111111111111,19
2000-03-11,Wimbledon,Leicester,2,1,H,27,29,42,-23,0.2631578947368421,37,49,-12,0.2222222222222222,26,38,49,-6,0.3157894736842105,40,38,2,0.4230769230769231,0,0,0,0,0,0,0,0,0.2,0.4,-9,-7,-17,-0.05263157894736842,-0.20085470085470086,-14
2000-03-12,Bradford,Leeds,1,2,A,27,26,-1,-1,0.0,27,43,-16,0.2222222222222222,27,54,67,28,0.4736842105263158,42,29,13,0.6296296296296297,0,0,0,0,0,0,0,0,0.4,0.4,-28,-68,-29,-0.4736842105263158,-0.40740740740740744,-29
2000-03-12,Middlesbrough,Arsenal,2,1,H,27,33,51,-6,0.3157894736842105,28,38,-10,0.3333333333333333,27,48,78,42,0.5789473684210527,47,28,19,0.5185185185185185,0,0,0,0,0,0,0,0,0.2,0.2,-15,-27,-48,-0.26315789473684215,-0.18518518518518517,-29
2000-03-15,Coventry,Everton,1,0,H,28,32,42,-12,0.2894736842105263,35,36,-1,0.2857142857142857,28,41,43,-5,0.2894736842105263,48,37,11,0.35714285714285715,0,0,1,0,0,0,0,0,0.2,0.6,-9,-1,-7,0.0,-0.07142857142857145,-12
2000-03-15,Liverpool,Aston Villa,0,0,D,27,49,54,19,0.3947368421052632,40,23,17,0.5185185185185185,28,42,55,5,0.3947368421052632,33,25,8,0.39285714285714285,0,0,0,0,0,0,0,0,0.4,0.6,7,-1,14,0.0,0.12566137566137564,9
2000-03-18,Coventry,Bradford,4,0,H,29,35,42,-12,0.2894736842105263,36,36,0,0.3103448275862069,28,26,-1,-1,0.0,28,45,-17,0.21428571428571427,0,0,0,0,0,0,0,0,0.2,0.2,9,43,-11,0.2894736842105263,0.09605911330049263,17
2000-03-18,Derby,Liverpool,0,2,A,28,28,52,-5,0.34210526315789475,33,42,-9,0.25,28,50,54,19,0.3947368421052632,40,23,17,0.5,0,0,0,0,0,0,0,0,0.2,0.4,-22,-2,-24,-0.052631578947368474,-0.25,-26
2000-03-18,Leicester,Man United,0,2,A,27,38,49,-6,0.3157894736842105,41,40,1,0.4074074074074074,28,61,79,43,0.5789473684210527,63,35,28,0.6428571428571429,0,0,0,0,0,0,0,0,0.4,0.4,-23,-30,-49,-0.26315789473684215,-0.23544973544973552,-27
2000-03-18,Southampton,Aston Villa,2,0,H,28,30,41,-27,0.2894736842105263,33,51,-18,0.2857142857142857,29,43,55,5,0.3947368421052632,33,25,8,0.3793103448275862,0,0,0,0,0,0,0,0,0.2,0.4,-13,-14,-32,-0.10526315789473689,-0.09359605911330049,-26
2000-03-18,Sunderland,Middlesbrough,1,1,D,28,41,-1,-1,0.0,45,43,2,0.39285714285714285,28,36,51,-6,0.3157894736842105,30,39,-9,0.35714285714285715,0,0,0,0,0,0,0,0,0.0,0.4,5,-52,5,-0.3157894736842105,0.0357142857142857,11
2000-03-18,Watford,Sheffield Weds,1,0,H,28,15,-1,-1,0.0,24,60,-36,0.14285714285714285,28,21,46,-1,0.34210526315789475,27,55,-28,0.17857142857142858,0,0,1,0,0,0,0,0,0.0,0.2,-6,-47,0,-0.34210526315789475,-0.035714285714285726,-8
2000-03-18,West Ham,Chelsea,0,0,D,28,41,57,-7,0.42105263157894735,39,39,0,0.39285714285714285,28,50,75,27,0.5263157894736842,39,25,14,0.5,0,0,0,0,0,0,0,0,0.6,0.8,-9,-18,-34,-0.10526315789473684,-0.10714285714285715,-14
2000-03-19,Arsenal,Tottenham,2,1,H,28,48,78,42,0.5789473684210527,48,30,18,0.5,28,42,47,-3,0.2894736842105263,43,32,11,0.42857142857142855,0,0,0,0,0,0,0,0,0.2,0.4,6,31,45,0.2894736842105263,0.07142857142857145,7
2000-03-19,Everton,Newcastle,0,2,A,29,41,43,-5,0.2894736842105263,48,38,10,0.3448275862068966,28,37,46,-6,0.2894736842105263,47,42,5,0.35714285714285715,0,0,0,0,0,0,0,0,0.4,0.6,4,-3,1,0.0,-0.012315270935960576,5
2000-03-19,Leeds,Wimbledon,4,1,H,28,57,67,28,0.4736842105263158,44,30,14,0.6428571428571429,28,32,42,-23,0.2631578947368421,39,50,-11,0.25,0,0,0,0,0,0,0,0,0.6,0.2,25,25,51,0.21052631578947373,0.3928571428571429,25
2000-03-25,Aston Villa,Derby,2,0,H,30,43,55,5,0.3947368421052632,33,27,6,0.36666666666666664,29,28,52,-5,0.34210526315789475,33,44,-11,0.2413793103448276,0,0,0,0,0,0,0,0,0.2,0.2,15,3,10,0.052631578947368474,0.12528735632183904,17
2000-03-25,Bradford,Man United,0,4,A,29,26,-1,-1,0.0,28,49,-21,0.20689655172413793,29,64,79,43,0.5789473684210527,65,35,30,0.6551724137931034,0,0,0,0,0,0,0,0,0.0,0.6,-38,-80,-44,-0.5789473684210527,-0.4482758620689655,-51
2000-03-25,Chelsea,Southampton,1,1,D,29,51,75,27,0.5263157894736842,39,25,14,0.4827586206896552,29,33,41,-27,0.2894736842105263,35,51,-16,0.3103448275862069,0,0,0,0,0,0,0,0,0.6,0.2,18,34,54,0.23684210526315785,0.1724137931034483,30
2000-03-25,Liverpool,Newcastle,2,1,H,29,53,54,19,0.3947368421052632,42,23,19,0.5172413793103449,29,40,46,-6,0.2894736842105263,49,42,7,0.3793103448275862,0,0,0,0,0,0,0,0,0.4,0.8,13,8,25,0.10526315789473689,0.13793103448275867,12
2000-03-25,Middlesbrough,Sheffield Weds,1,0,H,29,37,51,-6,0.3157894736842105,31,40,-9,0.3448275862068966,29,21,46,-1,0.34210526315789475,27,56,-29,0.1724137931034483,0,0,0,0,0,0,0,0,0.4,0.2,16,5,-5,-0.026315789473684237,0.1724137931034483,20
2000-03-25,Sunderland,Everton,2,1,H,29,42,-1,-1,0.0,46,44,2,0.3793103448275862,30,41,43,-5,0.2894736842105263,48,40,8,0.3333333333333333,0,0,0,0,0,0,0,0,0.0,0.2,1,-44,4,-0.2894736842105263,0.04597701149425287,-6
2000-03-25,Watford,Tottenham,1,1,D,29,18,-1,-1,0.0,25,60,-35,0.1724137931034483,29,42,47,-3,0.2894736842105263,44,34,10,0.41379310344827586,0,0,0,0,0,0,0,0,0.2,0.4,-24,-48,2,-0.2894736842105263,-0.24137931034482757,-45
2000-03-26,Arsenal,Coventry,3,0,H,29,51,78,42,0.5789473684210527,50,31,19,0.5172413793103449,30,38,42,-12,0.2894736842105263,40,36,4,0.3333333333333333,0,0,0,0,0,0,0,0,0.4,0.4,13,36,54,0.2894736842105263,0.18390804597701155,15
2000-03-26,Leicester,Leeds,2,1,H,28,38,49,-6,0.3157894736842105,41,42,-1,0.39285714285714285,29,60,67,28,0.4736842105263158,48,31,17,0.6551724137931034,0,0,0,0,1,0,0,0,0.4,0.6,-22,-18,-34,-0.1578947368421053,-0.2623152709359606,-18
2000-03-26,West Ham,Wimbledon,2,1,H,29,42,57,-7,0.42105263157894735,39,39,0,0.3793103448275862,29,32,42,-23,0.2631578947368421,40,54,-14,0.2413793103448276,0,0,0,0,0,0,0,0,0.4,0.2,10,15,16,0.15789473684210525,0.1379310344827586,14
2000-04-01,Coventry,Liverpool,0,3,A,31,38,42,-12,0.2894736842105263,40,39,1,0.3225806451612903,30,56,54,19,0.3947368421052632,44,24,20,0.5333333333333333,0,0,0,0,0,0,0,0,0.4,0.4,-18,-12,-31,-0.10526315789473689,-0.210752688172043,-19
2000-04-01,Everton,Watford,4,2,H,31,41,43,-5,0.2894736842105263,49,42,7,0.3225806451612903,30,19,-1,-1,0.0,26,61,-35,0.16666666666666666,0,0,1,0,0,0,0,0,0.0,0.2,22,44,-4,0.2894736842105263,0.15591397849462366,42
2000-04-01,Leeds,Chelsea,0,1,A,30,60,67,28,0.4736842105263158,49,33,16,0.6333333333333333,30,52,75,27,0.5263157894736842,40,26,14,0.4666666666666667,0,0,0,0,0,0,0,0,0.6,0.4,8,-8,1,-0.05263157894736836,0.16666666666666663,2
2000-04-01,Man United,West Ham,7,1,H,30,67,79,43,0.5789473684210527,69,35,34,0.6666666666666666,30,45,57,-7,0.42105263157894735,41,40,1,0.4,1,0,0,0,0,0,0,0,0.6,0.6,22,22,50,0.1578947368421053,0.2666666666666666,33
2000-04-01,Newcastle,Bradford,2,0,H,30,40,46,-6,0.2894736842105263,50,44,6,0.36666666666666664,30,26,-1,-1,0.0,28,53,-25,0.2,0,0,0,0,0,0,1,0,0.6,0.0,14,47,-5,0.2894736842105263,0.16666666666666663,31
2000-04-01,Southampton,Sunderland,1,2,A,30,34,41,-27,0.2894736842105263,36,52,-16,0.3,30,45,-1,-1,0.0,48,45,3,0.4,0,0,0,0,0,0,0,0,0.2,0.2,-11,42,-26,0.2894736842105263,-0.10000000000000003,-19
2000-04-01,Wimbledon,Arsenal,1,3,A,30,32,42,-23,0.2631578947368421,41,56,-15,0.23333333333333334,30,54,78,42,0.5789473684210527,53,31,22,0.5333333333333333,0,0,0,0,0,0,0,0,0.2,0.6,-22,-36,-65,-0.31578947368421056,-0.3,-37
2000-04-02,Derby,Leicester,3,0,H,30,28,52,-5,0.34210526315789475,33,46,-13,0.23333333333333334,29,41,49,-6,0.3157894736842105,43,43,0,0.41379310344827586,0,0,1,0,0,0,0,0,0.2,0.4,-13,3,1,0.026315789473684237,-0.18045977011494252,-13
2000-04-03,Tottenham,Middlesbrough,2,3,A,30,43,47,-3,0.2894736842105263,45,35,10,0.4,30,40,51,-6,0.3157894736842105,32,40,-8,0.36666666666666664,0,0,0,0,0,0,0,0,0.4,0.4,3,-4,3,-0.02631578947368418,0.03333333333333338,18
2000-04-05,Sheffield Weds,Aston Villa,0,1,A,30,21,46,-1,0.34210526315789475,27,57,-30,0.16666666666666666,31,46,55,5,0.3947368421052632,35,27,8,0.3870967741935484,0,0,0,0,0,0,0,0,0.2,0.4,-25,-9,-6,-0.052631578947368474,-0.22043010752688172,-38
2000-04-08,Bradford,Southampton,1,2,A,31,26,-1,-1,0.0,28,55,-27,0.1935483870967742,31,34,41,-27,0.2894736842105263,37,54,-17,0.2903225806451613,0,0,1,0,0,0,0,0,0.0,0.2,-8,-42,26,-0.2894736842105263,-0.09677419354838712,-10
2000-04-08,Leicester,Everton,1,1,D,30,41,49,-6,0.3157894736842105,43,46,-3,0.4,32,44,43,-5,0.2894736842105263,53,44,9,0.34375,0,0,0,0,0,0,0,0,0.4,0.2,-3,6,-1,0.02631578947368418,0.05625000000000002,-12
2000-04-08,Sunderland,Wimbledon,2,1,H,31,48,-1,-1,0.0,50,46,4,0.41935483870967744,31,32,42,-23,0.2631578947368421,42,59,-17,0.22580645161290322,0,0,0,0,0,0,1,0,0.4,0.2,16,-43,22,-0.2631578947368421,0.19354838709677422,21
2000-04-08,Watford,Derby,0,0,D,31,19,-1,-1,0.0,28,65,-37,0.16129032258064516,31,31,52,-5,0.34210526315789475,36,46,-10,0.25806451612903225,0,0,0,0,0,0,0,0,0.2,0.4,-12,-53,4,-0.34210526315789475,-0.0967741935483871,-27
2000-04-09,Aston Villa,Leeds,1,0,H,32,49,55,5,0.3947368421052632,36,27,9,0.40625,31,60,67,28,0.4736842105263158,49,34,15,0.6129032258064516,0,0,0,0,0,0,0,0,0.6,0.6,-11,-12,-23,-0.0789473684210526,-0.20665322580645162,-6
2000-04-09,Liverpool,Tottenham,2,0,H,31,59,54,19,0.3947368421052632,47,24,23,0.5483870967741935,31,43,47,-3,0.2894736842105263,47,38,9,0.3870967741935484,1,0,0,0,0,0,0,0,0.6,0.2,16,7,22,0.10526315789473689,0.16129032258064513,14
2000-04-10,Middlesbrough,Man United,3,4,A,31,43,51,-6,0.3157894736842105,35,42,-7,0.3870967741935484,31,70,79,43,0.5789473684210527,76,36,40,0.6774193548387096,0,0,0,0,1,0,0,0,0.6,0.8,-27,-28,-49,-0.26315789473684215,-0.29032258064516125,-47
2000-04-12,Chelsea,Coventry,2,1,H,31,55,75,27,0.5263157894736842,41,26,15,0.4838709677419355,32,38,42,-12,0.2894736842105263,40,42,-2,0.3125,0,0,0,0,0,0,0,0,0.4,0.4,17,33,39,0.23684210526315785,0.1713709677419355,17
2000-04-12,West Ham,Newcastle,2,1,H,31,45,57,-7,0.42105263157894735,42,47,-5,0.3870967741935484,31,43,46,-6,0.2894736842105263,52,44,8,0.3870967741935484,0,0,0,0,0,0,0,0,0.4,0.6,2,11,-1,0.13157894736842102,0.0,-13
2000-04-12,Wimbledon,Sheffield Weds,0,2,A,32,32,42,-23,0.2631578947368421,43,61,-18,0.21875,31,21,46,-1,0.34210526315789475,27,58,-31,0.16129032258064516,0,0,1,0,0,0,1,0,0.2,0.2,11,-4,-22,-0.07894736842105265,0.05745967741935484,13
2000-04-15,Coventry,Middlesbrough,2,1,H,33,38,42,-12,0.2894736842105263,41,44,-3,0.30303030303030304,32,43,51,-6,0.3157894736842105,38,46,-8,0.375,0,0,1,0,0,0,0,0,0.4,0.6,-5,-9,-6,-0.02631578947368418,-0.07196969696969696,5
2000-04-15,Derby,West Ham,1,2,A,32,32,52,-5,0.34210526315789475,36,46,-10,0.25,32,48,57,-7,0.42105263157894735,44,48,-4,0.40625,0,0,0,0,0,0,0,0,0.2,0.4,-16,-5,2,-0.0789473684210526,-0.15625,-6
2000-04-15,Everton,Bradford,4,0,H,33,45,43,-5,0.2894736842105263,54,45,9,0.3333333333333333,32,26,-1,-1,0.0,29,57,-28,0.1875,0,0,0,0,0,0,1,1,0.2,0.0,19,44,-4,0.2894736842105263,0.14583333333333331,37
2000-04-15,Man United,Sunderland,4,0,H,32,73,79,43,0.5789473684210527,80,39,41,0.6875,32,51,-1,-1,0.0,52,47,5,0.4375,1,1,0,0,1,0,0,0,1.0,0.6,22,80,44,0.5789473684210527,0.25,36
2000-04-15,Newcastle,Leicester,0,2,A,32,43,46,-6,0.2894736842105263,53,46,7,0.375,31,42,49,-6,0.3157894736842105,44,47,-3,0.3870967741935484,0,0,0,0,0,0,0,0,0.6,0.2,1,-3,0,-0.02631578947368418,-0.012096774193548376,10
2000-04-15,Sheffield Weds,Chelsea,1,0,H,32,24,46,-1,0.34210526315789475,29,58,-29,0.1875,32,58,75,27,0.5263157894736842,43,27,16,0.5,0,0,0,0,0,0,0,0,0.4,0.4,-34,-29,-28,-0.18421052631578944,-0.3125,-45
2000-04-15,Southampton,Watford,2,0,H,32,37,41,-27,0.2894736842105263,39,55,-16,0.3125,32,20,-1,-1,0.0,28,65,-37,0.15625,0,0,0,0,0,0,0,0,0.4,0.2,17,42,-26,0.2894736842105263,0.15625,21
2000-04-15,Tottenham,Aston Villa,2,4,A,32,43,47,-3,0.2894736842105263,47,40,7,0.375,33,52,55,5,0.3947368421052632,37,27,10,0.42424242424242425,0,0,0,0,1,0,0,0,0.2,0.6,-9,-8,-8,-0.10526315789473689,-0.049242424242424254,-3
2000-04-16,Leeds,Arsenal,0,4,A,32,60,67,28,0.4736842105263158,49,35,14,0.59375,31,57,78,42,0.5789473684210527,56,32,24,0.5483870967741935,0,0,1,0,1,0,0,0,0.4,0.6,3,-11,-14,-0.10526315789473684,0.045362903225806495,-10
2000-04-16,Wimbledon,Liverpool,1,2,A,33,32,42,-23,0.2631578947368421,43,63,-20,0.21212121212121213,32,62,54,19,0.3947368421052632,49,24,25,0.5625,0,0,1,1,1,0,0,0,0.0,0.8,-30,-12,-42,-0.13157894736842113,-0.35037878787878785,-45
2000-04-19,Leicester,Tottenham,0,1,A,32,45,49,-6,0.3157894736842105,46,47,-1,0.40625,33,43,47,-3,0.2894736842105263,49,44,5,0.36363636363636365,0,0,0,0,0,0,1,0,0.4,0.0,2,2,-3,0.02631578947368418,0.042613636363636354,-6
2000-04-21,Bradford,Derby,4,4,D,33,26,-1,-1,0.0,29,61,-32,0.18181818181818182,33,32,52,-5,0.34210526315789475,37,48,-11,0.24242424242424243,0,0,1,1,0,0,0,0,0.0,0.2,-6,-53,4,-0.34210526315789475,-0.06060606060606061,-21
2000-04-21,Everton,Liverpool,0,0,D,34,48,43,-5,0.2894736842105263,58,45,13,0.35294117647058826,33,65,54,19,0.3947368421052632,51,25,26,0.5757575757575758,0,0,0,0,1,1,0,0,0.4,1.0,-17,-11,-24,-0.10526315789473689,-0.22281639928698754,-13
2000-04-22,Aston Villa,Leicester,2,2,D,34,55,55,5,0.3947368421052632,41,29,12,0.4411764705882353,33,45,49,-6,0.3157894736842105,46,48,-2,0.3939393939393939,1,0,0,0,0,0,0,0,0.8,0.4,10,6,11,0.07894736842105271,0.04723707664884136,14
2000-04-22,Chelsea,Middlesbrough,1,1,D,33,58,75,27,0.5263157894736842,43,28,15,0.48484848484848486,33,43,51,-6,0.3157894736842105,39,48,-9,0.36363636363636365,0,0,0,0,0,0,0,0,0.4,0.4,15,24,33,0.21052631578947367,0.12121212121212122,24
2000-04-22,Sheffield Weds,Sunderland,0,2,A,33,27,46,-1,0.34210526315789475,30,58,-28,0.21212121212121213,33,51,-1,-1,0.0,52,51,1,0.42424242424242425,0,0,0,0,0,0,0,0,0.4,0.6,-24,47,0,0.34210526315789475,-0.21212121212121213,-29
2000-04-22,Southampton,Man United,1,3,A,33,40,41,-27,0.2894736842105263,41,55,-14,0.3333333333333333,33,76,79,43,0.5789473684210527,84,39,45,0.696969696969697,0,0,0,0,1,1,0,0,0.6,1.0,-36,-38,-70,-0.2894736842105263,-0.3636363636363637,-59
2000-04-22,Tottenham,Wimbledon,2,0,H,34,46,47,-3,0.2894736842105263,50,44,6,0.38235294117647056,34,32,42,-23,0.2631578947368421,44,65,-21,0.20588235294117646,0,0,0,0,0,0,1,1,0.2,0.0,14,5,20,0.026315789473684237,0.1764705882352941,27
2000-04-22,West Ham,Coventry,5,0,H,33,51,57,-7,0.42105263157894735,46,49,-3,0.42424242424242425,34,41,42,-12,0.2894736842105263,43,45,-2,0.3235294117647059,0,0,0,0,0,0,0,0,0.6,0.4,10,15,5,0.13157894736842102,0.10071301247771836,-1
2000-04-23,Newcastle,Leeds,2,2,D,33,43,46,-6,0.2894736842105263,53,48,5,0.36363636363636365,33,60,67,28,0.4736842105263158,49,39,10,0.5757575757575758,0,0,0,0,0,0,1,0,0.4,0.2,-17,-21,-34,-0.1842105263157895,-0.21212121212121215,-5
2000-04-23,Watford,Arsenal,2,3,A,33,20,-1,-1,0.0,28,67,-39,0.15151515151515152,32,60,78,42,0.5789473684210527,60,32,28,0.5625,0,0,0,0,1,0,0,0,0.2,0.8,-40,-79,-43,-0.5789473684210527,-0.4109848484848485,-67
2000-04-24,Derby,Southampton,2,0,H,34,33,52,-5,0.34210526315789475,41,52,-11,0.23529411764705882,34,40,41,-27,0.2894736842105263,42,58,-16,0.3235294117647059,0,0,0,0,0,0,0,0,0.2,0.4,-7,11,22,0.05263157894736842,-0.08823529411764708,5
2000-04-24,Man United,Chelsea,3,2,H,34,79,79,43,0.5789473684210527,87,40,47,0.7058823529411765,34,59,75,27,0.5263157894736842,44,29,15,0.47058823529411764,1,1,0,0,0,0,0,0,1.0,0.4,20,4,16,0.052631578947368474,0.23529411764705888,32
2000-04-24,Sunderland,Bradford,0,1,A,34,54,-1,-1,0.0,54,51,3,0.4411764705882353,34,27,-1,-1,0.0,33,65,-32,0.17647058823529413,0,0,0,0,0,0,0,0,0.8,0.0,27,0,0,0.0,0.2647058823529411,35
2000-04-29,Aston Villa,Sunderland,1,1,D,35,56,55,5,0.3947368421052632,43,31,12,0.42857142857142855,35,54,-1,-1,0.0,54,52,2,0.42857142857142855,0,0,0,0,0,0,0,0,0.8,0.6,2,56,6,0.3947368421052632,0.0,10
2000-04-29,Chelsea,Liverpool,2,0,H,35,59,75,27,0.5263157894736842,46,32,14,0.45714285714285713,34,66,54,19,0.3947368421052632,51,25,26,0.5588235294117647,0,0,0,0,0,0,0,0,0.4,0.8,-7,21,8,0.13157894736842096,-0.10168067226890759,-12
2000-04-29,Everton,Arsenal,0,1,A,35,49,43,-5,0.2894736842105263,58,45,13,0.34285714285714286,33,63,78,42,0.5789473684210527,63,34,29,0.5757575757575758,0,0,0,0,1,1,0,0,0.4,1.0,-14,-35,-47,-0.2894736842105263,-0.23290043290043294,-16
2000-04-29,Newcastle,Coventry,2,0,H,34,44,46,-6,0.2894736842105263,55,50,5,0.35294117647058826,35,41,42,-12,0.2894736842105263,43,50,-7,0.3142857142857143,0,0,0,0,0,0,0,0,0.2,0.2,3,4,6,0.0,0.03865546218487398,12
2000-04-29,Southampton,Leicester,1,2,A,35,40,41,-27,0.2894736842105263,42,60,-18,0.3142857142857143,34,46,49,-6,0.3157894736842105,48,50,-2,0.38235294117647056,0,0,0,0,0,0,0,0,0.4,0.2,-6,-8,-21,-0.02631578947368418,-0.06806722689075628,-16
2000-04-29,Tottenham,Derby,1,1,D,35,49,47,-3,0.2894736842105263,52,44,8,0.4,35,36,52,-5,0.34210526315789475,43,52,-9,0.2571428571428571,0,0,0,0,0,0,0,0,0.4,0.4,13,-5,2,-0.05263157894736842,0.1428571428571429,17
2000-04-29,Watford,Man United,2,3,A,34,20,-1,-1,0.0,30,70,-40,0.14705882352941177,35,82,79,43,0.5789473684210527,90,42,48,0.7142857142857143,0,0,0,0,1,1,0,0,0.0,1.0,-62,-80,-44,-0.5789473684210527,-0.5672268907563025,-88
2000-04-29,West Ham,Middlesbrough,0,1,A,34,54,57,-7,0.42105263157894735,51,49,2,0.4411764705882353,34,44,51,-6,0.3157894736842105,40,49,-9,0.35294117647058826,1,0,0,0,0,0,0,0,0.8,0.4,10,6,-1,0.10526315789473684,0.08823529411764702,11
2000-04-30,Bradford,Wimbledon,3,0,H,35,30,-1,-1,0.0,34,65,-31,0.2,35,32,42,-23,0.2631578947368421,44,67,-23,0.2,0,0,0,0,0,0,1,1,0.2,0.0,-2,-43,22,-0.2631578947368421,0.0,-8
2000-04-30,Sheffield Weds,Leeds,0,3,A,34,27,46,-1,0.34210526315789475,30,60,-30,0.20588235294117646,34,61,67,28,0.4736842105263158,51,41,10,0.5588235294117647,0,0,0,0,0,0,0,0,0.4,0.0,-34,-21,-29,-0.13157894736842107,-0.35294117647058826,-40
2000-05-02,Arsenal,West Ham,2,1,H,34,66,78,42,0.5789473684210527,64,34,30,0.5882352941176471,35,54,57,-7,0.42105263157894735,51,50,1,0.42857142857142855,1,1,0,0,0,0,0,0,1.0,0.6,12,21,49,0.1578947368421053,0.15966386554621853,29
2000-05-02,Middlesbrough,Newcastle,2,2,D,35,47,51,-6,0.3157894736842105,41,49,-8,0.37142857142857144,35,47,46,-6,0.2894736842105263,57,50,7,0.37142857142857144,0,0,0,0,0,0,0,0,0.4,0.4,0,5,0,0.02631578947368418,0.0,-15
2000-05-03,Leeds,Watford,3,1,H,35,64,67,28,0.4736842105263158,54,41,13,0.5714285714285714,35,20,-1,-1,0.0,32,73,-41,0.14285714285714285,0,0,0,0,0,0,1,0,0.2,0.0,44,68,29,0.4736842105263158,0.42857142857142855,54
2000-05-03,Liverpool,Leicester,0,2,A,35,66,54,19,0.3947368421052632,51,27,24,0.5428571428571428,35,49,49,-6,0.3157894736842105,50,51,-1,0.4,0,0,0,0,0,0,0,0,0.6,0.4,17,5,25,0.07894736842105271,0.1428571428571428,25
2000-05-06,Arsenal,Chelsea,2,1,H,35,69,78,42,0.5789473684210527,66,35,31,0.6,36,62,75,27,0.5263157894736842,48,32,16,0.4722222222222222,1,1,0,0,0,0,0,0,1.0,0.4,7,3,15,0.052631578947368474,0.12777777777777777,15
2000-05-06,Coventry,Sheffield Weds,4,1,H,36,41,42,-12,0.2894736842105263,43,52,-9,0.3055555555555556,35,27,46,-1,0.34210526315789475,30,63,-33,0.2,0,0,0,0,0,0,0,0,0.2,0.4,14,-4,-11,-0.05263157894736842,0.10555555555555557,24
2000-05-06,Derby,Newcastle,0,0,D,36,37,52,-5,0.34210526315789475,44,53,-9,0.25,36,48,46,-6,0.2894736842105263,59,52,7,0.3611111111111111,0,0,0,0,0,0,0,0,0.2,0.2,-11,6,1,0.05263157894736842,-0.1111111111111111,-16
2000-05-06,Leicester,Bradford,3,0,H,36,52,49,-6,0.3157894736842105,52,51,1,0.4166666666666667,36,33,-1,-1,0.0,37,65,-28,0.2222222222222222,0,0,0,0,0,0,0,0,0.6,0.4,19,50,-5,0.3157894736842105,0.19444444444444448,29
2000-05-06,Man United,Tottenham,3,1,H,36,85,79,43,0.5789473684210527,93,44,49,0.7222222222222222,36,50,47,-3,0.2894736842105263,53,45,8,0.3888888888888889,1,1,0,0,0,0,0,0,1.0,0.4,35,32,46,0.2894736842105263,0.3333333333333333,41
2000-05-06,Middlesbrough,Watford,1,1,D,36,48,51,-6,0.3157894736842105,43,51,-8,0.3611111111111111,36,20,-1,-1,0.0,33,76,-43,0.1388888888888889,0,0,0,0,0,0,1,0,0.2,0.0,28,52,-5,0.3157894736842105,0.2222222222222222,35
2000-05-06,Sunderland,West Ham,1,0,H,36,55,-1,-1,0.0,55,53,2,0.4166666666666667,36,54,57,-7,0.42105263157894735,52,52,0,0.4166666666666667,0,0,0,0,0,0,0,0,0.4,0.6,1,-58,6,-0.42105263157894735,0.0,2
2000-05-06,Wimbledon,Aston Villa,2,2,D,36,32,42,-23,0.2631578947368421,44,70,-26,0.19444444444444445,36,57,55,5,0.3947368421052632,44,32,12,0.4166666666666667,0,0,1,1,0,0,0,0,0.0,0.6,-25,-13,-28,-0.13157894736842113,-0.22222222222222224,-38
2000-05-07,Liverpool,Southampton,0,0,D,36,66,54,19,0.3947368421052632,51,29,22,0.5277777777777778,36,40,41,-27,0.2894736842105263,43,62,-19,0.3055555555555556,0,0,0,0,0,0,1,0,0.4,0.4,26,13,46,0.10526315789473689,0.2222222222222222,41
2000-05-08,Leeds,Everton,1,1,D,36,67,67,28,0.4736842105263158,57,42,15,0.5833333333333334,36,49,43,-5,0.2894736842105263,58,46,12,0.3333333333333333,0,0,0,0,0,0,0,0,0.4,0.4,18,24,33,0.1842105263157895,0.25000000000000006,3
2000-05-09,Arsenal,Sheffield Weds,3,3,D,36,72,78,42,0.5789473684210527,68,36,32,0.6111111111111112,36,27,46,-1,0.34210526315789475,31,67,-36,0.19444444444444445,1,1,0,0,0,0,1,0,1.0,0.4,45,32,43,0.2368421052631579,0.41666666666666674,68
2000-05-14,Aston Villa,Man United,0,1,A,37,58,55,5,0.3947368421052632,46,34,12,0.40540540540540543,37,88,79,43,0.5789473684210527,96,45,51,0.7297297297297297,0,0,0,0,1,1,0,0,0.4,1.0,-30,-24,-38,-0.18421052631578944,-0.3243243243243243,-39
2000-05-14,Bradford,Liverpool,1,0,H,37,33,-1,-1,0.0,37,68,-31,0.21621621621621623,37,67,54,19,0.3947368421052632,51,29,22,0.5135135135135135,0,0,0,0,0,0,0,0,0.4,0.2,-34,-55,-20,-0.3947368421052632,-0.29729729729729726,-53
2000-05-14,Chelsea,Derby,4,0,H,37,62,75,27,0.5263157894736842,49,34,15,0.4594594594594595,37,38,52,-5,0.34210526315789475,44,53,-9,0.24324324324324326,0,0,0,0,0,0,0,0,0.2,0.2,24,23,32,0.18421052631578944,0.21621621621621623,24
2000-05-14,Everton,Middlesbrough,0,2,A,37,50,43,-5,0.2894736842105263,59,47,12,0.32432432432432434,37,49,51,-6,0.3157894736842105,44,52,-8,0.35135135135135137,0,0,0,0,0,0,0,0,0.2,0.2,1,-8,1,-0.02631578947368418,-0.02702702702702703,20
2000-05-14,Newcastle,Arsenal,4,2,H,37,49,46,-6,0.2894736842105263,59,52,7,0.35135135135135137,37,73,78,42,0.5789473684210527,71,39,32,0.5945945945945946,0,0,0,0,0,0,0,0,0.2,0.8,-24,-32,-48,-0.2894736842105263,-0.24324324324324326,-25
2000-05-14,Sheffield Weds,Leicester,4,0,H,37,28,46,-1,0.34210526315789475,34,70,-36,0.1891891891891892,37,55,49,-6,0.3157894736842105,55,51,4,0.43243243243243246,0,0,0,0,1,0,0,0,0.2,0.6,-27,-3,5,0.026315789473684237,-0.24324324324324326,-40
2000-05-14,Southampton,Wimbledon,2,0,H,37,41,41,-27,0.2894736842105263,43,62,-19,0.2972972972972973,37,33,42,-23,0.2631578947368421,46,72,-26,0.1891891891891892,0,0,0,0,0,0,0,0,0.2,0.0,8,-1,-4,0.026315789473684237,0.10810810810810811,7
2000-05-14,Tottenham,Sunderland,3,1,H,37,50,47,-3,0.2894736842105263,54,48,6,0.3783783783783784,37,58,-1,-1,0.0,56,53,3,0.43243243243243246,0,0,0,0,0,0,0,0,0.4,0.4,-8,48,-2,0.2894736842105263,-0.05405405405405406,3
2000-05-14,Watford,Coventry,1,0,H,37,21,-1,-1,0.0,34,77,-43,0.13513513513513514,37,44,42,-12,0.2894736842105263,47,53,-6,0.32432432432432434,0,0,0,0,0,0,0,0,0.0,0.4,-23,-43,11,-0.2894736842105263,-0.1891891891891892,-37
2000-05-14,West Ham,Leeds,0,0,D,37,54,57,-7,0.42105263157894735,52,53,-1,0.40540540540540543,37,68,67,28,0.4736842105263158,58,43,15,0.5675675675675675,0,0,1,0,0,0,0,0,0.4,0.4,-14,-10,-35,-0.052631578947368474,-0.16216216216216212,-16
