Date,HomeTeam,AwayTeam,FTHG,FTAG,FTR,HT_match_played,HT_current_standing,HT_past_standing,HT_past_goal_diff,HT_past_win_rate,HT_goal_for,HT_goal_against,HT_goal_diff,HT_win_rate_season,AT_match_played,AT_current_standing,AT_past_standing,AT_past_goal_diff,AT_past_win_rate,AT_goal_for,AT_goal_against,AT_goal_diff,AT_win_rate_season,HT_3_win_streak,HT_5_win_streak,HT_3_lose_Streak,HT_5_lose_Streak,AT_3_win_streak,AT_5_win_streak,AT_3_lose_Streak,AT_5_lose_Streak,HT_5_win_rate,AT_5_win_rate,current_standing_diff,past_standing_diff,past_goal_diff_diff,past_win_rate_diff,win_rate_season_diff,goal_diff_diff
2001-08-18,Charlton,Everton,1,2,A,0,0,52,-7,0.3684210526315789,0,0,0,,0,0,42,-14,0.2894736842105263,0,0,0,,0,0,0,0,0,0,0,0,,,0,10,7,0.0789473684210526,,0
2001-08-18,Derby,Blackburn,2,1,H,0,0,42,-22,0.2631578947368421,0,0,0,,0,0,-1,-1,0.0,0,0,0,,0,0,0,0,0,0,0,0,,,0,43,-21,0.2631578947368421,,0
2001-08-18,Leeds,Southampton,2,0,H,0,0,68,21,0.5263157894736842,0,0,0,,0,0,52,-8,0.3684210526315789,0,0,0,,0,0,0,0,0,0,0,0,,,0,16,29,0.15789473684210525,,0
2001-08-18,Leicester,Bolton,0,5,A,0,0,48,-12,0.3684210526315789,0,0,0,,0,0,-1,-1,0.0,0,0,0,,0,0,0,0,0,0,0,0,,,0,49,-11,0.3684210526315789,,0
2001-08-18,Liverpool,West Ham,2,1,H,0,0,69,32,0.5263157894736842,0,0,0,,0,0,42,-5,0.2631578947368421,0,0,0,,0,0,0,0,0,0,0,0,,,0,27,37,0.2631578947368421,,0
2001-08-18,Middlesbrough,Arsenal,0,4,A,0,0,42,0,0.2368421052631579,0,0,0,,0,0,70,25,0.5263157894736842,0,0,0,,0,0,0,0,0,0,0,0,,,0,-28,-25,-0.28947368421052627,,0
2001-08-18,Sunderland,Ipswich,1,0,H,0,0,57,5,0.3947368421052632,0,0,0,,0,0,66,15,0.5263157894736842,0,0,0,,0,0,0,0,0,0,0,0,,,0,-9,-10,-0.13157894736842096,,0
2001-08-18,Tottenham,Aston Villa,0,0,D,0,0,49,-7,0.34210526315789475,0,0,0,,0,0,54,3,0.34210526315789475,0,0,0,,0,0,0,0,0,0,0,0,,,0,-5,-10,0.0,,0
2001-08-19,Chelsea,Newcastle,1,1,D,0,0,61,23,0.4473684210526316,0,0,0,,0,0,51,-6,0.3684210526315789,0,0,0,,0,0,0,0,0,0,0,0,,,0,10,29,0.07894736842105265,,0
2001-08-19,Man United,Fulham,3,2,H,0,0,80,48,0.631578947368421,0,0,0,,0,0,-1,-1,0.0,0,0,0,,0,0,0,0,0,0,0,0,,,0,81,49,0.631578947368421,,0
2001-08-20,Everton,Tottenham,1,1,D,1,3,42,-14,0.2894736842105263,2,1,1,1.0,1,1,49,-7,0.34210526315789475,0,0,0,0.0,0,0,0,0,0,0,0,0,,,2,-7,-7,-0.05263157894736842,1.0,1
2001-08-21,Arsenal,Leeds,1,2,A,1,3,70,25,0.5263157894736842,4,0,4,1.0,1,3,68,21,0.5263157894736842,2,0,2,1.0,0,0,0,0,0,0,0,0,,,0,2,4,0.0,0.0,2
2001-08-21,Bolton,Middlesbrough,1,0,H,1,3,-1,-1,0.0,5,0,5,1.0,1,0,42,0,0.2368421052631579,0,4,-4,0.0,0,0,0,0,0,0,0,0,,,3,-43,-1,-0.2368421052631579,1.0,9
2001-08-21,Ipswich,Derby,3,1,H,1,0,66,15,0.5263157894736842,0,1,-1,0.0,1,3,42,-22,0.2631578947368421,2,1,1,1.0,0,0,0,0,0,0,0,0,,,-3,24,37,0.2631578947368421,-1.0,-2
2001-08-22,Blackburn,Man United,2,2,D,1,0,-1,-1,0.0,1,2,-1,0.0,1,3,80,48,0.631578947368421,3,2,1,1.0,0,0,0,0,0,0,0,0,,,-3,-81,-49,-0.631578947368421,-1.0,-2
2001-08-22,Fulham,Sunderland,2,0,H,1,0,-1,-1,0.0,2,3,-1,0.0,1,3,57,5,0.3947368421052632,1,0,1,1.0,0,0,0,0,0,0,0,0,,,-3,-58,-6,-0.3947368421052632,-1.0,-2
2001-08-25,Arsenal,Leicester,4,0,H,2,3,70,25,0.5263157894736842,5,2,3,0.5,1,0,48,-12,0.3684210526315789,0,5,-5,0.0,0,0,0,0,0,0,0,0,,,3,22,37,0.15789473684210525,0.5,8
2001-08-25,Blackburn,Tottenham,2,1,H,2,1,-1,-1,0.0,3,4,-1,0.0,2,2,49,-7,0.34210526315789475,1,1,0,0.0,0,0,0,0,0,0,0,0,,,-1,-50,6,-0.34210526315789475,0.0,-1
2001-08-25,Everton,Middlesbrough,2,0,H,2,4,42,-14,0.2894736842105263,3,2,1,0.5,2,0,42,0,0.2368421052631579,0,5,-5,0.0,0,0,0,0,0,0,0,0,,,4,0,-14,0.05263157894736842,0.5,6
2001-08-25,Fulham,Derby,0,0,D,2,3,-1,-1,0.0,4,3,1,0.5,2,3,42,-22,0.2631578947368421,3,4,-1,0.5,0,0,0,0,0,0,0,0,,,0,-43,21,-0.2631578947368421,0.0,2
2001-08-25,Ipswich,Charlton,0,1,A,2,3,66,15,0.5263157894736842,3,2,1,0.5,1,0,52,-7,0.3684210526315789,1,2,-1,0.0,0,0,0,0,0,0,0,0,,,3,14,22,0.15789473684210525,0.5,2
2001-08-25,Southampton,Chelsea,0,2,A,1,0,52,-8,0.3684210526315789,0,2,-2,0.0,1,1,61,23,0.4473684210526316,1,1,0,0.0,0,0,0,0,0,0,0,0,,,-1,-9,-31,-0.07894736842105265,0.0,-2
2001-08-25,West Ham,Leeds,0,0,D,1,0,42,-5,0.2631578947368421,1,2,-1,0.0,2,6,68,21,0.5263157894736842,4,1,3,1.0,0,0,0,0,0,0,0,0,,,-6,-26,-26,-0.2631578947368421,-1.0,-4
2001-08-26,Aston Villa,Man United,1,1,D,1,1,54,3,0.34210526315789475,0,0,0,0.0,2,4,80,48,0.631578947368421,5,4,1,0.5,0,0,0,0,0,0,0,0,,,-3,-26,-45,-0.28947368421052627,-0.5,-1
2001-08-26,Newcastle,Sunderland,1,1,D,1,1,51,-6,0.3684210526315789,1,1,0,0.0,2,3,57,5,0.3947368421052632,1,2,-1,0.5,0,0,0,0,0,0,0,0,,,-2,-6,-11,-0.026315789473684292,-0.5,1
2001-08-27,Bolton,Liverpool,2,1,H,2,6,-1,-1,0.0,6,0,6,1.0,1,3,69,32,0.5263157894736842,2,1,1,1.0,0,0,0,0,0,0,0,0,,,3,-70,-33,-0.5263157894736842,0.0,5
2001-09-08,Chelsea,Arsenal,1,1,D,2,4,61,23,0.4473684210526316,3,1,2,0.5,3,6,70,25,0.5263157894736842,9,2,7,0.6666666666666666,0,0,0,0,0,0,0,0,,,-2,-9,-2,-0.0789473684210526,-0.16666666666666663,-5
2001-09-08,Derby,West Ham,0,0,D,3,4,42,-22,0.2631578947368421,3,4,-1,0.3333333333333333,2,1,42,-5,0.2631578947368421,1,2,-1,0.0,0,0,0,0,0,0,0,0,,,3,0,-17,0.0,0.3333333333333333,0
2001-09-08,Leeds,Bolton,0,0,D,3,7,68,21,0.5263157894736842,4,1,3,0.6666666666666666,3,9,-1,-1,0.0,8,1,7,1.0,0,0,0,0,0,0,0,0,,,-2,69,22,0.5263157894736842,-0.33333333333333337,-4
2001-09-08,Leicester,Ipswich,1,1,D,2,0,48,-12,0.3684210526315789,0,9,-9,0.0,3,3,66,15,0.5263157894736842,3,3,0,0.3333333333333333,0,0,0,0,0,0,0,0,,,-3,-18,-27,-0.15789473684210525,-0.3333333333333333,-9
2001-09-08,Liverpool,Aston Villa,1,3,A,2,3,69,32,0.5263157894736842,3,3,0,0.5,2,2,54,3,0.34210526315789475,1,1,0,0.0,0,0,0,0,0,0,0,0,,,1,15,29,0.18421052631578944,0.5,0
2001-09-08,Man United,Everton,4,1,H,3,5,80,48,0.631578947368421,6,5,1,0.3333333333333333,3,7,42,-14,0.2894736842105263,5,2,3,0.6666666666666666,0,0,0,0,0,0,0,0,,,-2,38,62,0.3421052631578947,-0.3333333333333333,-2
2001-09-08,Middlesbrough,Newcastle,1,4,A,3,0,42,0,0.2368421052631579,0,7,-7,0.0,2,2,51,-6,0.3684210526315789,2,2,0,0.0,0,0,0,0,0,0,0,0,,,-2,-9,6,-0.13157894736842102,0.0,-7
2001-09-08,Sunderland,Blackburn,1,0,H,3,4,57,5,0.3947368421052632,2,3,-1,0.3333333333333333,3,4,-1,-1,0.0,5,5,0,0.3333333333333333,0,0,0,0,0,0,0,0,,,0,58,6,0.3947368421052632,0.0,-1
2001-09-09,Charlton,Fulham,1,1,D,2,3,52,-7,0.3684210526315789,2,2,0,0.5,3,4,-1,-1,0.0,4,3,1,0.3333333333333333,0,0,0,0,0,0,0,0,,,-1,53,-6,0.3684210526315789,0.16666666666666669,-1
2001-09-09,Tottenham,Southampton,2,0,H,3,2,49,-7,0.34210526315789475,2,3,-1,0.0,2,0,52,-8,0.3684210526315789,0,4,-4,0.0,0,0,0,0,0,0,0,0,,,2,-3,1,-0.02631578947368418,0.0,3
2001-09-15,Bolton,Southampton,0,1,A,4,10,-1,-1,0.0,8,1,7,0.75,3,0,52,-8,0.3684210526315789,0,6,-6,0.0,0,0,0,0,0,0,0,0,,,10,-53,7,-0.3684210526315789,0.75,13
2001-09-15,Derby,Leicester,2,3,A,4,5,42,-22,0.2631578947368421,3,4,-1,0.25,3,1,48,-12,0.3684210526315789,1,10,-9,0.0,0,0,0,0,0,0,0,0,,,4,-6,-10,-0.10526315789473684,0.25,8
2001-09-15,Everton,Liverpool,1,3,A,4,7,42,-14,0.2894736842105263,6,6,0,0.5,3,3,69,32,0.5263157894736842,4,6,-2,0.3333333333333333,0,0,0,0,0,0,0,0,,,4,-27,-46,-0.23684210526315785,0.16666666666666669,2
2001-09-15,Fulham,Arsenal,1,3,A,4,5,-1,-1,0.0,5,4,1,0.25,4,7,70,25,0.5263157894736842,10,3,7,0.5,0,0,0,0,0,0,0,0,,,-2,-71,-26,-0.5263157894736842,-0.25,-6
2001-09-15,Middlesbrough,West Ham,2,0,H,4,0,42,0,0.2368421052631579,1,11,-10,0.0,3,2,42,-5,0.2631578947368421,1,2,-1,0.0,0,0,1,0,0,0,0,0,,,-2,0,5,-0.02631578947368418,0.0,-9
2001-09-15,Newcastle,Man United,4,3,H,3,5,51,-6,0.3684210526315789,6,3,3,0.3333333333333333,4,8,80,48,0.631578947368421,10,6,4,0.5,0,0,0,0,0,0,0,0,,,-3,-29,-54,-0.2631578947368421,-0.16666666666666669,-1
2001-09-16,Aston Villa,Sunderland,0,0,D,3,5,54,3,0.34210526315789475,4,2,2,0.3333333333333333,4,7,57,5,0.3947368421052632,3,3,0,0.5,0,0,0,0,0,0,0,0,,,-2,-3,-2,-0.052631578947368474,-0.16666666666666669,2
2001-09-16,Charlton,Leeds,0,2,A,3,4,52,-7,0.3684210526315789,3,3,0,0.3333333333333333,4,8,68,21,0.5263157894736842,4,1,3,0.5,0,0,0,0,0,0,0,0,,,-4,-16,-28,-0.15789473684210525,-0.16666666666666669,-3
2001-09-16,Ipswich,Blackburn,1,1,D,4,4,66,15,0.5263157894736842,4,4,0,0.25,4,4,-1,-1,0.0,5,6,-1,0.25,0,0,0,0,0,0,0,0,,,0,67,16,0.5263157894736842,0.0,1
2001-09-16,Tottenham,Chelsea,2,3,A,4,5,49,-7,0.34210526315789475,4,3,1,0.25,3,5,61,23,0.4473684210526316,4,2,2,0.3333333333333333,0,0,0,0,0,0,0,0,,,0,-12,-30,-0.10526315789473684,-0.08333333333333331,-1
2001-09-17,Leicester,Middlesbrough,1,2,A,4,4,48,-12,0.3684210526315789,4,12,-8,0.25,5,3,42,0,0.2368421052631579,3,11,-8,0.2,0,0,0,0,0,0,0,0,,0.2,1,6,-12,0.13157894736842102,0.04999999999999999,0
2001-09-19,Blackburn,Bolton,1,1,D,5,5,-1,-1,0.0,6,7,-1,0.2,5,10,-1,-1,0.0,8,2,6,0.6,0,0,0,0,0,0,0,0,0.2,0.6,-5,0,0,0.0,-0.39999999999999997,-7
2001-09-19,Sunderland,Tottenham,1,2,A,5,8,57,5,0.3947368421052632,3,3,0,0.4,5,5,49,-7,0.34210526315789475,6,6,0,0.2,0,0,0,0,0,0,0,0,0.4,0.2,3,8,12,0.052631578947368474,0.2,0
2001-09-22,Arsenal,Bolton,1,1,D,5,10,70,25,0.5263157894736842,13,4,9,0.6,6,11,-1,-1,0.0,9,3,6,0.5,0,0,0,0,0,0,0,0,0.6,0.4,-1,71,26,0.5263157894736842,0.09999999999999998,3
2001-09-22,Blackburn,Everton,1,0,H,6,6,-1,-1,0.0,7,8,-1,0.16666666666666666,5,7,42,-14,0.2894736842105263,7,9,-2,0.4,0,0,0,0,0,0,0,0,0.2,0.4,-1,-43,13,-0.2894736842105263,-0.23333333333333336,1
2001-09-22,Leicester,Fulham,0,0,D,5,4,48,-12,0.3684210526315789,5,14,-9,0.2,5,5,-1,-1,0.0,6,7,-1,0.2,0,0,0,0,0,0,0,0,0.2,0.2,-1,49,-11,0.3684210526315789,0.0,-8
2001-09-22,Liverpool,Tottenham,1,0,H,4,6,69,32,0.5263157894736842,7,7,0,0.5,6,8,49,-7,0.34210526315789475,8,7,1,0.3333333333333333,0,0,0,0,0,0,0,0,,0.4,-2,20,39,0.18421052631578944,0.16666666666666669,-1
2001-09-22,Man United,Ipswich,4,0,H,5,8,80,48,0.631578947368421,13,10,3,0.4,5,5,66,15,0.5263157894736842,5,5,0,0.2,0,0,0,0,0,0,0,0,0.4,0.2,3,14,33,0.10526315789473684,0.2,3
2001-09-22,Sunderland,Charlton,2,2,D,6,8,57,5,0.3947368421052632,4,5,-1,0.3333333333333333,4,4,52,-7,0.3684210526315789,3,5,-2,0.25,0,0,0,0,0,0,0,0,0.2,,4,5,12,0.026315789473684292,0.08333333333333331,1
2001-09-23,Chelsea,Middlesbrough,2,2,D,4,8,61,23,0.4473684210526316,7,4,3,0.5,6,6,42,0,0.2368421052631579,5,12,-7,0.3333333333333333,0,0,0,0,0,0,0,0,,0.4,2,19,23,0.21052631578947367,0.16666666666666669,10
2001-09-23,Leeds,Derby,3,0,H,5,11,68,21,0.5263157894736842,6,1,5,0.6,5,5,42,-22,0.2631578947368421,5,7,-2,0.2,0,0,0,0,0,0,0,0,0.6,0.2,6,26,43,0.2631578947368421,0.39999999999999997,7
2001-09-23,West Ham,Newcastle,3,0,H,4,2,42,-5,0.2631578947368421,1,4,-3,0.0,4,8,51,-6,0.3684210526315789,10,6,4,0.5,0,0,0,0,0,0,0,0,,,-6,-9,1,-0.10526315789473684,-0.5,-7
2001-09-24,Southampton,Aston Villa,1,3,A,4,3,52,-8,0.3684210526315789,1,6,-5,0.25,4,6,54,3,0.34210526315789475,4,2,2,0.25,0,0,0,0,0,0,0,0,,,-3,-2,-11,0.02631578947368418,0.0,-7
2001-09-26,Newcastle,Leicester,1,0,H,5,8,51,-6,0.3684210526315789,10,9,1,0.4,6,5,48,-12,0.3684210526315789,5,14,-9,0.16666666666666666,0,0,0,0,0,0,0,0,0.4,0.2,3,3,6,0.0,0.23333333333333336,10
2001-09-29,Bolton,Sunderland,0,2,A,7,12,-1,-1,0.0,10,4,6,0.42857142857142855,7,9,57,5,0.3947368421052632,6,7,-1,0.2857142857142857,0,0,0,0,0,0,0,0,0.2,0.2,3,-58,-6,-0.3947368421052632,0.14285714285714285,7
2001-09-29,Charlton,Leicester,2,0,H,5,5,52,-7,0.3684210526315789,5,7,-2,0.2,7,5,48,-12,0.3684210526315789,5,15,-10,0.14285714285714285,0,0,0,0,0,0,0,0,0.2,0.2,0,4,5,0.0,0.05714285714285716,8
2001-09-29,Derby,Arsenal,0,2,A,6,5,42,-22,0.2631578947368421,5,10,-5,0.16666666666666666,6,11,70,25,0.5263157894736842,14,5,9,0.5,0,0,0,0,0,0,0,0,0.0,0.4,-6,-28,-47,-0.2631578947368421,-0.33333333333333337,-14
2001-09-29,Everton,West Ham,5,0,H,6,7,42,-14,0.2894736842105263,7,10,-3,0.3333333333333333,5,5,42,-5,0.2631578947368421,4,4,0,0.2,0,0,1,0,0,0,0,0,0.2,0.2,2,0,-9,0.026315789473684237,0.1333333333333333,-3
2001-09-29,Middlesbrough,Southampton,1,3,A,7,7,42,0,0.2368421052631579,7,14,-7,0.2857142857142857,5,3,52,-8,0.3684210526315789,2,9,-7,0.2,0,0,0,0,0,0,0,0,0.4,0.2,4,-10,8,-0.13157894736842102,0.08571428571428569,0
2001-09-29,Tottenham,Man United,3,5,A,7,8,49,-7,0.34210526315789475,8,8,0,0.2857142857142857,6,11,80,48,0.631578947368421,17,10,7,0.5,0,0,0,0,0,0,0,0,0.4,0.4,-3,-31,-55,-0.28947368421052627,-0.2142857142857143,-7
2001-09-30,Aston Villa,Blackburn,2,0,H,5,9,54,3,0.34210526315789475,7,3,4,0.4,7,9,-1,-1,0.0,8,8,0,0.2857142857142857,0,0,0,0,0,0,0,0,0.4,0.4,0,55,4,0.34210526315789475,0.11428571428571432,4
2001-09-30,Fulham,Chelsea,1,1,D,6,6,-1,-1,0.0,6,7,-1,0.16666666666666666,5,9,61,23,0.4473684210526316,9,6,3,0.4,0,0,0,0,0,0,0,0,0.2,0.4,-3,-62,-24,-0.4473684210526316,-0.23333333333333336,-4
2001-09-30,Ipswich,Leeds,1,2,A,6,5,66,15,0.5263157894736842,5,9,-4,0.16666666666666666,6,14,68,21,0.5263157894736842,9,1,8,0.6666666666666666,0,0,0,0,0,0,0,0,0.2,0.6,-9,-2,-6,0.0,-0.5,-12
2001-09-30,Newcastle,Liverpool,0,2,A,6,11,51,-6,0.3684210526315789,11,9,2,0.5,5,9,69,32,0.5263157894736842,8,7,1,0.6,0,0,0,0,0,0,0,0,0.6,0.6,2,-18,-38,-0.15789473684210525,-0.09999999999999998,1
2001-10-13,Bolton,Newcastle,0,4,A,8,12,-1,-1,0.0,10,6,4,0.375,7,11,51,-6,0.3684210526315789,11,11,0,0.42857142857142855,0,0,0,0,0,0,0,0,0.0,0.6,1,-52,5,-0.3684210526315789,-0.05357142857142855,4
2001-10-13,Charlton,Middlesbrough,0,0,D,6,8,52,-7,0.3684210526315789,7,7,0,0.3333333333333333,8,7,42,0,0.2368421052631579,8,17,-9,0.25,0,0,0,0,0,0,0,0,0.4,0.4,1,10,-7,0.13157894736842102,0.08333333333333331,9
2001-10-13,Chelsea,Leicester,2,0,H,6,10,61,23,0.4473684210526316,10,7,3,0.3333333333333333,8,5,48,-12,0.3684210526315789,5,17,-12,0.125,0,0,0,0,0,0,0,0,0.4,0.2,5,13,35,0.07894736842105265,0.20833333333333331,15
2001-10-13,Ipswich,Everton,0,0,D,7,5,66,15,0.5263157894736842,6,11,-5,0.14285714285714285,7,10,42,-14,0.2894736842105263,12,10,2,0.42857142857142855,0,0,0,0,0,0,0,0,0.0,0.4,-5,24,29,0.23684210526315785,-0.2857142857142857,-7
2001-10-13,Liverpool,Leeds,1,1,D,6,12,69,32,0.5263157894736842,10,7,3,0.6666666666666666,7,17,68,21,0.5263157894736842,11,2,9,0.7142857142857143,1,0,0,0,1,0,0,0,0.6,0.6,-5,1,11,0.0,-0.04761904761904767,-6
2001-10-13,Southampton,Arsenal,0,2,A,6,6,52,-8,0.3684210526315789,5,10,-5,0.3333333333333333,7,14,70,25,0.5263157894736842,16,5,11,0.5714285714285714,0,0,0,0,0,0,0,0,0.4,0.6,-8,-18,-33,-0.15789473684210525,-0.23809523809523808,-16
2001-10-13,Sunderland,Man United,1,3,A,8,12,57,5,0.3947368421052632,8,7,1,0.375,7,14,80,48,0.631578947368421,22,13,9,0.5714285714285714,0,0,0,0,0,0,0,0,0.4,0.6,-2,-23,-43,-0.2368421052631578,-0.1964285714285714,-8
2001-10-14,Aston Villa,Fulham,2,0,H,6,12,54,3,0.34210526315789475,9,3,6,0.5,7,7,-1,-1,0.0,7,8,-1,0.14285714285714285,0,0,0,0,0,0,0,0,0.6,0.0,5,55,4,0.34210526315789475,0.35714285714285715,7
2001-10-14,Blackburn,West Ham,7,1,H,8,9,-1,-1,0.0,8,10,-2,0.25,6,5,42,-5,0.2631578947368421,4,9,-5,0.16666666666666666,0,0,0,0,0,0,0,0,0.2,0.2,4,-43,4,-0.2631578947368421,0.08333333333333334,3
2001-10-15,Tottenham,Derby,3,1,H,8,8,49,-7,0.34210526315789475,11,13,-2,0.25,7,5,42,-22,0.2631578947368421,5,12,-7,0.14285714285714285,0,0,0,0,0,0,1,0,0.4,0.0,3,7,15,0.07894736842105265,0.10714285714285715,5
2001-10-20,Arsenal,Blackburn,3,3,D,8,17,70,25,0.5263157894736842,18,5,13,0.625,9,12,-1,-1,0.0,15,11,4,0.3333333333333333,0,0,0,0,0,0,0,0,0.6,0.4,5,71,26,0.5263157894736842,0.2916666666666667,9
2001-10-20,Derby,Charlton,1,1,D,8,5,42,-22,0.2631578947368421,6,15,-9,0.125,7,9,52,-7,0.3684210526315789,7,7,0,0.2857142857142857,0,0,1,0,0,0,0,0,0.0,0.2,-4,-10,-15,-0.10526315789473684,-0.1607142857142857,-9
2001-10-20,Everton,Aston Villa,3,2,H,8,11,42,-14,0.2894736842105263,12,10,2,0.375,7,15,54,3,0.34210526315789475,11,3,8,0.5714285714285714,0,0,0,0,1,0,0,0,0.2,0.8,-4,-12,-17,-0.05263157894736842,-0.1964285714285714,-6
2001-10-20,Leicester,Liverpool,1,4,A,9,5,48,-12,0.3684210526315789,5,19,-14,0.1111111111111111,7,13,69,32,0.5263157894736842,11,8,3,0.5714285714285714,0,0,1,0,0,0,0,0,0.0,0.6,-8,-21,-44,-0.15789473684210525,-0.4603174603174603,-17
2001-10-20,Man United,Bolton,1,2,A,8,17,80,48,0.631578947368421,25,14,11,0.625,9,12,-1,-1,0.0,10,10,0,0.3333333333333333,1,0,0,0,0,0,0,0,0.8,0.0,5,81,49,0.631578947368421,0.2916666666666667,11
2001-10-20,West Ham,Southampton,2,0,H,7,5,42,-5,0.2631578947368421,5,16,-11,0.14285714285714285,7,6,52,-8,0.3684210526315789,5,12,-7,0.2857142857142857,0,0,0,0,0,0,0,0,0.2,0.4,-1,-10,3,-0.10526315789473684,-0.14285714285714285,-4
2001-10-21,Fulham,Ipswich,1,1,D,8,7,-1,-1,0.0,7,10,-3,0.125,8,6,66,15,0.5263157894736842,6,11,-5,0.125,0,0,0,0,0,0,0,0,0.0,0.0,1,-67,-16,-0.5263157894736842,0.0,2
2001-10-21,Leeds,Chelsea,0,0,D,8,18,68,21,0.5263157894736842,12,3,9,0.625,7,13,61,23,0.4473684210526316,12,7,5,0.42857142857142855,0,0,0,0,0,0,0,0,0.6,0.4,5,7,-2,0.0789473684210526,0.19642857142857145,4
2001-10-21,Newcastle,Tottenham,0,2,A,8,14,51,-6,0.3684210526315789,15,11,4,0.5,9,11,49,-7,0.34210526315789475,14,14,0,0.3333333333333333,0,0,0,0,0,0,0,0,0.6,0.4,3,2,1,0.02631578947368418,0.16666666666666669,4
2001-10-22,Middlesbrough,Sunderland,2,0,H,9,8,42,0,0.2368421052631579,8,17,-9,0.2222222222222222,9,12,57,5,0.3947368421052632,9,10,-1,0.3333333333333333,0,0,0,0,0,0,0,0,0.4,0.2,-4,-15,-5,-0.1578947368421053,-0.1111111111111111,-8
2001-10-24,Aston Villa,Charlton,1,0,H,8,15,54,3,0.34210526315789475,13,6,7,0.5,8,10,52,-7,0.3684210526315789,8,8,0,0.25,0,0,0,0,0,0,0,0,0.6,0.2,5,2,10,-0.02631578947368418,0.25,7
2001-10-24,Southampton,Ipswich,3,3,D,8,6,52,-8,0.3684210526315789,5,14,-9,0.25,9,7,66,15,0.5263157894736842,7,12,-5,0.1111111111111111,0,0,0,0,0,0,0,0,0.4,0.0,-1,-14,-23,-0.15789473684210525,0.1388888888888889,-4
2001-10-24,West Ham,Chelsea,2,1,H,8,8,42,-5,0.2631578947368421,7,16,-9,0.25,8,14,61,23,0.4473684210526316,12,7,5,0.375,0,0,0,0,0,0,0,0,0.4,0.4,-6,-19,-28,-0.1842105263157895,-0.125,-14
2001-10-27,Aston Villa,Bolton,3,2,H,9,18,54,3,0.34210526315789475,14,6,8,0.5555555555555556,10,15,-1,-1,0.0,12,11,1,0.4,0,0,0,0,0,0,0,0,0.8,0.2,3,55,4,0.34210526315789475,0.15555555555555556,7
2001-10-27,Charlton,Liverpool,0,2,A,9,10,52,-7,0.3684210526315789,8,9,-1,0.2222222222222222,8,16,69,32,0.5263157894736842,15,9,6,0.625,0,0,0,0,0,0,0,0,0.2,0.8,-6,-17,-39,-0.15789473684210525,-0.4027777777777778,-7
2001-10-27,Everton,Newcastle,1,3,A,9,14,42,-14,0.2894736842105263,15,12,3,0.4444444444444444,9,14,51,-6,0.3684210526315789,15,13,2,0.4444444444444444,0,0,0,0,0,0,0,0,0.4,0.4,0,-9,-8,-0.0789473684210526,0.0,1
2001-10-27,Fulham,Southampton,2,1,H,9,8,-1,-1,0.0,8,11,-3,0.1111111111111111,9,7,52,-8,0.3684210526315789,8,17,-9,0.2222222222222222,0,0,0,0,0,0,0,0,0.0,0.2,1,-53,7,-0.3684210526315789,-0.1111111111111111,6
2001-10-27,Man United,Leeds,1,1,D,9,17,80,48,0.631578947368421,26,16,10,0.5555555555555556,9,19,68,21,0.5263157894736842,12,3,9,0.5555555555555556,0,0,0,0,0,0,0,0,0.6,0.6,-2,12,27,0.10526315789473684,0.0,1
2001-10-27,Sunderland,Arsenal,1,1,D,10,12,57,5,0.3947368421052632,9,12,-3,0.3,9,18,70,25,0.5263157894736842,21,8,13,0.5555555555555556,0,0,0,0,0,0,0,0,0.2,0.6,-6,-13,-20,-0.13157894736842096,-0.2555555555555556,-16
2001-10-27,Tottenham,Middlesbrough,2,1,H,10,14,49,-7,0.34210526315789475,16,14,2,0.4,10,11,42,0,0.2368421052631579,10,17,-7,0.3,0,0,0,0,0,0,0,0,0.6,0.4,3,7,-7,0.10526315789473684,0.10000000000000003,9
2001-10-28,Derby,Chelsea,1,1,D,9,6,42,-22,0.2631578947368421,7,16,-9,0.1111111111111111,9,14,61,23,0.4473684210526316,13,9,4,0.3333333333333333,0,0,0,0,0,0,0,0,0.0,0.2,-8,-19,-45,-0.1842105263157895,-0.2222222222222222,-13
2001-10-28,Ipswich,West Ham,2,3,A,10,8,66,15,0.5263157894736842,10,15,-5,0.1,9,11,42,-5,0.2631578947368421,9,17,-8,0.3333333333333333,0,0,0,0,0,0,0,0,0.0,0.6,-3,24,20,0.2631578947368421,-0.2333333333333333,3
2001-10-29,Blackburn,Leicester,0,0,D,10,13,-1,-1,0.0,18,14,4,0.3,10,5,48,-12,0.3684210526315789,6,23,-17,0.1,0,0,0,0,0,0,1,0,0.4,0.0,8,-49,11,-0.3684210526315789,0.19999999999999998,21
2001-11-03,Bolton,Everton,2,2,D,11,15,-1,-1,0.0,14,14,0,0.36363636363636365,10,14,42,-14,0.2894736842105263,16,15,1,0.4,0,0,0,0,0,0,0,0,0.2,0.4,1,-43,13,-0.2894736842105263,-0.036363636363636376,-1
2001-11-03,Leicester,Sunderland,1,0,H,11,6,48,-12,0.3684210526315789,6,23,-17,0.09090909090909091,11,13,57,5,0.3947368421052632,10,13,-3,0.2727272727272727,0,0,0,0,0,0,0,0,0.0,0.2,-7,-9,-17,-0.026315789473684292,-0.1818181818181818,-14
2001-11-03,Middlesbrough,Derby,5,1,H,11,11,42,0,0.2368421052631579,11,19,-8,0.2727272727272727,10,7,42,-22,0.2631578947368421,8,17,-9,0.1,0,0,0,0,0,0,0,0,0.2,0.0,4,0,22,-0.02631578947368418,0.1727272727272727,1
2001-11-03,Newcastle,Aston Villa,3,0,H,10,17,51,-6,0.3684210526315789,18,14,4,0.5,10,21,54,3,0.34210526315789475,17,8,9,0.6,0,0,0,0,0,0,0,0,0.6,0.8,-4,-3,-9,0.02631578947368418,-0.09999999999999998,-5
2001-11-03,Southampton,Blackburn,1,2,A,10,7,52,-8,0.3684210526315789,9,19,-10,0.2,11,14,-1,-1,0.0,18,14,4,0.2727272727272727,0,0,0,0,0,0,0,0,0.2,0.4,-7,53,-7,0.3684210526315789,-0.0727272727272727,-14
2001-11-03,West Ham,Fulham,0,2,A,10,14,42,-5,0.2631578947368421,12,19,-7,0.4,10,11,-1,-1,0.0,10,12,-2,0.2,1,0,0,0,0,0,0,0,0.6,0.2,3,43,-4,0.2631578947368421,0.2,-5
2001-11-04,Arsenal,Charlton,2,4,A,10,19,70,25,0.5263157894736842,22,9,13,0.5,10,10,52,-7,0.3684210526315789,8,11,-3,0.2,0,0,0,0,0,0,0,0,0.4,0.2,9,18,32,0.15789473684210525,0.3,16
2001-11-04,Chelsea,Ipswich,2,1,H,10,15,61,23,0.4473684210526316,14,10,4,0.3,11,8,66,15,0.5263157894736842,12,18,-6,0.09090909090909091,0,0,0,0,0,0,0,0,0.2,0.0,7,-5,8,-0.0789473684210526,0.20909090909090908,10
2001-11-04,Leeds,Tottenham,2,1,H,10,20,68,21,0.5263157894736842,13,4,9,0.5,11,17,49,-7,0.34210526315789475,18,15,3,0.45454545454545453,0,0,0,0,1,0,0,0,0.4,0.6,3,19,28,0.18421052631578944,0.04545454545454547,6
2001-11-04,Liverpool,Man United,3,1,H,9,19,69,32,0.5263157894736842,17,9,8,0.6666666666666666,10,18,80,48,0.631578947368421,27,17,10,0.5,0,0,0,0,0,0,0,0,0.8,0.6,1,-11,-16,-0.10526315789473684,0.16666666666666663,-2
2001-11-17,Aston Villa,Middlesbrough,0,0,D,11,21,54,3,0.34210526315789475,17,11,6,0.5454545454545454,12,14,42,0,0.2368421052631579,16,20,-4,0.3333333333333333,0,0,0,0,0,0,0,0,0.6,0.4,7,12,3,0.10526315789473684,0.2121212121212121,10
2001-11-17,Blackburn,Liverpool,1,1,D,12,17,-1,-1,0.0,20,15,5,0.3333333333333333,10,22,69,32,0.5263157894736842,20,10,10,0.7,0,0,0,0,1,0,0,0,0.4,0.8,-5,-70,-33,-0.5263157894736842,-0.36666666666666664,-5
2001-11-17,Derby,Southampton,1,0,H,11,7,42,-22,0.2631578947368421,9,22,-13,0.09090909090909091,11,7,52,-8,0.3684210526315789,10,21,-11,0.18181818181818182,0,0,0,0,0,0,0,0,0.0,0.0,0,-10,-14,-0.10526315789473684,-0.09090909090909091,-2
2001-11-17,Fulham,Newcastle,3,1,H,11,14,-1,-1,0.0,12,12,0,0.2727272727272727,11,20,51,-6,0.3684210526315789,21,14,7,0.5454545454545454,0,0,0,0,0,0,0,0,0.4,0.6,-6,-52,5,-0.3684210526315789,-0.2727272727272727,-7
2001-11-17,Man United,Leicester,2,0,H,11,18,80,48,0.631578947368421,28,20,8,0.45454545454545453,12,9,48,-12,0.3684210526315789,7,23,-16,0.16666666666666666,0,0,0,0,0,0,0,0,0.4,0.2,9,32,60,0.2631578947368421,0.28787878787878785,24
2001-11-17,Tottenham,Arsenal,1,1,D,12,17,49,-7,0.34210526315789475,19,17,2,0.4166666666666667,11,19,70,25,0.5263157894736842,24,13,11,0.45454545454545453,0,0,0,0,0,0,0,0,0.6,0.4,-2,-21,-32,-0.18421052631578944,-0.037878787878787845,-9
2001-11-18,Everton,Chelsea,0,0,D,11,15,42,-14,0.2894736842105263,18,17,1,0.36363636363636365,11,18,61,23,0.4473684210526316,16,11,5,0.36363636363636365,0,0,0,0,0,0,0,0,0.4,0.4,-3,-19,-37,-0.15789473684210525,0.0,-4
2001-11-18,Ipswich,Bolton,1,2,A,12,8,66,15,0.5263157894736842,13,20,-7,0.08333333333333333,12,16,-1,-1,0.0,16,16,0,0.3333333333333333,0,0,0,0,0,0,0,0,0.0,0.2,-8,67,16,0.5263157894736842,-0.25,-7
2001-11-18,Sunderland,Leeds,2,0,H,12,13,57,5,0.3947368421052632,10,14,-4,0.25,11,23,68,21,0.5263157894736842,15,5,10,0.5454545454545454,0,0,0,0,0,0,0,0,0.2,0.4,-10,-11,-16,-0.13157894736842096,-0.2954545454545454,-14
2001-11-19,Charlton,West Ham,4,4,D,11,13,52,-7,0.3684210526315789,12,13,-1,0.2727272727272727,11,14,42,-5,0.2631578947368421,12,21,-9,0.36363636363636365,0,0,0,0,0,0,0,0,0.2,0.6,-1,10,-2,0.10526315789473684,-0.09090909090909094,8
2001-11-24,Bolton,Fulham,0,0,D,13,19,-1,-1,0.0,18,17,1,0.38461538461538464,12,17,-1,-1,0.0,15,13,2,0.3333333333333333,0,0,0,0,1,0,0,0,0.4,0.6,2,0,0,0.0,0.05128205128205132,-1
2001-11-24,Chelsea,Blackburn,0,0,D,12,19,61,23,0.4473684210526316,16,11,5,0.3333333333333333,13,18,-1,-1,0.0,21,16,5,0.3076923076923077,0,0,0,0,0,0,0,0,0.2,0.4,1,62,24,0.4473684210526316,0.025641025641025605,0
2001-11-24,Leicester,Everton,0,0,D,13,9,48,-12,0.3684210526315789,7,25,-18,0.15384615384615385,12,16,42,-14,0.2894736842105263,18,17,1,0.3333333333333333,0,0,0,0,0,0,0,0,0.2,0.2,-7,6,2,0.0789473684210526,-0.17948717948717946,-19
2001-11-24,Newcastle,Derby,1,0,H,12,20,51,-6,0.3684210526315789,22,17,5,0.5,12,10,42,-22,0.2631578947368421,10,22,-12,0.16666666666666666,0,0,0,0,0,0,0,0,0.6,0.2,10,9,16,0.10526315789473684,0.33333333333333337,17
2001-11-24,Southampton,Charlton,1,0,H,12,7,52,-8,0.3684210526315789,10,22,-12,0.16666666666666666,12,14,52,-7,0.3684210526315789,16,17,-1,0.25,0,0,1,0,0,0,0,0,0.0,0.2,-7,0,-1,0.0,-0.08333333333333334,-11
2001-11-24,West Ham,Tottenham,0,1,A,12,15,42,-5,0.2631578947368421,16,25,-9,0.3333333333333333,13,18,49,-7,0.34210526315789475,20,18,2,0.38461538461538464,0,0,0,0,0,0,0,0,0.6,0.6,-3,-7,2,-0.07894736842105265,-0.05128205128205132,-11
2001-11-25,Arsenal,Man United,3,1,H,12,20,70,25,0.5263157894736842,25,14,11,0.4166666666666667,12,21,80,48,0.631578947368421,30,20,10,0.5,0,0,0,0,0,0,0,0,0.2,0.4,-1,-10,-23,-0.10526315789473684,-0.08333333333333331,1
2001-11-25,Leeds,Aston Villa,1,1,D,12,23,68,21,0.5263157894736842,15,7,8,0.5,12,22,54,3,0.34210526315789475,17,11,6,0.5,0,0,0,0,0,0,0,0,0.2,0.4,1,14,18,0.18421052631578944,0.0,2
2001-11-25,Liverpool,Sunderland,1,0,H,11,23,69,32,0.5263157894736842,21,11,10,0.6363636363636364,13,16,57,5,0.3947368421052632,12,14,-2,0.3076923076923077,0,0,0,0,0,0,0,0,0.6,0.2,7,12,27,0.13157894736842096,0.32867132867132864,12
2001-11-25,Middlesbrough,Ipswich,0,0,D,13,15,42,0,0.2368421052631579,16,20,-4,0.3076923076923077,13,8,66,15,0.5263157894736842,14,22,-8,0.07692307692307693,0,0,0,0,0,0,1,0,0.4,0.0,7,-24,-15,-0.28947368421052627,0.23076923076923078,4
2001-12-01,Aston Villa,Leicester,0,2,A,13,23,54,3,0.34210526315789475,18,12,6,0.46153846153846156,14,10,48,-12,0.3684210526315789,7,25,-18,0.14285714285714285,0,0,0,0,0,0,0,0,0.4,0.2,13,6,15,-0.02631578947368418,0.3186813186813187,24
2001-12-01,Blackburn,Middlesbrough,0,1,A,14,19,-1,-1,0.0,21,16,5,0.2857142857142857,14,16,42,0,0.2368421052631579,16,20,-4,0.2857142857142857,0,0,0,0,0,0,0,0,0.2,0.4,3,-43,-1,-0.2368421052631579,0.0,9
2001-12-01,Charlton,Newcastle,1,1,D,13,14,52,-7,0.3684210526315789,16,18,-2,0.23076923076923078,13,23,51,-6,0.3684210526315789,23,17,6,0.5384615384615384,0,0,0,0,0,0,0,0,0.2,0.6,-9,1,-1,0.0,-0.30769230769230765,-8
2001-12-01,Derby,Liverpool,0,1,A,13,10,42,-22,0.2631578947368421,10,23,-13,0.15384615384615385,12,26,69,32,0.5263157894736842,22,11,11,0.6666666666666666,0,0,0,0,0,0,0,0,0.2,0.8,-16,-27,-54,-0.2631578947368421,-0.5128205128205128,-24
2001-12-01,Ipswich,Arsenal,0,2,A,14,9,66,15,0.5263157894736842,14,22,-8,0.07142857142857142,13,23,70,25,0.5263157894736842,28,15,13,0.46153846153846156,0,0,0,0,0,0,0,0,0.0,0.2,-14,-4,-10,0.0,-0.39010989010989017,-21
2001-12-01,Man United,Chelsea,0,3,A,13,21,80,48,0.631578947368421,31,23,8,0.46153846153846156,13,20,61,23,0.4473684210526316,16,11,5,0.3076923076923077,0,0,0,0,0,0,0,0,0.2,0.2,1,19,25,0.18421052631578944,0.15384615384615385,3
2001-12-01,Sunderland,West Ham,1,0,H,14,16,57,5,0.3947368421052632,12,15,-3,0.2857142857142857,13,15,42,-5,0.2631578947368421,16,26,-10,0.3076923076923077,0,0,0,0,0,0,0,0,0.2,0.4,1,15,10,0.13157894736842113,-0.02197802197802201,7
2001-12-02,Everton,Southampton,2,0,H,13,17,42,-14,0.2894736842105263,18,17,1,0.3076923076923077,13,10,52,-8,0.3684210526315789,11,22,-11,0.23076923076923078,0,0,0,0,0,0,0,0,0.2,0.2,7,-10,-6,-0.0789473684210526,0.07692307692307693,12
2001-12-02,Fulham,Leeds,0,0,D,13,18,-1,-1,0.0,15,13,2,0.3076923076923077,13,24,68,21,0.5263157894736842,16,8,8,0.46153846153846156,0,0,0,0,0,0,0,0,0.6,0.2,-6,-69,-22,-0.5263157894736842,-0.15384615384615385,-6
2001-12-03,Tottenham,Bolton,3,2,H,14,21,49,-7,0.34210526315789475,21,18,3,0.42857142857142855,14,20,-1,-1,0.0,18,17,1,0.35714285714285715,0,0,0,0,0,0,0,0,0.6,0.4,1,50,-6,0.34210526315789475,0.0714285714285714,2
2001-12-05,Chelsea,Charlton,0,1,A,14,23,61,23,0.4473684210526316,19,11,8,0.35714285714285715,14,15,52,-7,0.3684210526315789,17,19,-2,0.21428571428571427,0,0,0,0,0,0,0,0,0.4,0.2,8,9,30,0.07894736842105265,0.14285714285714288,10
2001-12-05,West Ham,Aston Villa,1,1,D,14,15,42,-5,0.2631578947368421,16,27,-11,0.2857142857142857,14,23,54,3,0.34210526315789475,18,14,4,0.42857142857142855,0,0,0,0,0,0,0,0,0.2,0.2,-8,-12,-8,-0.07894736842105265,-0.14285714285714285,-15
2001-12-08,Charlton,Tottenham,3,1,H,15,18,52,-7,0.3684210526315789,18,19,-1,0.26666666666666666,15,24,49,-7,0.34210526315789475,24,20,4,0.4666666666666667,0,0,0,0,0,0,0,0,0.4,0.6,-6,3,0,0.02631578947368418,-0.2,-5
2001-12-08,Derby,Bolton,1,0,H,14,10,42,-22,0.2631578947368421,10,24,-14,0.14285714285714285,15,20,-1,-1,0.0,20,20,0,0.3333333333333333,0,0,0,0,0,0,0,0,0.2,0.2,-10,43,-21,0.2631578947368421,-0.19047619047619047,-14
2001-12-08,Fulham,Everton,2,0,H,14,19,-1,-1,0.0,15,13,2,0.2857142857142857,14,20,42,-14,0.2894736842105263,20,17,3,0.35714285714285715,0,0,0,0,0,0,0,0,0.6,0.2,-1,-43,13,-0.2894736842105263,-0.07142857142857145,-1
2001-12-08,Leicester,Southampton,0,4,A,15,13,48,-12,0.3684210526315789,9,25,-16,0.2,14,10,52,-8,0.3684210526315789,11,24,-13,0.21428571428571427,0,0,0,0,0,0,0,0,0.4,0.2,3,-4,-4,0.0,-0.014285714285714263,-3
2001-12-08,Liverpool,Middlesbrough,2,0,H,13,29,69,32,0.5263157894736842,23,11,12,0.6923076923076923,15,19,42,0,0.2368421052631579,17,20,-3,0.3333333333333333,0,0,0,0,0,0,0,0,0.8,0.4,10,27,32,0.28947368421052627,0.358974358974359,15
2001-12-08,Man United,West Ham,0,1,A,14,21,80,48,0.631578947368421,31,26,5,0.42857142857142855,15,16,42,-5,0.2631578947368421,17,28,-11,0.26666666666666666,0,0,0,0,0,0,0,0,0.2,0.0,5,38,53,0.3684210526315789,0.16190476190476188,16
2001-12-09,Arsenal,Aston Villa,3,2,H,14,26,70,25,0.5263157894736842,30,15,15,0.5,15,24,54,3,0.34210526315789475,19,15,4,0.4,0,0,0,0,0,0,0,0,0.4,0.0,2,16,22,0.18421052631578944,0.09999999999999998,11
2001-12-09,Blackburn,Leeds,1,2,A,15,19,-1,-1,0.0,21,17,4,0.26666666666666666,14,25,68,21,0.5263157894736842,16,8,8,0.42857142857142855,0,0,0,0,0,0,0,0,0.2,0.2,-6,-69,-22,-0.5263157894736842,-0.16190476190476188,-4
2001-12-09,Ipswich,Newcastle,0,1,A,15,9,66,15,0.5263157894736842,14,24,-10,0.06666666666666667,14,24,51,-6,0.3684210526315789,24,18,6,0.5,0,0,0,0,0,0,0,0,0.0,0.6,-15,15,21,0.15789473684210525,-0.43333333333333335,-16
2001-12-09,Sunderland,Chelsea,0,0,D,15,19,57,5,0.3947368421052632,13,15,-2,0.3333333333333333,15,23,61,23,0.4473684210526316,19,12,7,0.3333333333333333,0,0,0,0,0,0,0,0,0.4,0.4,-4,-4,-18,-0.05263157894736836,0.0,-9
2001-12-12,Liverpool,Fulham,0,0,D,14,32,69,32,0.5263157894736842,25,11,14,0.7142857142857143,15,22,-1,-1,0.0,17,13,4,0.3333333333333333,1,0,0,0,0,0,0,0,0.8,0.6,10,70,33,0.5263157894736842,0.380952380952381,10
2001-12-12,Man United,Derby,5,0,H,15,21,80,48,0.631578947368421,31,27,4,0.4,15,13,42,-22,0.2631578947368421,11,24,-13,0.2,0,0,1,0,0,0,0,0,0.2,0.4,8,38,70,0.3684210526315789,0.2,17
2001-12-15,Bolton,Charlton,0,0,D,16,20,-1,-1,0.0,20,21,-1,0.3125,16,21,52,-7,0.3684210526315789,21,20,1,0.3125,0,0,0,0,0,0,0,0,0.2,0.4,-1,-53,6,-0.3684210526315789,0.0,-2
2001-12-15,Everton,Derby,1,0,H,15,20,42,-14,0.2894736842105263,20,19,1,0.3333333333333333,16,13,42,-22,0.2631578947368421,11,29,-18,0.1875,0,0,0,0,0,0,0,0,0.2,0.4,7,0,8,0.026315789473684237,0.14583333333333331,19
2001-12-15,Middlesbrough,Man United,0,1,A,16,19,42,0,0.2368421052631579,17,22,-5,0.3125,16,24,80,48,0.631578947368421,36,27,9,0.4375,0,0,0,0,0,0,0,0,0.4,0.4,-5,-38,-48,-0.3947368421052631,-0.125,-14
2001-12-15,Newcastle,Blackburn,2,1,H,15,27,51,-6,0.3684210526315789,25,18,7,0.5333333333333333,16,19,-1,-1,0.0,22,19,3,0.25,0,0,0,0,0,0,0,0,0.6,0.2,8,52,-5,0.3684210526315789,0.2833333333333333,4
2001-12-15,Southampton,Sunderland,2,0,H,15,13,52,-8,0.3684210526315789,15,24,-9,0.26666666666666666,16,20,57,5,0.3947368421052632,13,15,-2,0.3125,0,0,0,0,0,0,0,0,0.4,0.4,-7,-5,-13,-0.026315789473684292,-0.04583333333333334,-7
2001-12-15,Tottenham,Fulham,4,0,H,16,24,49,-7,0.34210526315789475,25,23,2,0.4375,16,23,-1,-1,0.0,17,13,4,0.3125,0,0,0,0,0,0,0,0,0.4,0.4,1,50,-6,0.34210526315789475,0.125,-2
2001-12-15,West Ham,Arsenal,1,1,D,16,19,42,-5,0.2631578947368421,18,28,-10,0.3125,15,29,70,25,0.5263157894736842,33,17,16,0.5333333333333333,0,0,0,0,1,0,0,0,0.2,0.6,-10,-28,-30,-0.2631578947368421,-0.22083333333333333,-26
2001-12-16,Chelsea,Liverpool,4,0,H,16,24,61,23,0.4473684210526316,19,12,7,0.3125,15,33,69,32,0.5263157894736842,25,11,14,0.6666666666666666,0,0,0,0,0,0,0,0,0.2,0.6,-9,-8,-9,-0.0789473684210526,-0.35416666666666663,-7
2001-12-16,Leeds,Leicester,2,2,D,15,28,68,21,0.5263157894736842,18,9,9,0.4666666666666667,16,13,48,-12,0.3684210526315789,9,29,-20,0.1875,0,0,0,0,0,0,0,0,0.4,0.4,15,20,33,0.15789473684210525,0.2791666666666667,29
2001-12-17,Aston Villa,Ipswich,2,1,H,16,24,54,3,0.34210526315789475,21,18,3,0.375,16,9,66,15,0.5263157894736842,14,25,-11,0.0625,0,0,0,0,0,0,0,0,0.0,0.0,15,-12,-12,-0.18421052631578944,0.3125,14
2001-12-18,Arsenal,Newcastle,1,3,A,16,30,70,25,0.5263157894736842,34,18,16,0.5,16,30,51,-6,0.3684210526315789,27,19,8,0.5625,0,0,0,0,0,0,0,0,0.6,0.6,0,19,31,0.15789473684210525,-0.0625,8
2001-12-19,Leeds,Everton,3,2,H,16,29,68,21,0.5263157894736842,20,11,9,0.4375,16,23,42,-14,0.2894736842105263,21,19,2,0.375,0,0,0,0,0,0,0,0,0.2,0.4,6,26,35,0.23684210526315785,0.0625,7
2001-12-22,Charlton,Blackburn,0,2,A,17,22,52,-7,0.3684210526315789,21,20,1,0.29411764705882354,17,19,-1,-1,0.0,23,21,2,0.23529411764705882,0,0,0,0,0,0,1,0,0.4,0.0,3,53,-6,0.3684210526315789,0.05882352941176472,-1
2001-12-22,Derby,Aston Villa,3,1,H,17,13,42,-22,0.2631578947368421,11,30,-19,0.17647058823529413,17,27,54,3,0.34210526315789475,23,19,4,0.4117647058823529,0,0,0,0,0,0,0,0,0.2,0.2,-14,-12,-25,-0.07894736842105265,-0.2352941176470588,-23
2001-12-22,Leeds,Newcastle,3,4,A,17,32,68,21,0.5263157894736842,23,13,10,0.47058823529411764,17,33,51,-6,0.3684210526315789,30,20,10,0.5882352941176471,0,0,0,0,1,0,0,0,0.4,0.8,-1,17,27,0.15789473684210525,-0.11764705882352944,0
2001-12-22,Leicester,West Ham,1,1,D,17,14,48,-12,0.3684210526315789,11,31,-20,0.17647058823529413,17,20,42,-5,0.2631578947368421,19,29,-10,0.29411764705882354,0,0,0,0,0,0,0,0,0.2,0.2,-6,6,-7,0.10526315789473684,-0.11764705882352941,-10
2001-12-22,Man United,Southampton,6,1,H,17,27,80,48,0.631578947368421,37,27,10,0.47058823529411764,16,16,52,-8,0.3684210526315789,17,24,-7,0.3125,0,0,0,0,0,0,0,0,0.4,0.6,11,28,56,0.2631578947368421,0.15808823529411764,17
2001-12-22,Sunderland,Everton,1,0,H,17,20,57,5,0.3947368421052632,13,17,-4,0.29411764705882354,17,23,42,-14,0.2894736842105263,23,22,1,0.35294117647058826,0,0,0,0,0,0,0,0,0.4,0.4,-3,15,19,0.10526315789473689,-0.05882352941176472,-5
2001-12-22,Tottenham,Ipswich,1,2,A,17,27,49,-7,0.34210526315789475,29,23,6,0.47058823529411764,17,9,66,15,0.5263157894736842,15,27,-12,0.058823529411764705,0,0,0,0,0,0,1,0,0.6,0.0,18,-17,-22,-0.18421052631578944,0.4117647058823529,18
2001-12-23,Chelsea,Bolton,5,1,H,17,27,61,23,0.4473684210526316,23,12,11,0.35294117647058826,17,21,-1,-1,0.0,20,21,-1,0.29411764705882354,0,0,0,0,0,0,0,0,0.4,0.2,6,62,24,0.4473684210526316,0.05882352941176472,12
2001-12-23,Liverpool,Arsenal,1,2,A,16,33,69,32,0.5263157894736842,25,15,10,0.625,17,30,70,25,0.5263157894736842,35,21,14,0.47058823529411764,0,0,0,0,0,0,0,0,0.6,0.6,3,-1,7,0.0,0.15441176470588236,-4
2001-12-26,Arsenal,Chelsea,2,1,H,18,33,70,25,0.5263157894736842,37,22,15,0.5,18,30,61,23,0.4473684210526316,28,13,15,0.3888888888888889,0,0,0,0,0,0,0,0,0.6,0.6,3,9,2,0.0789473684210526,0.1111111111111111,0
2001-12-26,Aston Villa,Liverpool,1,2,A,18,27,54,3,0.34210526315789475,24,22,2,0.3888888888888889,17,33,69,32,0.5263157894736842,26,17,9,0.5882352941176471,0,0,0,0,0,0,0,0,0.2,0.4,-6,-15,-29,-0.18421052631578944,-0.19934640522875818,-7
2001-12-26,Blackburn,Sunderland,0,3,A,18,22,-1,-1,0.0,25,21,4,0.2777777777777778,18,23,57,5,0.3947368421052632,14,17,-3,0.3333333333333333,0,0,0,0,0,0,0,0,0.2,0.4,-1,-58,-6,-0.3947368421052632,-0.055555555555555525,7
2001-12-26,Bolton,Leeds,0,3,A,18,21,-1,-1,0.0,21,26,-5,0.2777777777777778,18,32,68,21,0.5263157894736842,26,17,9,0.4444444444444444,0,0,0,0,0,0,0,0,0.0,0.4,-11,-69,-22,-0.5263157894736842,-0.16666666666666663,-14
2001-12-26,Everton,Man United,0,2,A,18,23,42,-14,0.2894736842105263,23,23,0,0.3333333333333333,18,30,80,48,0.631578947368421,43,28,15,0.5,0,0,0,0,1,0,0,0,0.4,0.6,-7,-38,-62,-0.3421052631578947,-0.16666666666666669,-15
2001-12-26,Fulham,Charlton,0,0,D,17,23,-1,-1,0.0,17,17,0,0.29411764705882354,18,22,52,-7,0.3684210526315789,21,22,-1,0.2777777777777778,0,0,0,0,0,0,0,0,0.2,0.4,1,-53,6,-0.3684210526315789,0.01633986928104575,1
2001-12-26,Ipswich,Leicester,2,0,H,18,12,66,15,0.5263157894736842,17,28,-11,0.1111111111111111,18,15,48,-12,0.3684210526315789,12,32,-20,0.16666666666666666,0,0,0,0,0,0,0,0,0.2,0.2,-3,18,27,0.15789473684210525,-0.05555555555555555,9
2001-12-26,Newcastle,Middlesbrough,3,0,H,18,36,51,-6,0.3684210526315789,34,23,11,0.6111111111111112,17,19,42,0,0.2368421052631579,17,23,-6,0.29411764705882354,1,0,0,0,0,0,0,0,0.8,0.2,17,9,-6,0.13157894736842102,0.3169934640522876,17
2001-12-26,Southampton,Tottenham,1,0,H,17,16,52,-8,0.3684210526315789,18,30,-12,0.29411764705882354,18,27,49,-7,0.34210526315789475,30,25,5,0.4444444444444444,0,0,0,0,0,0,0,0,0.6,0.6,-11,3,-1,0.02631578947368418,-0.15032679738562088,-17
2001-12-26,West Ham,Derby,4,0,H,18,21,42,-5,0.2631578947368421,20,30,-10,0.2777777777777778,18,16,42,-22,0.2631578947368421,14,31,-17,0.2222222222222222,0,0,0,0,0,0,0,0,0.2,0.4,5,0,17,0.0,0.05555555555555558,7
2001-12-29,Arsenal,Middlesbrough,2,1,H,19,36,70,25,0.5263157894736842,39,23,16,0.5263157894736842,18,19,42,0,0.2368421052631579,17,26,-9,0.2777777777777778,0,0,0,0,0,0,1,0,0.6,0.2,17,28,25,0.28947368421052627,0.2485380116959064,25
2001-12-29,Aston Villa,Tottenham,1,1,D,19,27,54,3,0.34210526315789475,25,24,1,0.3684210526315789,19,27,49,-7,0.34210526315789475,30,26,4,0.42105263157894735,0,0,0,0,0,0,0,0,0.2,0.4,0,5,10,0.0,-0.05263157894736842,-3
2001-12-29,Blackburn,Derby,0,1,A,19,22,-1,-1,0.0,25,24,1,0.2631578947368421,19,16,42,-22,0.2631578947368421,14,35,-21,0.21052631578947367,0,0,0,0,0,0,0,0,0.2,0.4,6,-43,21,-0.2631578947368421,0.05263157894736842,22
2001-12-29,Bolton,Leicester,2,2,D,19,21,-1,-1,0.0,21,29,-8,0.2631578947368421,19,15,48,-12,0.3684210526315789,12,34,-22,0.15789473684210525,0,0,0,0,0,0,0,0,0.0,0.2,6,-49,11,-0.3684210526315789,0.10526315789473684,14
2001-12-29,Everton,Charlton,0,3,A,19,23,42,-14,0.2894736842105263,23,25,-2,0.3157894736842105,19,23,52,-7,0.3684210526315789,21,22,-1,0.2631578947368421,0,0,1,0,0,0,0,0,0.2,0.4,0,-10,-7,-0.0789473684210526,0.05263157894736842,-1
2001-12-29,Ipswich,Sunderland,5,0,H,19,15,66,15,0.5263157894736842,19,28,-9,0.15789473684210525,19,26,57,5,0.3947368421052632,17,17,0,0.3684210526315789,0,0,0,0,0,0,0,0,0.4,0.6,-11,9,10,0.13157894736842096,-0.21052631578947367,-9
2001-12-29,Newcastle,Chelsea,1,2,A,19,39,51,-6,0.3684210526315789,37,23,14,0.631578947368421,19,30,61,23,0.4473684210526316,29,15,14,0.3684210526315789,1,1,0,0,0,0,0,0,1.0,0.4,9,-10,-29,-0.07894736842105265,0.2631578947368421,0
2001-12-29,Southampton,Leeds,0,1,A,18,19,52,-8,0.3684210526315789,19,30,-11,0.3333333333333333,19,35,68,21,0.5263157894736842,29,17,12,0.47368421052631576,0,0,0,0,0,0,0,0,0.6,0.6,-16,-16,-29,-0.15789473684210525,-0.14035087719298245,-23
2001-12-29,West Ham,Liverpool,1,1,D,19,24,42,-5,0.2631578947368421,24,30,-6,0.3157894736842105,18,36,69,32,0.5263157894736842,28,18,10,0.6111111111111112,0,0,0,0,0,0,0,0,0.4,0.4,-12,-27,-37,-0.2631578947368421,-0.29532163742690065,-16
2001-12-30,Fulham,Man United,2,3,A,18,24,-1,-1,0.0,17,17,0,0.2777777777777778,19,33,80,48,0.631578947368421,45,28,17,0.5263157894736842,0,0,0,0,1,0,0,0,0.2,0.8,-9,-81,-49,-0.631578947368421,-0.2485380116959064,-17
2002-01-01,Charlton,Ipswich,3,2,H,20,26,52,-7,0.3684210526315789,24,22,2,0.3,20,18,66,15,0.5263157894736842,24,28,-4,0.2,0,0,0,0,1,0,0,0,0.4,0.6,8,-14,-22,-0.15789473684210525,0.09999999999999998,6
2002-01-01,Chelsea,Southampton,2,4,A,20,33,61,23,0.4473684210526316,31,16,15,0.4,19,19,52,-8,0.3684210526315789,19,31,-12,0.3157894736842105,0,0,0,0,0,0,0,0,0.6,0.6,14,9,31,0.07894736842105265,0.08421052631578951,27
2002-01-01,Leeds,West Ham,3,0,H,20,38,68,21,0.5263157894736842,30,17,13,0.5,20,25,42,-5,0.2631578947368421,25,31,-6,0.3,0,0,0,0,0,0,0,0,0.6,0.4,13,26,26,0.2631578947368421,0.2,19
2002-01-01,Liverpool,Bolton,1,1,D,19,37,69,32,0.5263157894736842,29,19,10,0.5789473684210527,20,22,-1,-1,0.0,23,31,-8,0.25,0,0,0,0,0,0,0,0,0.2,0.0,15,70,33,0.5263157894736842,0.32894736842105265,18
2002-01-01,Middlesbrough,Everton,1,0,H,19,19,42,0,0.2368421052631579,18,28,-10,0.2631578947368421,20,23,42,-14,0.2894736842105263,23,28,-5,0.3,0,0,1,0,0,0,1,0,0.2,0.2,-4,0,14,-0.05263157894736842,-0.0368421052631579,-5
2002-01-01,Sunderland,Aston Villa,1,1,D,20,26,57,5,0.3947368421052632,17,22,-5,0.35,20,28,54,3,0.34210526315789475,26,25,1,0.35,0,0,0,0,0,0,0,0,0.4,0.2,-2,3,2,0.052631578947368474,0.0,-6
2002-01-01,Tottenham,Blackburn,1,0,H,20,28,49,-7,0.34210526315789475,31,27,4,0.4,20,22,-1,-1,0.0,25,25,0,0.25,0,0,0,0,0,0,0,0,0.2,0.2,6,50,-6,0.34210526315789475,0.15000000000000002,4
2002-01-02,Derby,Fulham,0,1,A,20,19,42,-22,0.2631578947368421,15,35,-20,0.25,19,24,-1,-1,0.0,19,20,-1,0.2631578947368421,0,0,0,0,0,0,0,0,0.4,0.2,-5,43,-21,0.2631578947368421,-0.01315789473684209,-19
2002-01-02,Man United,Newcastle,3,1,H,20,36,80,48,0.631578947368421,48,30,18,0.55,20,39,51,-6,0.3684210526315789,38,25,13,0.6,1,1,0,0,0,0,0,0,1.0,0.8,-3,29,54,0.2631578947368421,-0.04999999999999993,5
2002-01-09,Southampton,Liverpool,2,0,H,20,22,52,-8,0.3684210526315789,23,33,-10,0.35,20,38,69,32,0.5263157894736842,30,20,10,0.55,0,0,0,0,0,0,0,0,0.6,0.2,-16,-17,-40,-0.15789473684210525,-0.20000000000000007,-20
2002-01-12,Aston Villa,Derby,2,1,H,21,29,54,3,0.34210526315789475,27,26,1,0.3333333333333333,21,19,42,-22,0.2631578947368421,15,36,-21,0.23809523809523808,0,0,0,0,0,0,0,0,0.2,0.4,10,12,25,0.07894736842105265,0.09523809523809523,22
2002-01-12,Blackburn,Charlton,4,1,H,21,22,-1,-1,0.0,25,26,-1,0.23809523809523808,21,29,52,-7,0.3684210526315789,27,24,3,0.3333333333333333,0,0,1,0,0,0,0,0,0.2,0.4,-7,-53,6,-0.3684210526315789,-0.09523809523809523,-4
2002-01-12,Bolton,Chelsea,2,2,D,21,23,-1,-1,0.0,24,32,-8,0.23809523809523808,21,33,61,23,0.4473684210526316,33,20,13,0.38095238095238093,0,0,0,0,0,0,0,0,0.0,0.6,-10,-62,-24,-0.4473684210526316,-0.14285714285714285,-21
2002-01-12,Everton,Sunderland,1,0,H,21,23,42,-14,0.2894736842105263,23,29,-6,0.2857142857142857,21,27,57,5,0.3947368421052632,18,23,-5,0.3333333333333333,0,0,1,1,0,0,0,0,0.0,0.4,-4,-15,-19,-0.10526315789473689,-0.047619047619047616,-1
2002-01-12,Fulham,Middlesbrough,2,1,H,20,27,-1,-1,0.0,20,20,0,0.3,20,22,42,0,0.2368421052631579,19,28,-9,0.3,0,0,0,0,0,0,0,0,0.2,0.2,5,-43,-1,-0.2368421052631579,0.0,9
2002-01-12,Ipswich,Tottenham,2,1,H,21,18,66,15,0.5263157894736842,26,31,-5,0.19047619047619047,21,31,49,-7,0.34210526315789475,32,27,5,0.42857142857142855,0,0,0,0,0,0,0,0,0.6,0.4,-13,17,22,0.18421052631578944,-0.23809523809523808,-10
2002-01-12,Newcastle,Leeds,3,1,H,21,39,51,-6,0.3684210526315789,39,28,11,0.5714285714285714,21,41,68,21,0.5263157894736842,33,17,16,0.5238095238095238,0,0,0,0,1,0,0,0,0.6,0.8,-2,-17,-27,-0.15789473684210525,0.04761904761904756,-5
2002-01-12,West Ham,Leicester,1,0,H,21,25,42,-5,0.2631578947368421,25,34,-9,0.2857142857142857,20,16,48,-12,0.3684210526315789,14,36,-22,0.15,0,0,0,0,0,0,0,0,0.2,0.0,9,-6,7,-0.10526315789473684,0.1357142857142857,13
2002-01-13,Arsenal,Liverpool,1,1,D,20,39,70,25,0.5263157894736842,41,24,17,0.55,21,38,69,32,0.5263157894736842,30,22,8,0.5238095238095238,1,0,0,0,0,0,0,0,0.6,0.2,1,1,-7,0.0,0.02619047619047621,9
2002-01-13,Southampton,Man United,1,3,A,21,25,52,-8,0.3684210526315789,25,33,-8,0.38095238095238093,21,39,80,48,0.631578947368421,51,31,20,0.5714285714285714,0,0,0,0,1,1,0,0,0.6,1.0,-14,-28,-56,-0.2631578947368421,-0.19047619047619047,-28
2002-01-19,Derby,Ipswich,1,3,A,22,19,42,-22,0.2631578947368421,16,38,-22,0.22727272727272727,22,21,66,15,0.5263157894736842,28,32,-4,0.22727272727272727,0,0,0,0,0,0,0,0,0.4,0.8,-2,-24,-37,-0.2631578947368421,0.0,-18
2002-01-19,Leicester,Newcastle,0,0,D,21,16,48,-12,0.3684210526315789,14,37,-23,0.14285714285714285,22,42,51,-6,0.3684210526315789,42,29,13,0.5909090909090909,0,0,0,0,0,0,0,0,0.0,0.6,-26,-3,-6,0.0,-0.4480519480519481,-36
2002-01-19,Liverpool,Southampton,1,1,D,22,39,69,32,0.5263157894736842,31,23,8,0.5,22,25,52,-8,0.3684210526315789,26,36,-10,0.36363636363636365,0,0,0,0,0,0,0,0,0.2,0.6,14,17,40,0.15789473684210525,0.13636363636363635,18
2002-01-19,Man United,Blackburn,2,1,H,22,42,80,48,0.631578947368421,54,32,22,0.5909090909090909,22,25,-1,-1,0.0,29,27,2,0.2727272727272727,1,1,0,0,0,0,0,0,1.0,0.4,17,81,49,0.631578947368421,0.31818181818181823,20
2002-01-19,Middlesbrough,Bolton,1,1,D,21,22,42,0,0.2368421052631579,20,30,-10,0.2857142857142857,22,24,-1,-1,0.0,26,34,-8,0.22727272727272727,0,0,0,0,0,0,0,0,0.2,0.0,-2,43,1,0.2368421052631579,0.05844155844155843,-2
2002-01-19,Sunderland,Fulham,1,1,D,22,27,57,5,0.3947368421052632,18,24,-6,0.3181818181818182,21,30,-1,-1,0.0,22,21,1,0.3333333333333333,0,0,0,0,0,0,0,0,0.4,0.4,-3,58,6,0.3947368421052632,-0.015151515151515138,-7
2002-01-19,Tottenham,Everton,1,1,D,22,31,49,-7,0.34210526315789475,33,29,4,0.4090909090909091,22,26,42,-14,0.2894736842105263,24,29,-5,0.3181818181818182,0,0,0,0,0,0,0,0,0.2,0.2,5,7,7,0.05263157894736842,0.09090909090909094,9
2002-01-20,Chelsea,West Ham,5,1,H,22,34,61,23,0.4473684210526316,35,22,13,0.36363636363636365,22,28,42,-5,0.2631578947368421,26,34,-8,0.3181818181818182,0,0,0,0,0,0,0,0,0.4,0.4,6,19,28,0.1842105263157895,0.04545454545454547,21
2002-01-20,Leeds,Arsenal,1,1,D,22,41,68,21,0.5263157894736842,34,20,14,0.5,21,40,70,25,0.5263157894736842,42,25,17,0.5238095238095238,0,0,0,0,0,0,0,0,0.6,0.6,1,-2,-4,0.0,-0.023809523809523836,-3
2002-01-21,Charlton,Aston Villa,1,2,A,22,29,52,-7,0.3684210526315789,28,28,0,0.3181818181818182,22,32,54,3,0.34210526315789475,29,27,2,0.36363636363636365,0,0,0,0,0,0,0,0,0.4,0.2,-3,-2,-10,0.02631578947368418,-0.04545454545454547,-2
2002-01-22,Man United,Liverpool,0,1,A,23,45,80,48,0.631578947368421,56,33,23,0.6086956521739131,23,40,69,32,0.5263157894736842,32,24,8,0.4782608695652174,1,1,0,0,0,0,0,0,1.0,0.0,5,11,16,0.10526315789473684,0.13043478260869568,15
2002-01-23,Leicester,Arsenal,1,3,A,22,17,48,-12,0.3684210526315789,14,37,-23,0.13636363636363635,22,41,70,25,0.5263157894736842,43,26,17,0.5,0,0,0,0,0,0,0,0,0.0,0.6,-24,-22,-37,-0.15789473684210525,-0.36363636363636365,-40
2002-01-29,Bolton,Man United,0,4,A,23,25,-1,-1,0.0,27,35,-8,0.21739130434782608,24,45,80,48,0.631578947368421,56,34,22,0.5833333333333334,0,0,0,0,0,0,0,0,0.0,0.8,-20,-81,-49,-0.631578947368421,-0.3659420289855073,-30
2002-01-29,Charlton,Derby,1,0,H,23,29,52,-7,0.3684210526315789,29,30,-1,0.30434782608695654,23,19,42,-22,0.2631578947368421,17,41,-24,0.21739130434782608,0,0,0,0,0,0,1,0,0.4,0.2,10,10,15,0.10526315789473684,0.08695652173913046,23
2002-01-29,Sunderland,Middlesbrough,0,1,A,23,28,57,5,0.3947368421052632,19,25,-6,0.30434782608695654,22,23,42,0,0.2368421052631579,21,31,-10,0.2727272727272727,0,0,0,0,0,0,0,0,0.2,0.2,5,15,5,0.1578947368421053,0.031620553359683834,4
2002-01-30,Aston Villa,Everton,0,0,D,23,35,54,3,0.34210526315789475,31,28,3,0.391304347826087,23,27,42,-14,0.2894736842105263,25,30,-5,0.30434782608695654,0,0,0,0,0,0,0,0,0.4,0.2,8,12,17,0.05263157894736842,0.08695652173913043,8
2002-01-30,Blackburn,Arsenal,2,3,A,23,25,-1,-1,0.0,30,29,1,0.2608695652173913,23,44,70,25,0.5263157894736842,46,27,19,0.5217391304347826,0,0,0,0,0,0,0,0,0.2,0.6,-19,-71,-26,-0.5263157894736842,-0.2608695652173913,-18
2002-01-30,Chelsea,Leeds,2,0,H,23,37,61,23,0.4473684210526316,40,23,17,0.391304347826087,23,42,68,21,0.5263157894736842,35,21,14,0.4782608695652174,0,0,0,0,0,0,0,0,0.4,0.6,-5,-7,2,-0.0789473684210526,-0.08695652173913043,3
2002-01-30,Ipswich,Fulham,1,0,H,23,24,66,15,0.5263157894736842,31,33,-2,0.2608695652173913,22,31,-1,-1,0.0,23,22,1,0.3181818181818182,0,0,0,0,0,0,0,0,0.8,0.4,-7,67,16,0.5263157894736842,-0.05731225296442688,-3
2002-01-30,Liverpool,Leicester,1,0,H,24,43,69,32,0.5263157894736842,33,24,9,0.5,23,17,48,-12,0.3684210526315789,15,40,-25,0.13043478260869565,0,0,0,0,0,0,0,0,0.2,0.0,26,21,44,0.15789473684210525,0.3695652173913043,34
2002-01-30,Southampton,West Ham,2,0,H,23,26,52,-8,0.3684210526315789,27,37,-10,0.34782608695652173,23,28,42,-5,0.2631578947368421,27,39,-12,0.30434782608695654,0,0,0,0,0,0,0,0,0.4,0.4,-2,10,-3,0.10526315789473684,0.04347826086956519,2
2002-01-30,Tottenham,Newcastle,1,3,A,23,32,49,-7,0.34210526315789475,34,30,4,0.391304347826087,23,43,51,-6,0.3684210526315789,42,29,13,0.5652173913043478,0,0,0,0,0,0,0,0,0.2,0.4,-11,-2,-1,-0.02631578947368418,-0.1739130434782608,-9
2002-02-02,Arsenal,Southampton,1,1,D,24,47,70,25,0.5263157894736842,49,29,20,0.5416666666666666,24,29,52,-8,0.3684210526315789,29,37,-8,0.375,0,0,0,0,0,0,0,0,0.6,0.6,18,18,33,0.15789473684210525,0.16666666666666663,28
2002-02-02,Derby,Tottenham,1,0,H,24,19,42,-22,0.2631578947368421,17,42,-25,0.20833333333333334,24,32,49,-7,0.34210526315789475,35,33,2,0.375,0,0,1,0,0,0,0,0,0.2,0.2,-13,-7,-15,-0.07894736842105265,-0.16666666666666666,-27
2002-02-02,Everton,Ipswich,1,2,A,24,28,42,-14,0.2894736842105263,25,30,-5,0.2916666666666667,24,27,66,15,0.5263157894736842,32,33,-1,0.2916666666666667,0,0,0,0,1,0,0,0,0.2,0.8,1,-24,-29,-0.23684210526315785,0.0,-4
2002-02-02,Fulham,Aston Villa,0,0,D,23,31,-1,-1,0.0,23,23,0,0.30434782608695654,24,36,54,3,0.34210526315789475,31,28,3,0.375,0,0,0,0,0,0,0,0,0.4,0.4,-5,-55,-4,-0.34210526315789475,-0.07065217391304346,-3
2002-02-02,Leicester,Chelsea,2,3,A,24,17,48,-12,0.3684210526315789,15,41,-26,0.125,24,40,61,23,0.4473684210526316,42,23,19,0.4166666666666667,0,0,0,0,0,0,0,0,0.0,0.6,-23,-13,-35,-0.07894736842105265,-0.2916666666666667,-45
2002-02-02,Man United,Sunderland,4,1,H,25,48,80,48,0.631578947368421,60,34,26,0.6,24,28,57,5,0.3947368421052632,19,26,-7,0.2916666666666667,0,0,0,0,0,0,0,0,0.8,0.0,20,23,43,0.2368421052631578,0.3083333333333333,33
2002-02-02,Newcastle,Bolton,3,2,H,24,46,51,-6,0.3684210526315789,45,30,15,0.5833333333333334,24,25,-1,-1,0.0,27,39,-12,0.20833333333333334,0,0,0,0,0,0,0,0,0.4,0.0,21,52,-5,0.3684210526315789,0.375,27
2002-02-02,West Ham,Blackburn,2,0,H,24,28,42,-5,0.2631578947368421,27,41,-14,0.2916666666666667,24,25,-1,-1,0.0,32,32,0,0.25,0,0,0,0,0,0,0,0,0.2,0.2,3,43,-4,0.2631578947368421,0.041666666666666685,-14
2002-02-03,Leeds,Liverpool,0,4,A,24,42,68,21,0.5263157894736842,35,23,12,0.4583333333333333,25,46,69,32,0.5263157894736842,34,24,10,0.52,0,0,0,0,0,0,0,0,0.4,0.4,-4,-1,-11,0.0,-0.0616666666666667,2
2002-02-03,Middlesbrough,Charlton,0,0,D,23,26,42,0,0.2368421052631579,22,31,-9,0.30434782608695654,24,32,52,-7,0.3684210526315789,30,30,0,0.3333333333333333,0,0,0,0,0,0,0,0,0.4,0.6,-6,-10,7,-0.13157894736842102,-0.028985507246376774,-9
2002-02-09,Aston Villa,Chelsea,1,1,D,25,37,54,3,0.34210526315789475,31,28,3,0.36,25,43,61,23,0.4473684210526316,45,25,20,0.44,0,0,0,0,1,0,0,0,0.4,0.6,-6,-7,-20,-0.10526315789473684,-0.08000000000000002,-17
2002-02-09,Bolton,West Ham,1,0,H,25,25,-1,-1,0.0,29,42,-13,0.2,25,31,42,-5,0.2631578947368421,29,41,-12,0.32,0,0,0,0,0,0,0,0,0.0,0.4,-6,-43,4,-0.2631578947368421,-0.12,-1
2002-02-09,Derby,Sunderland,0,1,A,25,22,42,-22,0.2631578947368421,18,42,-24,0.24,25,28,57,5,0.3947368421052632,20,30,-10,0.28,0,0,0,0,0,0,0,0,0.2,0.0,-6,-15,-27,-0.13157894736842113,-0.040000000000000036,-14
2002-02-09,Fulham,Blackburn,2,0,H,24,32,-1,-1,0.0,23,23,0,0.2916666666666667,25,25,-1,-1,0.0,32,34,-2,0.24,0,0,0,0,0,0,1,0,0.4,0.2,7,0,0,0.0,0.051666666666666694,2
2002-02-09,Ipswich,Liverpool,0,6,A,25,30,66,15,0.5263157894736842,34,34,0,0.32,26,49,69,32,0.5263157894736842,38,24,14,0.5384615384615384,1,0,0,0,1,0,0,0,0.8,0.6,-19,-3,-17,0.0,-0.21846153846153843,-14
2002-02-09,Middlesbrough,Leeds,2,2,D,24,27,42,0,0.2368421052631579,22,31,-9,0.2916666666666667,25,42,68,21,0.5263157894736842,35,27,8,0.44,0,0,0,0,0,0,0,0,0.4,0.2,-15,-26,-21,-0.28947368421052627,-0.14833333333333332,-17
2002-02-09,Newcastle,Southampton,3,1,H,25,49,51,-6,0.3684210526315789,48,32,16,0.6,25,30,52,-8,0.3684210526315789,30,38,-8,0.36,0,0,0,0,0,0,0,0,0.6,0.4,19,-1,2,0.0,0.24,24
2002-02-09,Tottenham,Leicester,2,1,H,25,32,49,-7,0.34210526315789475,35,34,1,0.36,25,17,48,-12,0.3684210526315789,17,44,-27,0.12,0,0,0,0,0,0,1,0,0.2,0.0,15,1,5,-0.02631578947368418,0.24,28
2002-02-10,Charlton,Man United,0,2,A,25,33,52,-7,0.3684210526315789,30,30,0,0.32,26,51,80,48,0.631578947368421,64,35,29,0.6153846153846154,0,0,0,0,0,0,0,0,0.4,0.8,-18,-28,-55,-0.2631578947368421,-0.2953846153846154,-29
2002-02-10,Everton,Arsenal,0,1,A,25,28,42,-14,0.2894736842105263,26,32,-6,0.28,25,48,70,25,0.5263157894736842,50,30,20,0.52,0,0,0,0,0,0,0,0,0.2,0.4,-20,-28,-39,-0.23684210526315785,-0.24,-26
2002-02-19,Middlesbrough,Fulham,2,1,H,25,28,42,0,0.2368421052631579,24,33,-9,0.28,25,35,-1,-1,0.0,25,23,2,0.32,0,0,0,0,0,0,0,0,0.2,0.4,-7,43,1,0.2368421052631579,-0.03999999999999998,-11
2002-02-23,Arsenal,Fulham,4,1,H,26,51,70,25,0.5263157894736842,51,30,21,0.5384615384615384,26,35,-1,-1,0.0,26,25,1,0.3076923076923077,0,0,0,0,0,0,0,0,0.6,0.2,16,71,26,0.5263157894736842,0.23076923076923073,20
2002-02-23,Leicester,Derby,0,3,A,26,17,48,-12,0.3684210526315789,18,46,-28,0.11538461538461539,26,22,42,-22,0.2631578947368421,18,43,-25,0.23076923076923078,0,0,1,0,0,0,0,0,0.0,0.2,-5,6,10,0.10526315789473684,-0.11538461538461539,-3
2002-02-23,Liverpool,Everton,1,1,D,27,52,69,32,0.5263157894736842,44,24,20,0.5555555555555556,26,28,42,-14,0.2894736842105263,26,33,-7,0.2692307692307692,1,0,0,0,0,0,0,0,0.8,0.2,24,27,46,0.23684210526315785,0.28632478632478636,27
2002-02-23,Man United,Aston Villa,1,0,H,27,54,80,48,0.631578947368421,66,35,31,0.6296296296296297,26,38,54,3,0.34210526315789475,32,29,3,0.34615384615384615,1,0,0,0,0,0,0,0,0.8,0.4,16,26,45,0.28947368421052627,0.2834757834757835,28
2002-02-23,Southampton,Bolton,0,0,D,26,30,52,-8,0.3684210526315789,31,41,-10,0.34615384615384615,26,28,-1,-1,0.0,30,42,-12,0.23076923076923078,0,0,0,0,0,0,0,0,0.2,0.2,2,53,-7,0.3684210526315789,0.11538461538461536,2
2002-02-23,West Ham,Middlesbrough,1,0,H,26,31,42,-5,0.2631578947368421,29,42,-13,0.3076923076923077,26,31,42,0,0.2368421052631579,26,34,-8,0.3076923076923077,0,0,0,0,0,0,0,0,0.4,0.4,0,0,-5,0.02631578947368418,0.0,-5
2002-02-24,Leeds,Charlton,0,0,D,26,43,68,21,0.5263157894736842,37,29,8,0.4230769230769231,26,33,52,-7,0.3684210526315789,30,32,-2,0.3076923076923077,0,0,0,0,0,0,0,0,0.0,0.2,10,16,28,0.15789473684210525,0.11538461538461536,10
2002-02-24,Sunderland,Newcastle,0,1,A,26,31,57,5,0.3947368421052632,21,30,-9,0.3076923076923077,26,52,51,-6,0.3684210526315789,51,33,18,0.6153846153846154,0,0,0,0,1,0,0,0,0.2,0.8,-21,6,11,0.026315789473684292,-0.3076923076923077,-27
2002-03-02,Aston Villa,West Ham,2,1,H,27,38,54,3,0.34210526315789475,32,30,2,0.3333333333333333,27,34,42,-5,0.2631578947368421,30,42,-12,0.3333333333333333,0,0,0,0,0,0,0,0,0.2,0.4,4,12,8,0.07894736842105265,0.0,14
2002-03-02,Bolton,Blackburn,1,1,D,27,29,-1,-1,0.0,30,42,-12,0.2222222222222222,26,25,-1,-1,0.0,32,36,-4,0.23076923076923078,0,0,0,0,0,0,1,0,0.2,0.2,4,0,0,0.0,-0.008547008547008572,-8
2002-03-02,Charlton,Chelsea,2,1,H,27,34,52,-7,0.3684210526315789,30,32,-2,0.2962962962962963,26,44,61,23,0.4473684210526316,46,26,20,0.4230769230769231,0,0,0,0,0,0,0,0,0.2,0.6,-10,-9,-30,-0.07894736842105265,-0.1267806267806268,-22
2002-03-02,Fulham,Liverpool,0,2,A,27,35,-1,-1,0.0,27,29,-2,0.2962962962962963,28,53,69,32,0.5263157894736842,45,25,20,0.5357142857142857,0,0,0,0,0,0,0,0,0.2,0.8,-18,-70,-33,-0.5263157894736842,-0.23941798941798942,-22
2002-03-02,Ipswich,Southampton,1,3,A,26,30,66,15,0.5263157894736842,34,40,-6,0.3076923076923077,27,31,52,-8,0.3684210526315789,31,41,-10,0.3333333333333333,0,0,0,0,0,0,0,0,0.8,0.2,-1,14,23,0.15789473684210525,-0.025641025641025605,4
2002-03-02,Middlesbrough,Leicester,1,0,H,27,31,42,0,0.2368421052631579,26,35,-9,0.2962962962962963,27,17,48,-12,0.3684210526315789,18,49,-31,0.1111111111111111,0,0,0,0,0,0,1,1,0.4,0.0,14,-6,12,-0.13157894736842102,0.18518518518518517,22
2002-03-02,Newcastle,Arsenal,0,2,A,27,55,51,-6,0.3684210526315789,52,33,19,0.6296296296296297,27,54,70,25,0.5263157894736842,55,31,24,0.5555555555555556,1,0,0,0,0,0,0,0,0.8,0.8,1,-19,-31,-0.15789473684210525,0.07407407407407407,-5
2002-03-02,Tottenham,Sunderland,2,1,H,26,35,49,-7,0.34210526315789475,37,35,2,0.38461538461538464,27,31,57,5,0.3947368421052632,21,31,-10,0.2962962962962963,0,0,0,0,0,0,0,0,0.2,0.2,4,-8,-12,-0.052631578947368474,0.08831908831908836,12
2002-03-03,Derby,Man United,2,2,D,27,25,42,-22,0.2631578947368421,21,43,-22,0.25925925925925924,28,57,80,48,0.631578947368421,67,35,32,0.6428571428571429,0,0,0,0,1,0,0,0,0.4,0.8,-32,-38,-70,-0.3684210526315789,-0.38359788359788366,-54
2002-03-03,Everton,Leeds,0,0,D,27,29,42,-14,0.2894736842105263,27,34,-7,0.25925925925925924,27,44,68,21,0.5263157894736842,37,29,8,0.4074074074074074,0,0,0,0,0,0,0,0,0.0,0.0,-15,-26,-35,-0.23684210526315785,-0.14814814814814814,-15
2002-03-05,Arsenal,Derby,1,0,H,28,57,70,25,0.5263157894736842,57,31,26,0.5714285714285714,28,26,42,-22,0.2631578947368421,23,45,-22,0.25,1,0,0,0,0,0,0,0,0.8,0.4,31,28,47,0.2631578947368421,0.3214285714285714,48
2002-03-05,Blackburn,Aston Villa,3,0,H,27,26,-1,-1,0.0,33,37,-4,0.2222222222222222,28,41,54,3,0.34210526315789475,34,31,3,0.35714285714285715,0,0,0,0,0,0,0,0,0.0,0.2,-15,-55,-4,-0.34210526315789475,-0.13492063492063494,-7
2002-03-05,Sunderland,Bolton,1,0,H,28,31,57,5,0.3947368421052632,22,33,-11,0.2857142857142857,28,30,-1,-1,0.0,31,43,-12,0.21428571428571427,0,0,0,0,0,0,0,0,0.2,0.2,1,58,6,0.3947368421052632,0.07142857142857142,1
2002-03-06,Chelsea,Fulham,3,2,H,27,44,61,23,0.4473684210526316,47,28,19,0.4074074074074074,28,35,-1,-1,0.0,27,31,-4,0.2857142857142857,0,0,0,0,0,0,1,0,0.6,0.2,9,62,24,0.4473684210526316,0.12169312169312169,23
2002-03-06,Leeds,Ipswich,2,0,H,28,45,68,21,0.5263157894736842,37,29,8,0.39285714285714285,27,30,66,15,0.5263157894736842,35,43,-8,0.2962962962962963,0,0,0,0,0,0,0,0,0.0,0.6,15,2,6,0.0,0.09656084656084657,16
2002-03-06,Liverpool,Newcastle,3,0,H,29,56,69,32,0.5263157894736842,47,25,22,0.5517241379310345,28,55,51,-6,0.3684210526315789,52,35,17,0.6071428571428571,0,0,0,0,0,0,0,0,0.8,0.8,1,18,38,0.15789473684210525,-0.05541871921182262,5
2002-03-06,Man United,Tottenham,4,0,H,29,58,80,48,0.631578947368421,69,37,32,0.6206896551724138,27,38,49,-7,0.34210526315789475,39,36,3,0.4074074074074074,0,0,0,0,0,0,0,0,0.8,0.4,20,31,55,0.28947368421052627,0.21328224776500643,29
2002-03-06,Southampton,Middlesbrough,1,1,D,28,34,52,-8,0.3684210526315789,34,42,-8,0.35714285714285715,28,34,42,0,0.2368421052631579,27,35,-8,0.32142857142857145,0,0,0,0,0,0,0,0,0.4,0.4,0,10,-8,0.13157894736842102,0.0357142857142857,0
2002-03-06,West Ham,Everton,1,0,H,28,34,42,-5,0.2631578947368421,31,44,-13,0.32142857142857145,28,30,42,-14,0.2894736842105263,27,34,-7,0.25,0,0,0,0,0,0,0,0,0.4,0.0,4,0,9,-0.026315789473684237,0.07142857142857145,-6
2002-03-09,Leicester,Charlton,1,1,D,28,17,48,-12,0.3684210526315789,18,50,-32,0.10714285714285714,28,37,52,-7,0.3684210526315789,32,33,-1,0.32142857142857145,0,0,1,1,0,0,0,0,0.0,0.4,-20,-4,-5,0.0,-0.2142857142857143,-31
2002-03-13,Blackburn,Ipswich,2,1,H,28,29,-1,-1,0.0,36,37,-1,0.25,28,30,66,15,0.5263157894736842,35,45,-10,0.2857142857142857,0,0,0,0,0,0,1,0,0.2,0.4,-1,-67,-16,-0.5263157894736842,-0.0357142857142857,9
2002-03-13,Chelsea,Tottenham,4,0,H,28,47,61,23,0.4473684210526316,50,30,20,0.42857142857142855,28,38,49,-7,0.34210526315789475,39,40,-1,0.39285714285714285,0,0,0,0,0,0,0,0,0.6,0.4,9,12,30,0.10526315789473684,0.0357142857142857,21
2002-03-16,Bolton,Derby,1,3,A,29,30,-1,-1,0.0,31,44,-13,0.20689655172413793,29,26,42,-22,0.2631578947368421,23,46,-23,0.2413793103448276,0,0,0,0,0,0,0,0,0.2,0.4,4,-43,21,-0.2631578947368421,-0.03448275862068967,10
2002-03-16,Chelsea,Sunderland,4,0,H,29,50,61,23,0.4473684210526316,54,30,24,0.4482758620689655,29,34,57,5,0.3947368421052632,23,33,-10,0.3103448275862069,0,0,0,0,0,0,0,0,0.6,0.4,16,4,18,0.05263157894736836,0.13793103448275862,34
2002-03-16,Everton,Fulham,2,1,H,29,30,42,-14,0.2894736842105263,27,35,-8,0.2413793103448276,29,35,-1,-1,0.0,29,34,-5,0.27586206896551724,0,0,0,0,0,0,1,0,0.0,0.2,-5,43,-13,0.2894736842105263,-0.03448275862068964,-3
2002-03-16,Middlesbrough,Liverpool,1,2,A,29,35,42,0,0.2368421052631579,28,36,-8,0.3103448275862069,30,59,69,32,0.5263157894736842,50,25,25,0.5666666666666667,0,0,0,0,0,0,0,0,0.4,0.8,-24,-27,-32,-0.28947368421052627,-0.25632183908045975,-33
2002-03-16,Newcastle,Ipswich,2,2,D,29,55,51,-6,0.3684210526315789,52,38,14,0.5862068965517241,29,30,66,15,0.5263157894736842,36,47,-11,0.27586206896551724,0,0,0,0,0,0,1,0,0.6,0.2,25,-15,-21,-0.15789473684210525,0.31034482758620685,25
2002-03-16,Southampton,Leicester,2,2,D,29,35,52,-8,0.3684210526315789,35,43,-8,0.3448275862068966,29,18,48,-12,0.3684210526315789,19,51,-32,0.10344827586206896,0,0,0,0,0,0,0,0,0.2,0.0,17,4,4,0.0,0.24137931034482762,24
2002-03-16,West Ham,Man United,3,5,A,29,37,42,-5,0.2631578947368421,32,44,-12,0.3448275862068966,30,61,80,48,0.631578947368421,73,37,36,0.6333333333333333,0,0,0,0,0,0,0,0,0.6,0.8,-24,-38,-53,-0.3684210526315789,-0.28850574712643673,-48
2002-03-17,Aston Villa,Arsenal,1,2,A,29,41,54,3,0.34210526315789475,34,34,0,0.3448275862068966,29,60,70,25,0.5263157894736842,58,31,27,0.5862068965517241,0,0,0,0,1,0,0,0,0.2,0.8,-19,-16,-22,-0.18421052631578944,-0.2413793103448275,-27
2002-03-17,Leeds,Blackburn,3,1,H,29,48,68,21,0.5263157894736842,39,29,10,0.41379310344827586,29,32,-1,-1,0.0,38,38,0,0.27586206896551724,0,0,0,0,0,0,0,0,0.2,0.4,16,69,22,0.5263157894736842,0.13793103448275862,10
2002-03-18,Tottenham,Charlton,0,1,A,29,38,49,-7,0.34210526315789475,39,44,-5,0.3793103448275862,29,38,52,-7,0.3684210526315789,33,34,-1,0.3103448275862069,0,0,0,0,0,0,0,0,0.4,0.2,0,-3,0,-0.02631578947368418,0.06896551724137928,-4
2002-03-23,Charlton,Bolton,1,2,A,30,41,52,-7,0.3684210526315789,34,34,0,0.3333333333333333,30,30,-1,-1,0.0,32,47,-15,0.2,0,0,0,0,0,0,0,0,0.4,0.2,11,53,-6,0.3684210526315789,0.1333333333333333,15
2002-03-23,Derby,Everton,3,4,A,30,29,42,-22,0.2631578947368421,26,47,-21,0.26666666666666666,30,33,42,-14,0.2894736842105263,29,36,-7,0.26666666666666666,0,0,0,0,0,0,0,0,0.4,0.2,-4,0,-8,-0.026315789473684237,0.0,-14
2002-03-23,Ipswich,Aston Villa,0,0,D,30,31,66,15,0.5263157894736842,38,49,-11,0.26666666666666666,30,41,54,3,0.34210526315789475,35,36,-1,0.3333333333333333,0,0,0,0,0,0,0,0,0.0,0.2,-10,12,12,0.18421052631578944,-0.06666666666666665,-10
2002-03-23,Leicester,Leeds,0,2,A,30,19,48,-12,0.3684210526315789,21,53,-32,0.1,30,51,68,21,0.5263157894736842,42,30,12,0.43333333333333335,0,0,0,0,0,0,0,0,0.0,0.4,-32,-20,-33,-0.15789473684210525,-0.33333333333333337,-44
2002-03-23,Man United,Middlesbrough,0,1,A,31,64,80,48,0.631578947368421,78,40,38,0.6451612903225806,30,35,42,0,0.2368421052631579,29,38,-9,0.3,0,0,0,0,0,0,0,0,0.8,0.4,29,38,48,0.3947368421052631,0.34516129032258064,47
2002-03-23,Sunderland,Southampton,1,1,D,30,34,57,5,0.3947368421052632,23,37,-14,0.3,30,36,52,-8,0.3684210526315789,37,45,-8,0.3333333333333333,0,0,0,0,0,0,0,0,0.4,0.2,-2,5,13,0.026315789473684292,-0.033333333333333326,-6
2002-03-24,Fulham,Tottenham,0,2,A,30,35,-1,-1,0.0,30,36,-6,0.26666666666666666,30,38,49,-7,0.34210526315789475,39,45,-6,0.36666666666666664,0,0,1,1,0,0,1,0,0.0,0.4,-3,-50,6,-0.34210526315789475,-0.09999999999999998,0
2002-03-24,Liverpool,Chelsea,1,0,H,31,62,69,32,0.5263157894736842,52,26,26,0.5806451612903226,30,53,61,23,0.4473684210526316,58,30,28,0.4666666666666667,1,0,0,0,1,0,0,0,0.8,0.6,9,8,9,0.0789473684210526,0.11397849462365595,-2
2002-03-29,Newcastle,Everton,6,2,H,30,56,51,-6,0.3684210526315789,54,40,14,0.5666666666666667,31,36,42,-14,0.2894736842105263,33,39,-6,0.2903225806451613,0,0,0,0,0,0,0,0,0.4,0.4,20,9,8,0.0789473684210526,0.27634408602150534,20
2002-03-30,Arsenal,Sunderland,3,0,H,30,63,70,25,0.5263157894736842,60,32,28,0.6,31,35,57,5,0.3947368421052632,24,38,-14,0.2903225806451613,1,1,0,0,0,0,0,0,1.0,0.2,28,13,20,0.13157894736842096,0.30967741935483867,42
2002-03-30,Bolton,Aston Villa,3,2,H,31,33,-1,-1,0.0,34,48,-14,0.22580645161290322,31,42,54,3,0.34210526315789475,35,36,-1,0.3225806451612903,0,0,0,0,0,0,0,0,0.2,0.2,-9,-55,-4,-0.34210526315789475,-0.0967741935483871,-13
2002-03-30,Chelsea,Derby,2,1,H,31,53,61,23,0.4473684210526316,58,31,27,0.45161290322580644,31,29,42,-22,0.2631578947368421,29,51,-22,0.25806451612903225,0,0,0,0,0,0,0,0,0.6,0.4,24,19,45,0.1842105263157895,0.1935483870967742,49
2002-03-30,Leeds,Man United,3,4,A,31,54,68,21,0.5263157894736842,44,30,14,0.45161290322580644,32,64,80,48,0.631578947368421,78,41,37,0.625,1,0,0,0,0,0,0,0,0.6,0.6,-10,-12,-27,-0.10526315789473684,-0.17338709677419356,-23
2002-03-30,Leicester,Blackburn,2,1,H,31,19,48,-12,0.3684210526315789,21,55,-34,0.0967741935483871,30,32,-1,-1,0.0,39,41,-2,0.26666666666666666,0,0,0,0,0,0,0,0,0.0,0.4,-13,49,-11,0.3684210526315789,-0.16989247311827957,-32
2002-03-30,Liverpool,Charlton,2,0,H,32,65,69,32,0.5263157894736842,53,26,27,0.59375,31,41,52,-7,0.3684210526315789,35,36,-1,0.3225806451612903,1,0,0,0,0,0,0,0,0.8,0.4,24,17,39,0.15789473684210525,0.2711693548387097,28
2002-03-30,Middlesbrough,Tottenham,1,1,D,31,38,42,0,0.2368421052631579,30,38,-8,0.3225806451612903,31,41,49,-7,0.34210526315789475,41,45,-4,0.3870967741935484,0,0,0,0,0,0,0,0,0.4,0.4,-3,-7,7,-0.10526315789473684,-0.06451612903225806,-4
2002-03-30,Southampton,Fulham,1,1,D,31,37,52,-8,0.3684210526315789,38,46,-8,0.3225806451612903,31,35,-1,-1,0.0,30,38,-8,0.25806451612903225,0,0,0,0,0,0,1,1,0.2,0.0,2,53,-7,0.3684210526315789,0.06451612903225806,0
2002-03-30,West Ham,Ipswich,3,1,H,30,37,42,-5,0.2631578947368421,35,49,-14,0.3333333333333333,31,32,66,15,0.5263157894736842,38,49,-11,0.25806451612903225,0,0,0,0,0,0,0,0,0.4,0.0,5,-24,-20,-0.2631578947368421,0.07526881720430106,-3
2002-04-01,Blackburn,Southampton,2,0,H,31,32,-1,-1,0.0,40,43,-3,0.25806451612903225,32,38,52,-8,0.3684210526315789,39,47,-8,0.3125,0,0,0,0,0,0,0,0,0.4,0.2,-6,-53,7,-0.3684210526315789,-0.05443548387096775,5
2002-04-01,Charlton,Arsenal,0,3,A,32,41,52,-7,0.3684210526315789,35,38,-3,0.3125,31,66,70,25,0.5263157894736842,63,32,31,0.6129032258064516,0,0,0,0,1,1,0,0,0.4,1.0,-25,-18,-32,-0.15789473684210525,-0.3004032258064516,-34
2002-04-01,Derby,Middlesbrough,0,1,A,32,29,42,-22,0.2631578947368421,30,53,-23,0.25,32,39,42,0,0.2368421052631579,31,39,-8,0.3125,0,0,0,0,0,0,0,0,0.2,0.4,-10,0,-22,0.02631578947368418,-0.0625,-15
2002-04-01,Everton,Bolton,3,1,H,32,36,42,-14,0.2894736842105263,35,45,-10,0.28125,32,36,-1,-1,0.0,37,50,-13,0.25,0,0,0,0,0,0,0,0,0.4,0.4,0,43,-13,0.2894736842105263,0.03125,3
2002-04-01,Fulham,West Ham,0,1,A,32,36,-1,-1,0.0,31,39,-8,0.25,31,40,42,-5,0.2631578947368421,38,50,-12,0.3548387096774194,0,0,0,0,0,0,0,0,0.0,0.6,-4,-43,4,-0.2631578947368421,-0.10483870967741937,4
2002-04-01,Ipswich,Chelsea,0,0,D,32,32,66,15,0.5263157894736842,39,52,-13,0.25,32,56,61,23,0.4473684210526316,60,32,28,0.46875,0,0,0,0,0,0,0,0,0.0,0.8,-24,5,-8,0.0789473684210526,-0.21875,-41
2002-04-01,Sunderland,Leicester,2,1,H,32,35,57,5,0.3947368421052632,24,41,-17,0.28125,32,22,48,-12,0.3684210526315789,23,56,-33,0.125,0,0,0,0,0,0,0,0,0.2,0.2,13,9,17,0.026315789473684292,0.15625,16
2002-04-01,Tottenham,Leeds,2,1,H,32,42,49,-7,0.34210526315789475,42,46,-4,0.375,32,54,68,21,0.5263157894736842,47,34,13,0.4375,0,0,0,0,0,0,0,0,0.2,0.6,-12,-19,-28,-0.18421052631578944,-0.0625,-17
2002-04-02,Aston Villa,Newcastle,1,1,D,32,42,54,3,0.34210526315789475,37,39,-2,0.3125,31,59,51,-6,0.3684210526315789,60,42,18,0.5806451612903226,0,0,0,0,0,0,0,0,0.2,0.4,-17,3,9,-0.02631578947368418,-0.2681451612903226,-20
2002-04-06,Arsenal,Tottenham,2,1,H,32,69,70,25,0.5263157894736842,66,32,34,0.625,33,45,49,-7,0.34210526315789475,44,47,-3,0.3939393939393939,1,1,0,0,0,0,0,0,1.0,0.4,24,21,32,0.18421052631578944,0.23106060606060608,37
2002-04-06,Bolton,Ipswich,4,1,H,33,36,-1,-1,0.0,38,53,-15,0.24242424242424243,33,33,66,15,0.5263157894736842,39,52,-13,0.24242424242424243,0,0,0,0,0,0,0,0,0.4,0.0,3,-67,-16,-0.5263157894736842,0.0,-2
2002-04-06,Chelsea,Everton,3,0,H,33,57,61,23,0.4473684210526316,60,32,28,0.45454545454545453,33,39,42,-14,0.2894736842105263,38,46,-8,0.30303030303030304,0,0,0,0,0,0,0,0,0.6,0.6,18,19,37,0.15789473684210525,0.1515151515151515,36
2002-04-06,Leicester,Man United,0,1,A,33,22,48,-12,0.3684210526315789,24,58,-34,0.12121212121212122,33,67,80,48,0.631578947368421,82,44,38,0.6363636363636364,0,0,0,0,0,0,0,0,0.2,0.6,-45,-32,-60,-0.2631578947368421,-0.5151515151515151,-72
2002-04-06,Middlesbrough,Aston Villa,2,1,H,33,42,42,0,0.2368421052631579,32,39,-7,0.3333333333333333,33,43,54,3,0.34210526315789475,38,40,-2,0.30303030303030304,0,0,0,0,0,0,0,0,0.4,0.0,-1,-12,-3,-0.10526315789473684,0.030303030303030276,-5
2002-04-06,Southampton,Derby,2,0,H,33,38,52,-8,0.3684210526315789,39,49,-10,0.30303030303030304,33,29,42,-22,0.2631578947368421,30,54,-24,0.24242424242424243,0,0,0,0,0,0,1,0,0.0,0.2,9,10,14,0.10526315789473684,0.06060606060606061,14
2002-04-06,West Ham,Charlton,2,0,H,32,43,42,-5,0.2631578947368421,39,50,-11,0.375,33,41,52,-7,0.3684210526315789,35,41,-6,0.30303030303030304,0,0,0,0,0,0,1,0,0.6,0.2,2,-10,2,-0.10526315789473684,0.07196969696969696,-5
2002-04-07,Leeds,Sunderland,2,0,H,33,54,68,21,0.5263157894736842,48,36,12,0.42424242424242425,33,38,57,5,0.3947368421052632,26,42,-16,0.30303030303030304,0,0,0,0,0,0,0,0,0.6,0.4,16,11,16,0.13157894736842096,0.12121212121212122,28
2002-04-08,Newcastle,Fulham,1,1,D,32,60,51,-6,0.3684210526315789,61,43,18,0.5625,33,36,-1,-1,0.0,31,40,-9,0.24242424242424243,0,0,0,0,0,0,0,0,0.2,0.0,24,52,-5,0.3684210526315789,0.32007575757575757,27
2002-04-10,Blackburn,Chelsea,0,0,D,32,35,-1,-1,0.0,42,43,-1,0.28125,34,60,61,23,0.4473684210526316,63,32,31,0.47058823529411764,0,0,0,0,0,0,0,0,0.6,0.6,-25,-62,-24,-0.4473684210526316,-0.18933823529411764,-32
2002-04-13,Aston Villa,Leeds,0,1,A,34,43,54,3,0.34210526315789475,39,42,-3,0.29411764705882354,34,57,68,21,0.5263157894736842,50,36,14,0.4411764705882353,0,0,0,0,0,0,0,0,0.0,0.6,-14,-14,-18,-0.18421052631578944,-0.14705882352941174,-17
2002-04-13,Charlton,Southampton,1,1,D,34,41,52,-7,0.3684210526315789,35,43,-8,0.29411764705882354,34,41,52,-8,0.3684210526315789,41,49,-8,0.3235294117647059,0,0,1,0,0,0,0,0,0.2,0.2,0,0,1,0.0,-0.02941176470588236,0
2002-04-13,Derby,Newcastle,2,3,A,34,29,42,-22,0.2631578947368421,30,56,-26,0.23529411764705882,33,61,51,-6,0.3684210526315789,62,44,18,0.5454545454545454,0,0,1,0,0,0,0,0,0.2,0.2,-32,-9,-16,-0.10526315789473684,-0.3101604278074866,-44
2002-04-13,Everton,Leicester,2,2,D,34,39,42,-14,0.2894736842105263,38,49,-11,0.29411764705882354,34,22,48,-12,0.3684210526315789,24,59,-35,0.11764705882352941,0,0,0,0,0,0,0,0,0.6,0.2,17,-6,-2,-0.0789473684210526,0.17647058823529413,24
2002-04-13,Sunderland,Liverpool,0,1,A,34,38,57,5,0.3947368421052632,26,44,-18,0.29411764705882354,33,68,69,32,0.5263157894736842,55,26,29,0.6060606060606061,0,0,0,0,1,1,0,0,0.2,1.0,-30,-12,-27,-0.13157894736842096,-0.31194295900178254,-47
2002-04-13,Tottenham,West Ham,1,1,D,34,45,49,-7,0.34210526315789475,45,49,-4,0.38235294117647056,33,46,42,-5,0.2631578947368421,41,50,-9,0.3939393939393939,0,0,0,0,1,0,0,0,0.4,0.8,-1,7,-2,0.07894736842105265,-0.01158645276292336,5
2002-04-20,Bolton,Tottenham,1,1,D,34,39,-1,-1,0.0,42,54,-12,0.2647058823529412,35,46,49,-7,0.34210526315789475,46,50,-4,0.37142857142857144,0,0,0,0,0,0,0,0,0.6,0.4,-7,-50,6,-0.34210526315789475,-0.10672268907563026,-8
2002-04-20,Chelsea,Man United,0,3,A,35,61,61,23,0.4473684210526316,63,32,31,0.45714285714285713,34,70,80,48,0.631578947368421,83,44,39,0.6470588235294118,0,0,0,0,0,0,0,0,0.4,0.8,-9,-19,-25,-0.18421052631578944,-0.18991596638655467,-8
2002-04-20,Leeds,Fulham,0,1,A,35,60,68,21,0.5263157894736842,51,36,15,0.45714285714285713,34,37,-1,-1,0.0,32,41,-9,0.23529411764705882,0,0,0,0,0,0,0,0,0.6,0.0,23,69,22,0.5263157894736842,0.2218487394957983,24
2002-04-20,Leicester,Aston Villa,2,2,D,35,23,48,-12,0.3684210526315789,26,61,-35,0.11428571428571428,35,43,54,3,0.34210526315789475,39,43,-4,0.2857142857142857,0,0,0,0,0,0,0,0,0.2,0.0,-20,-6,-15,0.02631578947368418,-0.17142857142857143,-31
2002-04-20,Liverpool,Derby,2,0,H,34,71,69,32,0.5263157894736842,56,26,30,0.6176470588235294,35,29,42,-22,0.2631578947368421,32,59,-27,0.22857142857142856,1,1,0,0,0,0,1,1,1.0,0.0,42,27,54,0.2631578947368421,0.3890756302521009,57
2002-04-20,Middlesbrough,Blackburn,1,3,A,34,45,42,0,0.2368421052631579,34,40,-6,0.35294117647058826,33,36,-1,-1,0.0,42,43,-1,0.2727272727272727,0,0,0,0,0,0,0,0,0.6,0.4,9,43,1,0.2368421052631579,0.08021390374331555,-5
2002-04-20,Newcastle,Charlton,3,0,H,34,64,51,-6,0.3684210526315789,65,46,19,0.5588235294117647,35,42,52,-7,0.3684210526315789,36,44,-8,0.2857142857142857,0,0,0,0,0,0,0,0,0.4,0.0,22,-1,1,0.0,0.273109243697479,27
2002-04-20,Southampton,Everton,0,1,A,35,42,52,-8,0.3684210526315789,42,50,-8,0.3142857142857143,35,40,42,-14,0.2894736842105263,40,51,-11,0.2857142857142857,0,0,0,0,0,0,0,0,0.2,0.4,2,10,6,0.0789473684210526,0.02857142857142858,3
2002-04-20,West Ham,Sunderland,3,0,H,34,47,42,-5,0.2631578947368421,42,51,-9,0.38235294117647056,35,38,57,5,0.3947368421052632,26,45,-19,0.2857142857142857,0,0,0,0,0,0,0,0,0.6,0.2,9,-15,-10,-0.13157894736842113,0.09663865546218486,10
2002-04-21,Arsenal,Ipswich,2,0,H,33,72,70,25,0.5263157894736842,68,33,35,0.6363636363636364,34,33,66,15,0.5263157894736842,40,56,-16,0.23529411764705882,1,1,0,0,0,0,0,0,1.0,0.0,39,4,10,0.0,0.40106951871657753,51
2002-04-23,Blackburn,Newcastle,2,2,D,34,39,-1,-1,0.0,45,44,1,0.29411764705882354,35,67,51,-6,0.3684210526315789,68,46,22,0.5714285714285714,0,0,0,0,0,0,0,0,0.4,0.6,-28,-52,5,-0.3684210526315789,-0.27731092436974786,-21
2002-04-23,Fulham,Bolton,3,0,H,35,40,-1,-1,0.0,33,41,-8,0.2571428571428571,35,40,-1,-1,0.0,43,55,-12,0.2571428571428571,0,0,0,0,0,0,0,0,0.2,0.6,0,0,0,0.0,0.0,4
2002-04-24,Arsenal,West Ham,2,0,H,34,75,70,25,0.5263157894736842,70,33,37,0.6470588235294118,35,50,42,-5,0.2631578947368421,45,51,-6,0.4,1,1,0,0,0,0,0,0,1.0,0.8,25,28,30,0.2631578947368421,0.24705882352941178,43
2002-04-24,Ipswich,Middlesbrough,1,0,H,35,33,66,15,0.5263157894736842,40,58,-18,0.22857142857142856,35,45,42,0,0.2368421052631579,35,43,-8,0.34285714285714286,0,0,0,0,0,0,0,0,0.0,0.6,-12,24,15,0.28947368421052627,-0.1142857142857143,-10
2002-04-27,Aston Villa,Southampton,2,1,H,36,44,54,3,0.34210526315789475,41,45,-4,0.2777777777777778,36,42,52,-8,0.3684210526315789,42,51,-9,0.3055555555555556,0,0,0,0,0,0,0,0,0.0,0.2,2,2,11,-0.02631578947368418,-0.02777777777777779,5
2002-04-27,Charlton,Sunderland,2,2,D,36,42,52,-7,0.3684210526315789,36,47,-11,0.2777777777777778,36,38,57,5,0.3947368421052632,26,48,-22,0.2777777777777778,0,0,0,0,0,0,1,0,0.0,0.2,4,-5,-12,-0.026315789473684292,0.0,11
2002-04-27,Derby,Leeds,0,1,A,36,29,42,-22,0.2631578947368421,32,61,-29,0.2222222222222222,36,60,68,21,0.5263157894736842,51,37,14,0.4444444444444444,0,0,1,1,0,0,0,0,0.0,0.4,-31,-26,-43,-0.2631578947368421,-0.2222222222222222,-43
2002-04-27,Fulham,Leicester,0,0,D,36,43,-1,-1,0.0,36,41,-5,0.2777777777777778,36,24,48,-12,0.3684210526315789,28,63,-35,0.1111111111111111,0,0,0,0,0,0,0,0,0.4,0.2,19,-49,11,-0.3684210526315789,0.16666666666666669,30
2002-04-27,Ipswich,Man United,0,1,A,36,36,66,15,0.5263157894736842,41,58,-17,0.25,35,73,80,48,0.631578947368421,86,44,42,0.6571428571428571,0,0,0,0,1,0,0,0,0.2,0.8,-37,-14,-33,-0.10526315789473684,-0.40714285714285714,-59
2002-04-27,Middlesbrough,Chelsea,0,2,A,36,45,42,0,0.2368421052631579,35,44,-9,0.3333333333333333,36,61,61,23,0.4473684210526316,63,35,28,0.4444444444444444,0,0,0,0,0,0,0,0,0.4,0.4,-16,-19,-23,-0.21052631578947367,-0.1111111111111111,-37
2002-04-27,Newcastle,West Ham,3,1,H,36,68,51,-6,0.3684210526315789,70,48,22,0.5555555555555556,36,50,42,-5,0.2631578947368421,45,53,-8,0.3888888888888889,0,0,0,0,0,0,0,0,0.4,0.6,18,9,-1,0.10526315789473684,0.16666666666666669,30
2002-04-27,Tottenham,Liverpool,1,0,H,36,47,49,-7,0.34210526315789475,47,51,-4,0.3611111111111111,35,74,69,32,0.5263157894736842,58,26,32,0.6285714285714286,0,0,0,0,1,1,0,0,0.2,1.0,-27,-20,-39,-0.18421052631578944,-0.26746031746031745,-36
2002-04-28,Everton,Blackburn,1,2,A,36,43,42,-14,0.2894736842105263,41,51,-10,0.3055555555555556,35,40,-1,-1,0.0,47,46,1,0.2857142857142857,0,0,0,0,0,0,0,0,0.4,0.4,3,43,-13,0.2894736842105263,0.019841269841269882,-11
2002-04-29,Bolton,Arsenal,0,2,A,36,40,-1,-1,0.0,43,58,-15,0.25,35,78,70,25,0.5263157894736842,72,33,39,0.6571428571428571,0,0,0,0,1,1,0,0,0.4,1.0,-38,-71,-26,-0.5263157894736842,-0.40714285714285714,-54
2002-05-08,Liverpool,Blackburn,4,3,H,36,74,69,32,0.5263157894736842,58,27,31,0.6111111111111112,36,43,-1,-1,0.0,49,47,2,0.3055555555555556,0,0,0,0,0,0,0,0,0.8,0.6,31,70,33,0.5263157894736842,0.3055555555555556,29
2002-05-08,Man United,Arsenal,0,1,A,36,76,80,48,0.631578947368421,87,44,43,0.6666666666666666,36,81,70,25,0.5263157894736842,74,33,41,0.6666666666666666,1,0,0,0,1,1,0,0,0.8,1.0,-5,10,23,0.10526315789473684,0.0,2
2002-05-11,Arsenal,Everton,4,3,H,37,84,70,25,0.5263157894736842,75,33,42,0.6756756756756757,37,43,42,-14,0.2894736842105263,42,53,-11,0.2972972972972973,1,1,0,0,0,0,0,0,1.0,0.4,41,28,39,0.23684210526315785,0.37837837837837834,53
2002-05-11,Blackburn,Fulham,3,0,H,37,43,-1,-1,0.0,52,51,1,0.2972972972972973,37,44,-1,-1,0.0,36,41,-5,0.2702702702702703,0,0,0,0,0,0,0,0,0.4,0.4,-1,0,0,0.0,0.02702702702702703,6
2002-05-11,Chelsea,Aston Villa,1,3,A,37,64,61,23,0.4473684210526316,65,35,30,0.4594594594594595,37,47,54,3,0.34210526315789475,43,46,-3,0.2972972972972973,0,0,0,0,0,0,0,0,0.4,0.2,17,7,20,0.10526315789473684,0.16216216216216217,33
2002-05-11,Leeds,Middlesbrough,1,0,H,37,63,68,21,0.5263157894736842,52,37,15,0.4594594594594595,37,45,42,0,0.2368421052631579,35,46,-11,0.32432432432432434,0,0,0,0,0,0,1,0,0.6,0.4,18,26,21,0.28947368421052627,0.13513513513513514,26
2002-05-11,Leicester,Tottenham,2,1,H,37,25,48,-12,0.3684210526315789,28,63,-35,0.10810810810810811,37,50,49,-7,0.34210526315789475,48,51,-3,0.3783783783783784,0,0,0,0,0,0,0,0,0.0,0.4,-25,-1,-5,0.02631578947368418,-0.2702702702702703,-32
2002-05-11,Liverpool,Ipswich,5,0,H,37,77,69,32,0.5263157894736842,62,30,32,0.6216216216216216,37,36,66,15,0.5263157894736842,41,59,-18,0.24324324324324326,0,0,0,0,0,0,0,0,0.8,0.2,41,3,17,0.0,0.37837837837837834,50
2002-05-11,Man United,Charlton,0,0,D,37,76,80,48,0.631578947368421,87,45,42,0.6486486486486487,37,43,52,-7,0.3684210526315789,38,49,-11,0.2702702702702703,0,0,0,0,0,0,0,0,0.8,0.0,33,28,55,0.2631578947368421,0.3783783783783784,53
2002-05-11,Southampton,Newcastle,3,1,H,37,42,52,-8,0.3684210526315789,43,53,-10,0.2972972972972973,37,71,51,-6,0.3684210526315789,73,49,24,0.5675675675675675,0,0,0,0,0,0,0,0,0.2,0.6,-29,1,-2,0.0,-0.27027027027027023,-34
2002-05-11,Sunderland,Derby,1,1,D,37,39,57,5,0.3947368421052632,28,50,-22,0.2702702702702703,37,29,42,-22,0.2631578947368421,32,62,-30,0.21621621621621623,0,0,0,0,0,0,1,1,0.2,0.0,10,15,27,0.13157894736842113,0.05405405405405406,8
2002-05-11,West Ham,Bolton,2,1,H,37,50,42,-5,0.2631578947368421,46,56,-10,0.3783783783783784,37,40,-1,-1,0.0,43,60,-17,0.24324324324324326,0,0,0,0,0,0,0,0,0.4,0.2,10,43,-4,0.2631578947368421,0.13513513513513514,7
