Date,HomeTeam,AwayTeam,FTHG,FTAG,FTR,HT_match_played,HT_current_standing,HT_past_standing,HT_past_goal_diff,HT_past_win_rate,HT_goal_for,HT_goal_against,HT_goal_diff,HT_win_rate_season,AT_match_played,AT_current_standing,AT_past_standing,AT_past_goal_diff,AT_past_win_rate,AT_goal_for,AT_goal_against,AT_goal_diff,AT_win_rate_season,HT_3_win_streak,HT_5_win_streak,HT_3_lose_Streak,HT_5_lose_Streak,AT_3_win_streak,AT_5_win_streak,AT_3_lose_Streak,AT_5_lose_Streak,HT_5_win_rate,AT_5_win_rate,current_standing_diff,past_standing_diff,past_goal_diff_diff,past_win_rate_diff,win_rate_season_diff,goal_diff_diff
2002-08-17,Blackburn,Sunderland,0,0,D,0,0,46,4,0.3157894736842105,0,0,0,,0,0,40,-22,0.2631578947368421,0,0,0,,0,0,0,0,0,0,0,0,,,0,6,26,0.05263157894736842,,0
2002-08-17,Charlton,Chelsea,2,3,A,0,0,44,-11,0.2631578947368421,0,0,0,,0,0,64,28,0.4473684210526316,0,0,0,,0,0,0,0,0,0,0,0,,,0,-20,-39,-0.1842105263157895,,0
2002-08-17,Everton,Tottenham,2,2,D,0,0,43,-12,0.2894736842105263,0,0,0,,0,0,50,-4,0.3684210526315789,0,0,0,,0,0,0,0,0,0,0,0,,,0,-7,-8,-0.0789473684210526,,0
2002-08-17,Fulham,Bolton,4,1,H,0,0,44,-8,0.2631578947368421,0,0,0,,0,0,40,-18,0.2368421052631579,0,0,0,,0,0,0,0,0,0,0,0,,,0,4,10,0.02631578947368418,,0
2002-08-17,Leeds,Man City,3,0,H,0,0,66,16,0.4736842105263158,0,0,0,,0,0,-1,-1,0.0,0,0,0,,0,0,0,0,0,0,0,0,,,0,67,17,0.4736842105263158,,0
2002-08-17,Man United,West Brom,1,0,H,0,0,77,42,0.631578947368421,0,0,0,,0,0,-1,-1,0.0,0,0,0,,0,0,0,0,0,0,0,0,,,0,78,43,0.631578947368421,,0
2002-08-17,Southampton,Middlesboro,0,0,D,0,0,45,-8,0.3157894736842105,0,0,0,,0,0,-1,-1,0.0,0,0,0,,0,0,0,0,0,0,0,0,,,0,46,-7,0.3157894736842105,,0
2002-08-18,Arsenal,Birmingham,2,0,H,0,0,87,43,0.6842105263157895,0,0,0,,0,0,-1,-1,0.0,0,0,0,,0,0,0,0,0,0,0,0,,,0,88,44,0.6842105263157895,,0
2002-08-18,Aston Villa,Liverpool,0,1,A,0,0,50,-1,0.3157894736842105,0,0,0,,0,0,80,37,0.631578947368421,0,0,0,,0,0,0,0,0,0,0,0,,,0,-30,-38,-0.3157894736842105,,0
2002-08-19,Newcastle,West Ham,4,0,H,0,0,71,22,0.5526315789473685,0,0,0,,0,0,53,-9,0.3947368421052632,0,0,0,,0,0,0,0,0,0,0,0,,,0,18,31,0.15789473684210525,,0
2002-08-23,Chelsea,Man United,2,2,D,1,3,64,28,0.4473684210526316,3,2,1,1.0,1,3,77,42,0.631578947368421,1,0,1,1.0,0,0,0,0,0,0,0,0,,,0,-13,-14,-0.18421052631578944,0.0,0
2002-08-24,Birmingham,Blackburn,0,1,A,1,0,-1,-1,0.0,0,2,-2,0.0,1,1,46,4,0.3157894736842105,0,0,0,0.0,0,0,0,0,0,0,0,0,,,-1,-47,-5,-0.3157894736842105,0.0,-2
2002-08-24,Bolton,Charlton,1,2,A,1,0,40,-18,0.2368421052631579,1,4,-3,0.0,1,0,44,-11,0.2631578947368421,2,3,-1,0.0,0,0,0,0,0,0,0,0,,,0,-4,-7,-0.02631578947368418,0.0,-2
2002-08-24,Liverpool,Southampton,3,0,H,1,3,80,37,0.631578947368421,1,0,1,1.0,1,1,45,-8,0.3157894736842105,0,0,0,0.0,0,0,0,0,0,0,0,0,,,2,35,45,0.3157894736842105,1.0,1
2002-08-24,Man City,Newcastle,1,0,H,1,0,-1,-1,0.0,0,3,-3,0.0,1,3,71,22,0.5526315789473685,4,0,4,1.0,0,0,0,0,0,0,0,0,,,-3,-72,-23,-0.5526315789473685,-1.0,-7
2002-08-24,Middlesboro,Fulham,2,2,D,1,1,-1,-1,0.0,0,0,0,0.0,1,3,44,-8,0.2631578947368421,4,1,3,1.0,0,0,0,0,0,0,0,0,,,-2,-45,7,-0.2631578947368421,-1.0,-3
2002-08-24,Sunderland,Everton,0,1,A,1,1,40,-22,0.2631578947368421,0,0,0,0.0,1,1,43,-12,0.2894736842105263,2,2,0,0.0,0,0,0,0,0,0,0,0,,,0,-3,-10,-0.026315789473684237,0.0,0
2002-08-24,Tottenham,Aston Villa,1,0,H,1,1,50,-4,0.3684210526315789,2,2,0,0.0,1,0,50,-1,0.3157894736842105,0,1,-1,0.0,0,0,0,0,0,0,0,0,,,1,0,-3,0.05263157894736842,0.0,1
2002-08-24,West Brom,Leeds,1,3,A,1,0,-1,-1,0.0,0,1,-1,0.0,1,3,66,16,0.4736842105263158,3,0,3,1.0,0,0,0,0,0,0,0,0,,,-3,-67,-17,-0.4736842105263158,-1.0,-4
2002-08-24,West Ham,Arsenal,2,2,D,1,0,53,-9,0.3947368421052632,0,4,-4,0.0,1,3,87,43,0.6842105263157895,2,0,2,1.0,0,0,0,0,0,0,0,0,,,-3,-34,-52,-0.28947368421052627,-1.0,-6
2002-08-27,Arsenal,West Brom,5,2,H,2,4,87,43,0.6842105263157895,4,2,2,0.5,2,0,-1,-1,0.0,1,4,-3,0.0,0,0,0,0,0,0,0,0,,,4,88,44,0.6842105263157895,0.5,5
2002-08-27,Charlton,Tottenham,0,1,A,2,3,44,-11,0.2631578947368421,4,4,0,0.5,2,4,50,-4,0.3684210526315789,3,2,1,0.5,0,0,0,0,0,0,0,0,,,-1,-6,-7,-0.10526315789473684,0.0,-1
2002-08-28,Aston Villa,Man City,1,0,H,2,0,50,-1,0.3157894736842105,0,2,-2,0.0,2,3,-1,-1,0.0,1,3,-2,0.5,0,0,0,0,0,0,0,0,,,-3,51,0,0.3157894736842105,-0.5,0
2002-08-28,Blackburn,Liverpool,2,2,D,2,4,46,4,0.3157894736842105,1,0,1,0.5,2,6,80,37,0.631578947368421,4,0,4,1.0,0,0,0,0,0,0,0,0,,,-2,-34,-33,-0.3157894736842105,-0.5,-3
2002-08-28,Everton,Birmingham,1,1,D,2,4,43,-12,0.2894736842105263,3,2,1,0.5,2,0,-1,-1,0.0,0,3,-3,0.0,0,0,0,0,0,0,0,0,,,4,44,-11,0.2894736842105263,0.5,4
2002-08-28,Leeds,Sunderland,0,1,A,2,6,66,16,0.4736842105263158,6,1,5,1.0,2,1,40,-22,0.2631578947368421,0,1,-1,0.0,0,0,0,0,0,0,0,0,,,5,26,38,0.21052631578947373,1.0,6
2002-08-28,Southampton,Chelsea,1,1,D,2,1,45,-8,0.3157894736842105,0,3,-3,0.0,2,4,64,28,0.4473684210526316,5,4,1,0.5,0,0,0,0,0,0,0,0,,,-3,-19,-36,-0.13157894736842107,-0.5,-4
2002-08-31,Birmingham,Leeds,2,1,H,3,1,-1,-1,0.0,1,4,-3,0.0,3,6,66,16,0.4736842105263158,6,2,4,0.6666666666666666,0,0,0,0,0,0,0,0,,,-5,-67,-17,-0.4736842105263158,-0.6666666666666666,-7
2002-08-31,Man City,Everton,3,1,H,3,3,-1,-1,0.0,1,4,-3,0.3333333333333333,3,5,43,-12,0.2894736842105263,4,3,1,0.3333333333333333,0,0,0,0,0,0,0,0,,,-2,-44,11,-0.2894736842105263,0.0,-4
2002-08-31,Middlesboro,Blackburn,1,0,H,2,2,-1,-1,0.0,2,2,0,0.0,3,5,46,4,0.3157894736842105,3,2,1,0.3333333333333333,0,0,0,0,0,0,0,0,,,-3,-47,-5,-0.3157894736842105,-0.3333333333333333,-1
2002-08-31,Sunderland,Man United,1,1,D,3,4,40,-22,0.2631578947368421,1,1,0,0.3333333333333333,2,4,77,42,0.631578947368421,3,2,1,0.5,0,0,0,0,0,0,0,0,,,0,-37,-64,-0.3684210526315789,-0.16666666666666669,-1
2002-08-31,Tottenham,Southampton,2,1,H,3,7,50,-4,0.3684210526315789,4,2,2,0.6666666666666666,3,2,45,-8,0.3157894736842105,1,4,-3,0.0,0,0,0,0,0,0,0,0,,,5,5,4,0.05263157894736842,0.6666666666666666,5
2002-08-31,West Brom,Fulham,1,0,H,3,0,-1,-1,0.0,3,9,-6,0.0,2,4,44,-8,0.2631578947368421,6,3,3,0.5,0,0,0,0,0,0,0,0,,,-4,-45,7,-0.2631578947368421,-0.5,-9
2002-08-31,West Ham,Charlton,0,2,A,2,1,53,-9,0.3947368421052632,2,6,-4,0.0,3,3,44,-11,0.2631578947368421,4,5,-1,0.3333333333333333,0,0,0,0,0,0,0,0,,,-2,9,2,0.13157894736842113,-0.3333333333333333,-3
2002-09-01,Bolton,Aston Villa,1,0,H,2,0,40,-18,0.2368421052631579,2,6,-4,0.0,3,3,50,-1,0.3157894736842105,1,2,-1,0.3333333333333333,0,0,0,0,0,0,0,0,,,-3,-10,-17,-0.0789473684210526,-0.3333333333333333,-3
2002-09-01,Chelsea,Arsenal,1,1,D,3,5,64,28,0.4473684210526316,6,5,1,0.3333333333333333,3,7,87,43,0.6842105263157895,9,4,5,0.6666666666666666,0,0,0,0,0,0,0,0,,,-2,-23,-15,-0.2368421052631579,-0.3333333333333333,-4
2002-09-02,Liverpool,Newcastle,2,2,D,3,7,80,37,0.631578947368421,6,2,4,0.6666666666666666,2,3,71,22,0.5526315789473685,4,1,3,0.5,0,0,0,0,0,0,0,0,,,4,9,15,0.07894736842105254,0.16666666666666663,1
2002-09-03,Man United,Middlesboro,1,0,H,3,5,77,42,0.631578947368421,4,3,1,0.3333333333333333,3,5,-1,-1,0.0,3,2,1,0.3333333333333333,0,0,0,0,0,0,0,0,,,0,78,43,0.631578947368421,0.0,0
2002-09-10,Arsenal,Man City,2,1,H,4,8,87,43,0.6842105263157895,10,5,5,0.5,4,6,-1,-1,0.0,4,5,-1,0.5,0,0,0,0,0,0,0,0,,,2,88,44,0.6842105263157895,0.0,6
2002-09-10,Middlesboro,Sunderland,3,0,H,4,5,-1,-1,0.0,3,3,0,0.25,4,5,40,-22,0.2631578947368421,2,2,0,0.25,0,0,0,0,0,0,0,0,,,0,-41,21,-0.2631578947368421,0.0,0
2002-09-11,Aston Villa,Charlton,2,0,H,4,3,50,-1,0.3157894736842105,1,3,-2,0.25,4,6,44,-11,0.2631578947368421,6,5,1,0.5,0,0,0,0,0,0,0,0,,,-3,6,10,0.05263157894736842,-0.25,-3
2002-09-11,Blackburn,Chelsea,2,3,A,4,5,46,4,0.3157894736842105,3,3,0,0.25,4,6,64,28,0.4473684210526316,7,6,1,0.25,0,0,0,0,0,0,0,0,,,-1,-18,-24,-0.13157894736842107,0.0,-1
2002-09-11,Fulham,Tottenham,3,2,H,3,4,44,-8,0.2631578947368421,6,4,2,0.3333333333333333,4,10,50,-4,0.3684210526315789,6,3,3,0.75,0,0,0,0,1,0,0,0,,,-6,-6,-4,-0.10526315789473684,-0.4166666666666667,-1
2002-09-11,Liverpool,Birmingham,2,2,D,4,8,80,37,0.631578947368421,8,4,4,0.5,4,4,-1,-1,0.0,3,5,-2,0.25,0,0,0,0,0,0,0,0,,,4,81,38,0.631578947368421,0.25,6
2002-09-11,Man United,Bolton,0,1,A,4,8,77,42,0.631578947368421,5,3,2,0.5,3,3,40,-18,0.2368421052631579,3,6,-3,0.3333333333333333,0,0,0,0,0,0,0,0,,,5,37,60,0.3947368421052631,0.16666666666666669,5
2002-09-11,Newcastle,Leeds,0,2,A,3,4,71,22,0.5526315789473685,6,3,3,0.3333333333333333,4,6,66,16,0.4736842105263158,7,4,3,0.5,0,0,0,0,0,0,0,0,,,-2,5,6,0.07894736842105265,-0.16666666666666669,0
2002-09-11,Southampton,Everton,1,0,H,4,2,45,-8,0.3157894736842105,2,6,-4,0.0,4,5,43,-12,0.2894736842105263,5,6,-1,0.25,0,0,0,0,0,0,0,0,,,-3,2,4,0.02631578947368418,-0.25,-3
2002-09-11,West Ham,West Brom,0,1,A,3,1,53,-9,0.3947368421052632,2,8,-6,0.0,4,3,-1,-1,0.0,4,9,-5,0.25,0,0,0,0,0,0,0,0,,,-2,54,-8,0.3947368421052632,-0.25,-1
2002-09-14,Bolton,Liverpool,2,3,A,4,6,40,-18,0.2368421052631579,4,6,-2,0.5,5,9,80,37,0.631578947368421,10,6,4,0.4,0,0,0,0,0,0,0,0,,0.4,-3,-40,-55,-0.3947368421052631,0.09999999999999998,-6
2002-09-14,Charlton,Arsenal,0,3,A,5,6,44,-11,0.2631578947368421,6,7,-1,0.4,5,11,87,43,0.6842105263157895,12,6,6,0.6,0,0,0,0,0,0,0,0,0.4,0.6,-5,-43,-54,-0.4210526315789474,-0.19999999999999996,-7
2002-09-14,Chelsea,Newcastle,3,0,H,5,9,64,28,0.4473684210526316,10,8,2,0.4,4,4,71,22,0.5526315789473685,6,5,1,0.25,0,0,0,0,0,0,0,0,0.4,,5,-7,6,-0.10526315789473689,0.15000000000000002,1
2002-09-14,Everton,Middlesboro,2,1,H,5,5,43,-12,0.2894736842105263,5,7,-2,0.2,5,8,-1,-1,0.0,6,3,3,0.4,0,0,0,0,0,0,0,0,0.2,0.4,-3,44,-11,0.2894736842105263,-0.2,-5
2002-09-14,Leeds,Man United,1,0,H,5,9,66,16,0.4736842105263158,9,4,5,0.6,5,8,77,42,0.631578947368421,5,4,1,0.4,0,0,0,0,0,0,0,0,0.6,0.4,1,-11,-26,-0.1578947368421052,0.19999999999999996,4
2002-09-14,Sunderland,Fulham,0,3,A,5,5,40,-22,0.2631578947368421,2,5,-3,0.2,4,7,44,-8,0.2631578947368421,9,6,3,0.5,0,0,0,0,0,0,0,0,0.2,,-2,-4,-14,0.0,-0.3,-6
2002-09-14,West Brom,Southampton,1,0,H,5,6,-1,-1,0.0,5,9,-4,0.4,5,5,45,-8,0.3157894736842105,3,6,-3,0.2,0,0,0,0,0,0,0,0,0.4,0.2,1,-46,7,-0.3157894736842105,0.2,-1
2002-09-15,Man City,Blackburn,2,2,D,5,6,-1,-1,0.0,5,7,-2,0.4,5,5,46,4,0.3157894736842105,5,6,-1,0.2,0,0,0,0,0,0,0,0,0.4,0.2,1,-47,-5,-0.3157894736842105,0.2,-1
2002-09-15,Tottenham,West Ham,3,2,H,5,10,50,-4,0.3684210526315789,8,6,2,0.6,4,1,53,-9,0.3947368421052632,2,9,-7,0.0,0,0,0,0,0,0,0,0,0.6,,9,-3,5,-0.026315789473684292,0.6,9
2002-09-16,Birmingham,Aston Villa,3,0,H,5,5,-1,-1,0.0,5,7,-2,0.2,5,6,50,-1,0.3157894736842105,3,3,0,0.4,0,0,0,0,0,0,0,0,0.2,0.4,-1,-51,0,-0.3157894736842105,-0.2,-2
2002-09-21,Arsenal,Bolton,2,1,H,6,14,87,43,0.6842105263157895,15,6,9,0.6666666666666666,5,6,40,-18,0.2368421052631579,6,9,-3,0.4,0,0,0,0,0,0,0,0,0.6,0.4,8,47,61,0.4473684210526316,0.2666666666666666,12
2002-09-21,Liverpool,West Brom,2,0,H,6,12,80,37,0.631578947368421,13,8,5,0.5,6,9,-1,-1,0.0,6,9,-3,0.5,0,0,0,0,1,0,0,0,0.4,0.6,3,81,38,0.631578947368421,0.0,8
2002-09-21,Man United,Tottenham,1,0,H,6,8,77,42,0.631578947368421,5,5,0,0.3333333333333333,6,13,50,-4,0.3684210526315789,11,8,3,0.6666666666666666,0,0,0,0,0,0,0,0,0.2,0.8,-5,27,46,0.2631578947368421,-0.3333333333333333,-3
2002-09-21,Middlesboro,Birmingham,1,0,H,6,8,-1,-1,0.0,7,5,2,0.3333333333333333,6,8,-1,-1,0.0,8,7,1,0.3333333333333333,0,0,0,0,0,0,0,0,0.4,0.4,0,0,0,0.0,0.0,1
2002-09-21,Newcastle,Sunderland,2,0,H,5,4,71,22,0.5526315789473685,6,8,-2,0.2,6,5,40,-22,0.2631578947368421,2,8,-6,0.16666666666666666,0,0,0,0,0,0,0,0,0.2,0.2,-1,31,44,0.2894736842105264,0.033333333333333354,4
2002-09-21,Southampton,Charlton,0,0,D,6,5,45,-8,0.3157894736842105,3,7,-4,0.16666666666666666,6,6,44,-11,0.2631578947368421,6,10,-4,0.3333333333333333,0,0,0,0,0,0,0,0,0.2,0.4,-1,1,3,0.05263157894736842,-0.16666666666666666,0
2002-09-21,West Ham,Man City,0,0,D,5,1,53,-9,0.3947368421052632,4,12,-8,0.0,6,7,-1,-1,0.0,7,9,-2,0.3333333333333333,0,0,1,0,0,0,0,0,0.0,0.4,-6,54,-8,0.3947368421052632,-0.3333333333333333,-6
2002-09-22,Aston Villa,Everton,3,2,H,6,6,50,-1,0.3157894736842105,3,6,-3,0.3333333333333333,6,8,43,-12,0.2894736842105263,7,8,-1,0.3333333333333333,0,0,0,0,0,0,0,0,0.4,0.4,-2,7,11,0.02631578947368418,0.0,-2
2002-09-22,Blackburn,Leeds,1,0,H,6,6,46,4,0.3157894736842105,7,8,-1,0.16666666666666666,6,12,66,16,0.4736842105263158,10,4,6,0.6666666666666666,0,0,0,0,0,0,0,0,0.2,0.6,-6,-20,-12,-0.1578947368421053,-0.5,-7
2002-09-23,Fulham,Chelsea,0,0,D,5,10,44,-8,0.2631578947368421,12,6,6,0.6,6,12,64,28,0.4473684210526316,13,8,5,0.5,0,0,0,0,0,0,0,0,0.6,0.4,-2,-20,-36,-0.1842105263157895,0.09999999999999998,1
2002-09-28,Birmingham,Newcastle,0,2,A,7,8,-1,-1,0.0,8,8,0,0.2857142857142857,6,7,71,22,0.5526315789473685,8,8,0,0.3333333333333333,0,0,0,0,0,0,0,0,0.4,0.2,1,-72,-23,-0.5526315789473685,-0.047619047619047616,0
2002-09-28,Bolton,Southampton,1,1,D,6,6,40,-18,0.2368421052631579,7,11,-4,0.3333333333333333,7,6,45,-8,0.3157894736842105,3,7,-4,0.14285714285714285,0,0,0,0,0,0,0,0,0.4,0.2,0,-5,-10,-0.0789473684210526,0.19047619047619047,0
2002-09-28,Charlton,Man United,1,3,A,7,7,44,-11,0.2631578947368421,6,10,-4,0.2857142857142857,7,11,77,42,0.631578947368421,6,5,1,0.42857142857142855,0,0,0,0,0,0,0,0,0.2,0.4,-4,-33,-53,-0.3684210526315789,-0.14285714285714285,-5
2002-09-28,Chelsea,West Ham,2,3,A,7,13,64,28,0.4473684210526316,13,8,5,0.42857142857142855,6,2,53,-9,0.3947368421052632,4,12,-8,0.0,0,0,0,0,0,0,0,0,0.4,0.0,11,11,37,0.05263157894736836,0.42857142857142855,13
2002-09-28,Everton,Fulham,2,0,H,7,8,43,-12,0.2894736842105263,9,11,-2,0.2857142857142857,6,11,44,-8,0.2631578947368421,12,6,6,0.5,0,0,0,0,0,0,0,0,0.2,0.4,-3,-1,-4,0.026315789473684237,-0.2142857142857143,-8
2002-09-28,Leeds,Arsenal,1,4,A,7,12,66,16,0.4736842105263158,10,5,5,0.5714285714285714,7,17,87,43,0.6842105263157895,17,7,10,0.7142857142857143,0,0,0,0,1,0,0,0,0.4,0.8,-5,-21,-27,-0.21052631578947367,-0.1428571428571429,-5
2002-09-28,Man City,Liverpool,0,3,A,7,8,-1,-1,0.0,7,9,-2,0.2857142857142857,7,15,80,37,0.631578947368421,15,8,7,0.5714285714285714,0,0,0,0,0,0,0,0,0.2,0.4,-7,-81,-38,-0.631578947368421,-0.2857142857142857,-9
2002-09-28,Sunderland,Aston Villa,1,0,H,7,5,40,-22,0.2631578947368421,2,10,-8,0.14285714285714285,7,9,50,-1,0.3157894736842105,6,8,-2,0.42857142857142855,0,0,1,0,0,0,0,0,0.2,0.6,-4,-10,-21,-0.05263157894736842,-0.2857142857142857,-6
2002-09-28,Tottenham,Middlesboro,0,3,A,7,13,50,-4,0.3684210526315789,11,9,2,0.5714285714285714,7,11,-1,-1,0.0,8,5,3,0.42857142857142855,0,0,0,0,0,0,0,0,0.6,0.6,2,51,-3,0.3684210526315789,0.14285714285714285,-1
2002-09-30,West Brom,Blackburn,0,2,A,7,9,-1,-1,0.0,6,11,-5,0.42857142857142855,7,9,46,4,0.3157894736842105,8,8,0,0.2857142857142857,0,0,0,0,0,0,0,0,0.6,0.2,0,-47,-5,-0.3157894736842105,0.14285714285714285,-5
2002-10-05,Middlesboro,Bolton,2,0,H,8,14,-1,-1,0.0,11,5,6,0.5,7,7,40,-18,0.2368421052631579,8,12,-4,0.2857142857142857,0,0,0,0,0,0,0,0,0.6,0.4,7,-41,17,-0.2368421052631579,0.2142857142857143,10
2002-10-05,Newcastle,West Brom,2,1,H,7,10,71,22,0.5526315789473685,10,8,2,0.42857142857142855,8,9,-1,-1,0.0,6,13,-7,0.375,0,0,0,0,0,0,0,0,0.4,0.6,1,72,23,0.5526315789473685,0.05357142857142855,9
2002-10-05,Southampton,Man City,2,0,H,8,7,45,-8,0.3157894736842105,4,8,-4,0.125,8,8,-1,-1,0.0,7,12,-5,0.25,0,0,0,0,0,0,0,0,0.2,0.2,-1,46,-7,0.3157894736842105,-0.125,1
2002-10-05,West Ham,Birmingham,1,2,A,7,5,53,-9,0.3947368421052632,7,14,-7,0.14285714285714285,8,8,-1,-1,0.0,8,10,-2,0.25,0,0,0,0,0,0,0,0,0.2,0.4,-3,54,-8,0.3947368421052632,-0.10714285714285715,-5
2002-10-06,Arsenal,Sunderland,3,1,H,8,20,87,43,0.6842105263157895,21,8,13,0.75,8,8,40,-22,0.2631578947368421,3,10,-7,0.25,1,0,0,0,0,0,0,0,0.8,0.2,12,47,65,0.4210526315789474,0.5,20
2002-10-06,Aston Villa,Leeds,0,0,D,8,9,50,-1,0.3157894736842105,6,9,-3,0.375,8,12,66,16,0.4736842105263158,11,9,2,0.5,0,0,0,0,0,0,0,0,0.4,0.4,-3,-16,-17,-0.1578947368421053,-0.125,-5
2002-10-06,Blackburn,Tottenham,1,2,A,8,12,46,4,0.3157894736842105,10,8,2,0.375,8,13,50,-4,0.3684210526315789,11,12,-1,0.5,0,0,0,0,0,0,0,0,0.4,0.4,-1,-4,8,-0.05263157894736842,-0.125,3
2002-10-06,Fulham,Charlton,1,0,H,7,11,44,-8,0.2631578947368421,12,8,4,0.42857142857142855,8,7,44,-11,0.2631578947368421,7,13,-6,0.25,0,0,0,0,0,0,0,0,0.4,0.2,4,0,3,0.0,0.17857142857142855,10
2002-10-06,Liverpool,Chelsea,1,0,H,8,18,80,37,0.631578947368421,18,8,10,0.625,8,13,64,28,0.4473684210526316,15,11,4,0.375,1,0,0,0,0,0,0,0,0.6,0.4,5,16,9,0.18421052631578944,0.25,6
2002-10-07,Man United,Everton,3,0,H,8,14,77,42,0.631578947368421,9,6,3,0.5,8,11,43,-12,0.2894736842105263,11,11,0,0.375,0,0,0,0,0,0,0,0,0.6,0.4,3,34,54,0.3421052631578947,0.125,3
2002-10-19,Blackburn,Newcastle,5,2,H,9,12,46,4,0.3157894736842105,11,10,1,0.3333333333333333,8,13,71,22,0.5526315789473685,12,9,3,0.5,0,0,0,0,1,0,0,0,0.4,0.6,-1,-25,-18,-0.23684210526315796,-0.16666666666666669,-2
2002-10-19,Everton,Arsenal,2,1,H,9,11,43,-12,0.2894736842105263,11,14,-3,0.3333333333333333,9,23,87,43,0.6842105263157895,24,9,15,0.7777777777777778,0,0,0,0,1,1,0,0,0.4,1.0,-12,-44,-55,-0.39473684210526316,-0.4444444444444445,-18
2002-10-19,Fulham,Man United,1,1,D,8,14,44,-8,0.2631578947368421,13,8,5,0.5,9,17,77,42,0.631578947368421,12,6,6,0.5555555555555556,0,0,0,0,1,0,0,0,0.6,0.6,-3,-33,-50,-0.3684210526315789,-0.05555555555555558,-1
2002-10-19,Leeds,Liverpool,0,1,A,9,13,66,16,0.4736842105263158,11,9,2,0.4444444444444444,9,21,80,37,0.631578947368421,19,8,11,0.6666666666666666,0,0,0,0,1,0,0,0,0.4,0.8,-8,-14,-21,-0.1578947368421052,-0.2222222222222222,-9
2002-10-19,Man City,Chelsea,0,3,A,9,8,-1,-1,0.0,7,14,-7,0.2222222222222222,9,13,64,28,0.4473684210526316,15,12,3,0.3333333333333333,0,0,0,0,0,0,0,0,0.0,0.4,-5,-65,-29,-0.4473684210526316,-0.1111111111111111,-10
2002-10-19,Sunderland,West Ham,0,1,A,9,8,40,-22,0.2631578947368421,4,13,-9,0.2222222222222222,8,5,53,-9,0.3947368421052632,8,16,-8,0.125,0,0,0,0,0,0,0,0,0.2,0.2,3,-13,-13,-0.13157894736842113,0.09722222222222221,-1
2002-10-19,West Brom,Birmingham,1,1,D,9,9,-1,-1,0.0,7,15,-8,0.3333333333333333,9,11,-1,-1,0.0,10,11,-1,0.3333333333333333,0,0,1,0,0,0,0,0,0.4,0.4,-2,0,0,0.0,0.0,-7
2002-10-20,Charlton,Middlesboro,1,0,H,9,7,44,-11,0.2631578947368421,7,14,-7,0.2222222222222222,9,17,-1,-1,0.0,13,5,8,0.5555555555555556,0,0,0,0,1,0,0,0,0.0,0.8,-10,45,-10,0.2631578947368421,-0.33333333333333337,-15
2002-10-20,Tottenham,Bolton,3,1,H,9,16,50,-4,0.3684210526315789,13,13,0,0.5555555555555556,8,7,40,-18,0.2368421052631579,8,14,-6,0.25,0,0,0,0,0,0,0,0,0.4,0.2,9,10,14,0.13157894736842102,0.3055555555555556,6
2002-10-21,Aston Villa,Southampton,0,1,A,9,10,50,-1,0.3157894736842105,6,9,-3,0.3333333333333333,9,10,45,-8,0.3157894736842105,6,8,-2,0.2222222222222222,0,0,0,0,0,0,0,0,0.4,0.4,0,5,7,0.0,0.1111111111111111,-1
2002-10-23,Fulham,West Ham,0,1,A,9,15,44,-8,0.2631578947368421,14,9,5,0.4444444444444444,9,8,53,-9,0.3947368421052632,9,16,-7,0.2222222222222222,0,0,0,0,0,0,0,0,0.4,0.4,7,-9,1,-0.13157894736842113,0.2222222222222222,12
2002-10-26,Arsenal,Blackburn,1,2,A,10,23,87,43,0.6842105263157895,25,11,14,0.7,10,15,46,4,0.3157894736842105,16,12,4,0.4,0,0,0,0,0,0,0,0,0.8,0.6,8,41,39,0.368421052631579,0.29999999999999993,10
2002-10-26,Birmingham,Man City,0,2,A,10,12,-1,-1,0.0,11,12,-1,0.3,10,8,-1,-1,0.0,7,17,-10,0.2,0,0,0,0,0,0,1,0,0.4,0.0,4,0,0,0.0,0.09999999999999998,9
2002-10-26,Chelsea,West Brom,2,0,H,10,16,64,28,0.4473684210526316,18,12,6,0.4,10,10,-1,-1,0.0,8,16,-8,0.3,0,0,0,0,0,0,0,0,0.4,0.2,6,65,29,0.4473684210526316,0.10000000000000003,14
2002-10-26,Liverpool,Tottenham,2,1,H,10,24,80,37,0.631578947368421,20,8,12,0.7,10,19,50,-4,0.3684210526315789,16,14,2,0.6,1,1,0,0,0,0,0,0,1.0,0.6,5,30,41,0.2631578947368421,0.09999999999999998,10
2002-10-26,Man United,Aston Villa,1,1,D,10,18,77,42,0.631578947368421,13,7,6,0.5,10,10,50,-1,0.3157894736842105,6,10,-4,0.3,0,0,0,0,0,0,0,0,0.6,0.2,8,27,43,0.3157894736842105,0.2,10
2002-10-26,Middlesboro,Leeds,2,2,D,10,17,-1,-1,0.0,13,6,7,0.5,10,13,66,16,0.4736842105263158,11,10,1,0.4,0,0,0,0,0,0,0,0,0.6,0.2,4,-67,-17,-0.4736842105263158,0.09999999999999998,6
2002-10-26,Newcastle,Charlton,2,1,H,9,13,71,22,0.5526315789473685,14,14,0,0.4444444444444444,10,10,44,-11,0.2631578947368421,8,14,-6,0.3,0,0,0,0,0,0,0,0,0.6,0.2,3,27,33,0.2894736842105264,0.14444444444444443,6
2002-10-27,Southampton,Fulham,4,2,H,10,13,45,-8,0.3157894736842105,7,8,-1,0.3,10,15,44,-8,0.2631578947368421,14,10,4,0.4,0,0,0,0,0,0,0,0,0.4,0.2,-2,1,0,0.05263157894736842,-0.10000000000000003,-5
2002-10-27,West Ham,Everton,0,1,A,10,11,53,-9,0.3947368421052632,10,16,-6,0.3,10,14,43,-12,0.2894736842105263,13,15,-2,0.4,0,0,0,0,0,0,0,0,0.6,0.6,-3,10,3,0.10526315789473689,-0.10000000000000003,-4
2002-10-28,Bolton,Sunderland,1,1,D,9,7,40,-18,0.2368421052631579,9,17,-8,0.2222222222222222,10,8,40,-22,0.2631578947368421,4,14,-10,0.2,0,0,0,0,0,0,0,0,0.0,0.2,-1,0,4,-0.02631578947368418,0.0222222222222222,2
2002-11-02,Birmingham,Bolton,3,1,H,11,12,-1,-1,0.0,11,14,-3,0.2727272727272727,10,8,40,-18,0.2368421052631579,10,18,-8,0.2,0,0,0,0,0,0,0,0,0.2,0.0,4,-41,17,-0.2368421052631579,0.0727272727272727,5
2002-11-02,Liverpool,West Ham,2,0,H,11,27,80,37,0.631578947368421,22,9,13,0.7272727272727273,11,11,53,-9,0.3947368421052632,10,17,-7,0.2727272727272727,1,1,0,0,0,0,0,0,1.0,0.6,16,27,46,0.2368421052631578,0.4545454545454546,20
2002-11-02,Man United,Southampton,2,1,H,11,19,77,42,0.631578947368421,14,8,6,0.45454545454545453,11,16,45,-8,0.3157894736842105,11,10,1,0.36363636363636365,0,0,0,0,1,0,0,0,0.6,0.6,3,32,50,0.3157894736842105,0.09090909090909088,5
2002-11-02,West Brom,Man City,1,2,A,11,10,-1,-1,0.0,8,18,-10,0.2727272727272727,11,11,-1,-1,0.0,9,17,-8,0.2727272727272727,0,0,0,0,0,0,0,0,0.0,0.2,-1,0,0,0.0,0.0,-2
2002-11-03,Blackburn,Aston Villa,0,0,D,11,18,46,4,0.3157894736842105,18,13,5,0.45454545454545453,11,11,50,-1,0.3157894736842105,7,11,-4,0.2727272727272727,0,0,0,0,0,0,0,0,0.8,0.2,7,-4,5,0.0,0.18181818181818182,9
2002-11-03,Charlton,Sunderland,1,1,D,11,10,44,-11,0.2631578947368421,9,16,-7,0.2727272727272727,11,9,40,-22,0.2631578947368421,5,15,-10,0.18181818181818182,0,0,0,0,0,0,0,0,0.2,0.2,1,4,11,0.0,0.09090909090909088,3
2002-11-03,Fulham,Arsenal,0,1,A,11,15,44,-8,0.2631578947368421,16,14,2,0.36363636363636365,11,23,87,43,0.6842105263157895,26,13,13,0.6363636363636364,0,0,0,0,0,0,0,0,0.2,0.6,-8,-43,-51,-0.4210526315789474,-0.2727272727272727,-11
2002-11-03,Leeds,Everton,0,1,A,11,14,66,16,0.4736842105263158,13,12,1,0.36363636363636365,11,17,43,-12,0.2894736842105263,14,15,-1,0.45454545454545453,0,0,0,0,0,0,0,0,0.0,0.6,-3,23,28,0.1842105263157895,-0.09090909090909088,2
2002-11-03,Tottenham,Chelsea,0,0,D,11,19,50,-4,0.3684210526315789,17,16,1,0.5454545454545454,11,19,64,28,0.4473684210526316,20,12,8,0.45454545454545453,0,0,0,0,0,0,0,0,0.4,0.4,0,-14,-32,-0.07894736842105265,0.09090909090909088,-7
2002-11-04,Newcastle,Middlesboro,2,0,H,10,16,71,22,0.5526315789473685,16,15,1,0.5,11,18,-1,-1,0.0,15,8,7,0.45454545454545453,0,0,0,0,0,0,0,0,0.8,0.6,-2,72,23,0.5526315789473685,0.04545454545454547,-6
2002-11-09,Arsenal,Newcastle,1,0,H,12,26,87,43,0.6842105263157895,27,13,14,0.6666666666666666,11,19,71,22,0.5526315789473685,18,15,3,0.5454545454545454,0,0,0,0,0,0,0,0,0.6,0.8,7,16,21,0.13157894736842102,0.12121212121212122,11
2002-11-09,Aston Villa,Fulham,3,1,H,12,12,50,-1,0.3157894736842105,7,11,-4,0.25,12,15,44,-8,0.2631578947368421,16,15,1,0.3333333333333333,0,0,0,0,0,0,1,0,0.0,0.2,-3,6,7,0.05263157894736842,-0.08333333333333331,-5
2002-11-09,Bolton,West Brom,1,1,D,11,8,40,-18,0.2368421052631579,11,21,-10,0.18181818181818182,12,10,-1,-1,0.0,9,20,-11,0.25,0,0,0,0,0,0,0,0,0.0,0.0,-2,41,-17,0.2368421052631579,-0.06818181818181818,1
2002-11-09,Chelsea,Birmingham,3,0,H,12,20,64,28,0.4473684210526316,20,12,8,0.4166666666666667,12,15,-1,-1,0.0,14,15,-1,0.3333333333333333,0,0,0,0,0,0,0,0,0.4,0.4,5,65,29,0.4473684210526316,0.08333333333333337,9
2002-11-09,Everton,Charlton,1,0,H,12,20,43,-12,0.2894736842105263,15,15,0,0.5,12,11,44,-11,0.2631578947368421,10,17,-7,0.25,1,0,0,0,0,0,0,0,0.8,0.2,9,-1,-1,0.026315789473684237,0.25,7
2002-11-09,Man City,Man United,3,1,H,12,14,-1,-1,0.0,11,18,-7,0.3333333333333333,12,22,77,42,0.631578947368421,16,9,7,0.5,0,0,0,0,0,0,0,0,0.4,0.6,-8,-78,-43,-0.631578947368421,-0.16666666666666669,-14
2002-11-09,Middlesboro,Liverpool,1,0,H,12,18,-1,-1,0.0,15,10,5,0.4166666666666667,12,30,80,37,0.631578947368421,24,9,15,0.75,0,0,0,0,1,1,0,0,0.4,1.0,-12,-81,-38,-0.631578947368421,-0.3333333333333333,-10
2002-11-09,Southampton,Blackburn,1,1,D,12,16,45,-8,0.3157894736842105,12,12,0,0.3333333333333333,12,19,46,4,0.3157894736842105,18,13,5,0.4166666666666667,0,0,0,0,0,0,0,0,0.6,0.6,-3,-1,-12,0.0,-0.08333333333333337,-5
2002-11-10,Sunderland,Tottenham,2,0,H,12,10,40,-22,0.2631578947368421,6,16,-10,0.16666666666666666,12,20,50,-4,0.3684210526315789,17,16,1,0.5,0,0,0,0,0,0,0,0,0.2,0.4,-10,-10,-18,-0.10526315789473684,-0.33333333333333337,-11
2002-11-10,West Ham,Leeds,3,4,A,12,11,53,-9,0.3947368421052632,10,19,-9,0.25,12,14,66,16,0.4736842105263158,13,13,0,0.3333333333333333,0,0,0,0,0,0,0,0,0.4,0.0,-3,-13,-25,-0.0789473684210526,-0.08333333333333331,-9
2002-11-16,Arsenal,Tottenham,3,0,H,13,29,87,43,0.6842105263157895,28,13,15,0.6923076923076923,13,20,50,-4,0.3684210526315789,17,18,-1,0.46153846153846156,0,0,0,0,0,0,0,0,0.6,0.4,9,37,47,0.31578947368421056,0.23076923076923073,16
2002-11-16,Chelsea,Middlesboro,1,0,H,13,23,64,28,0.4473684210526316,23,12,11,0.46153846153846156,13,21,-1,-1,0.0,16,10,6,0.46153846153846156,0,0,0,0,0,0,0,0,0.6,0.4,2,65,29,0.4473684210526316,0.0,5
2002-11-16,Man City,Charlton,0,1,A,13,17,-1,-1,0.0,14,19,-5,0.38461538461538464,13,11,44,-11,0.2631578947368421,10,18,-8,0.23076923076923078,1,0,0,0,0,0,0,0,0.6,0.2,6,-45,10,-0.2631578947368421,0.15384615384615385,3
2002-11-16,Newcastle,Southampton,2,1,H,12,19,71,22,0.5526315789473685,18,16,2,0.5,13,17,45,-8,0.3157894736842105,13,13,0,0.3076923076923077,0,0,0,0,0,0,0,0,0.6,0.6,2,26,30,0.23684210526315796,0.1923076923076923,2
2002-11-16,West Brom,Aston Villa,0,0,D,13,11,-1,-1,0.0,10,21,-11,0.23076923076923078,13,15,50,-1,0.3157894736842105,10,12,-2,0.3076923076923077,0,0,0,0,0,0,0,0,0.0,0.2,-4,-51,0,-0.3157894736842105,-0.07692307692307693,-9
2002-11-17,Birmingham,Fulham,0,0,D,13,15,-1,-1,0.0,14,18,-4,0.3076923076923077,13,15,44,-8,0.2631578947368421,17,18,-1,0.3076923076923077,0,0,0,0,0,0,1,0,0.4,0.0,0,-45,7,-0.2631578947368421,0.0,-3
2002-11-17,Blackburn,Everton,0,1,A,13,20,46,4,0.3157894736842105,19,14,5,0.38461538461538464,13,23,43,-12,0.2894736842105263,16,15,1,0.5384615384615384,0,0,0,0,1,0,0,0,0.4,0.8,-3,3,16,0.02631578947368418,-0.1538461538461538,4
2002-11-17,Leeds,Bolton,2,4,A,13,17,66,16,0.4736842105263158,17,16,1,0.38461538461538464,12,9,40,-18,0.2368421052631579,12,22,-10,0.16666666666666666,0,0,0,0,0,0,0,0,0.2,0.0,8,26,34,0.2368421052631579,0.21794871794871798,11
2002-11-17,Liverpool,Sunderland,0,0,D,13,30,80,37,0.631578947368421,24,10,14,0.6923076923076923,13,13,40,-22,0.2631578947368421,8,16,-8,0.23076923076923078,0,0,0,0,0,0,0,0,0.8,0.2,17,40,59,0.3684210526315789,0.4615384615384615,22
2002-11-17,West Ham,Man United,1,1,D,13,11,53,-9,0.3947368421052632,13,23,-10,0.23076923076923078,13,22,77,42,0.631578947368421,17,12,5,0.46153846153846156,0,0,1,0,0,0,0,0,0.4,0.4,-11,-24,-51,-0.2368421052631578,-0.23076923076923078,-15
2002-11-23,Aston Villa,West Ham,4,1,H,14,16,50,-1,0.3157894736842105,10,12,-2,0.2857142857142857,14,12,53,-9,0.3947368421052632,14,24,-10,0.21428571428571427,0,0,0,0,0,0,0,0,0.2,0.2,4,-3,8,-0.07894736842105271,0.07142857142857142,8
2002-11-23,Bolton,Chelsea,1,1,D,13,12,40,-18,0.2368421052631579,16,24,-8,0.23076923076923078,14,26,64,28,0.4473684210526316,24,12,12,0.5,0,0,0,0,0,0,0,0,0.2,0.8,-14,-24,-46,-0.21052631578947367,-0.2692307692307692,-20
2002-11-23,Everton,West Brom,1,0,H,14,26,43,-12,0.2894736842105263,17,15,2,0.5714285714285714,14,12,-1,-1,0.0,10,21,-11,0.21428571428571427,1,1,0,0,0,0,0,0,1.0,0.0,14,44,-11,0.2894736842105263,0.3571428571428571,13
2002-11-23,Fulham,Liverpool,3,2,H,14,16,44,-8,0.2631578947368421,17,18,-1,0.2857142857142857,14,31,80,37,0.631578947368421,24,10,14,0.6428571428571429,0,0,0,0,0,0,0,0,0.0,0.6,-15,-36,-45,-0.3684210526315789,-0.3571428571428572,-15
2002-11-23,Man United,Newcastle,5,3,H,14,23,77,42,0.631578947368421,18,13,5,0.42857142857142855,13,22,71,22,0.5526315789473685,20,17,3,0.5384615384615384,0,0,0,0,0,0,0,0,0.2,0.6,1,6,20,0.07894736842105254,-0.10989010989010989,2
2002-11-23,Middlesboro,Man City,3,1,H,14,21,-1,-1,0.0,16,11,5,0.42857142857142855,14,17,-1,-1,0.0,14,20,-6,0.35714285714285715,0,0,0,0,0,0,0,0,0.2,0.6,4,0,0,0.0,0.0714285714285714,11
2002-11-23,Southampton,Arsenal,3,2,H,14,17,45,-8,0.3157894736842105,14,15,-1,0.2857142857142857,14,32,87,43,0.6842105263157895,31,13,18,0.7142857142857143,0,0,0,0,1,0,0,0,0.4,0.6,-15,-42,-51,-0.368421052631579,-0.4285714285714286,-19
2002-11-23,Sunderland,Birmingham,0,1,A,14,14,40,-22,0.2631578947368421,8,16,-8,0.21428571428571427,14,16,-1,-1,0.0,14,18,-4,0.2857142857142857,0,0,0,0,0,0,0,0,0.2,0.2,-2,41,-21,0.2631578947368421,-0.07142857142857142,-4
2002-11-24,Charlton,Blackburn,3,1,H,14,14,44,-11,0.2631578947368421,11,18,-7,0.2857142857142857,14,20,46,4,0.3157894736842105,19,15,4,0.35714285714285715,0,0,0,0,0,0,0,0,0.4,0.4,-6,-2,-15,-0.05263157894736842,-0.07142857142857145,-11
2002-11-24,Tottenham,Leeds,2,0,H,14,20,50,-4,0.3684210526315789,17,21,-4,0.42857142857142855,14,17,66,16,0.4736842105263158,19,20,-1,0.35714285714285715,0,0,0,0,0,0,0,0,0.2,0.2,3,-16,-20,-0.10526315789473689,0.0714285714285714,-3
2002-11-30,Arsenal,Aston Villa,3,1,H,15,32,87,43,0.6842105263157895,33,16,17,0.6666666666666666,15,19,50,-1,0.3157894736842105,14,13,1,0.3333333333333333,0,0,0,0,0,0,0,0,0.6,0.4,13,37,44,0.368421052631579,0.3333333333333333,16
2002-11-30,Birmingham,Tottenham,1,1,D,15,19,-1,-1,0.0,15,18,-3,0.3333333333333333,15,23,50,-4,0.3684210526315789,19,21,-2,0.4666666666666667,0,0,0,0,0,0,0,0,0.4,0.2,-4,-51,3,-0.3684210526315789,-0.13333333333333336,-1
2002-11-30,Blackburn,Fulham,2,1,H,15,20,46,4,0.3157894736842105,20,18,2,0.3333333333333333,15,19,44,-8,0.2631578947368421,20,20,0,0.3333333333333333,0,0,0,0,0,0,0,0,0.2,0.2,1,2,12,0.05263157894736842,0.0,2
2002-11-30,Chelsea,Sunderland,3,0,H,15,27,64,28,0.4473684210526316,25,13,12,0.4666666666666667,15,14,40,-22,0.2631578947368421,8,17,-9,0.2,0,0,0,0,0,0,0,0,0.6,0.2,13,24,50,0.1842105263157895,0.26666666666666666,21
2002-11-30,Man City,Bolton,2,0,H,15,17,-1,-1,0.0,15,23,-8,0.3333333333333333,14,13,40,-18,0.2368421052631579,17,25,-8,0.21428571428571427,0,0,0,0,0,0,0,0,0.6,0.2,4,-41,17,-0.2368421052631579,0.11904761904761904,0
2002-11-30,West Brom,Middlesboro,1,0,H,15,12,-1,-1,0.0,10,22,-12,0.2,15,24,-1,-1,0.0,19,12,7,0.4666666666666667,0,0,0,0,0,0,0,0,0.0,0.4,-12,0,0,0.0,-0.26666666666666666,-19
2002-12-01,Leeds,Charlton,1,2,A,15,17,66,16,0.4736842105263158,19,22,-3,0.3333333333333333,15,17,44,-11,0.2631578947368421,14,19,-5,0.3333333333333333,0,0,0,0,0,0,0,0,0.2,0.4,0,22,27,0.21052631578947373,0.0,2
2002-12-01,Liverpool,Man United,1,2,A,15,31,80,37,0.631578947368421,26,13,13,0.6,15,26,77,42,0.631578947368421,23,16,7,0.4666666666666667,0,0,0,0,0,0,0,0,0.4,0.4,5,3,-5,0.0,0.1333333333333333,6
2002-12-01,Newcastle,Everton,2,1,H,14,22,71,22,0.5526315789473685,23,22,1,0.5,15,29,43,-12,0.2894736842105263,18,15,3,0.6,0,0,0,0,1,1,0,0,0.6,1.0,-7,28,34,0.26315789473684215,-0.09999999999999998,-2
2002-12-02,West Ham,Southampton,0,1,A,15,12,53,-9,0.3947368421052632,15,28,-13,0.2,15,20,45,-8,0.3157894736842105,17,17,0,0.3333333333333333,0,0,0,0,0,0,0,0,0.0,0.4,-8,8,-1,0.07894736842105271,-0.1333333333333333,-13
2002-12-07,Aston Villa,Newcastle,0,1,A,16,19,50,-1,0.3157894736842105,15,16,-1,0.3125,15,25,71,22,0.5526315789473685,25,23,2,0.5333333333333333,0,0,0,0,0,0,0,0,0.4,0.6,-6,-21,-23,-0.23684210526315796,-0.22083333333333333,-3
2002-12-07,Bolton,Blackburn,1,1,D,15,13,40,-18,0.2368421052631579,17,27,-10,0.2,16,23,46,4,0.3157894736842105,22,19,3,0.375,0,0,0,0,0,0,0,0,0.2,0.2,-10,-6,-22,-0.0789473684210526,-0.175,-13
2002-12-07,Charlton,Liverpool,2,0,H,16,20,44,-11,0.2631578947368421,16,20,-4,0.375,16,31,80,37,0.631578947368421,27,15,12,0.5625,1,0,0,0,0,0,0,0,0.6,0.2,-11,-36,-48,-0.3684210526315789,-0.1875,-16
2002-12-07,Everton,Chelsea,1,3,A,16,29,43,-12,0.2894736842105263,19,17,2,0.5625,16,30,64,28,0.4473684210526316,28,13,15,0.5,0,0,0,0,0,0,0,0,0.8,0.6,-1,-21,-40,-0.15789473684210525,0.0625,-13
2002-12-07,Fulham,Leeds,1,0,H,16,19,44,-8,0.2631578947368421,21,22,-1,0.3125,16,17,66,16,0.4736842105263158,20,24,-4,0.3125,0,0,0,0,0,0,1,0,0.2,0.2,2,-22,-24,-0.21052631578947373,0.0,3
2002-12-07,Man United,Arsenal,2,0,H,16,29,77,42,0.631578947368421,25,17,8,0.5,16,35,87,43,0.6842105263157895,36,17,19,0.6875,0,0,0,0,0,0,0,0,0.6,0.8,-6,-10,-1,-0.052631578947368474,-0.1875,-11
2002-12-07,Middlesboro,West Ham,2,2,D,16,24,-1,-1,0.0,19,13,6,0.4375,16,12,53,-9,0.3947368421052632,15,29,-14,0.1875,0,0,0,0,0,0,0,0,0.4,0.0,12,-54,8,-0.3947368421052632,0.25,20
2002-12-07,Southampton,Birmingham,2,0,H,16,23,45,-8,0.3157894736842105,18,17,1,0.375,16,20,-1,-1,0.0,16,19,-3,0.3125,0,0,0,0,0,0,0,0,0.4,0.4,3,46,-7,0.3157894736842105,0.0625,4
2002-12-08,Tottenham,West Brom,3,1,H,16,24,50,-4,0.3684210526315789,20,22,-2,0.4375,16,15,-1,-1,0.0,11,22,-11,0.25,0,0,0,0,0,0,0,0,0.2,0.2,9,51,-3,0.3684210526315789,0.1875,9
2002-12-09,Sunderland,Man City,0,3,A,16,14,40,-22,0.2631578947368421,8,20,-12,0.1875,16,20,-1,-1,0.0,17,23,-6,0.375,0,0,0,0,0,0,0,0,0.2,0.6,-6,41,-21,0.2631578947368421,-0.1875,-6
2002-12-14,Aston Villa,West Brom,2,1,H,17,19,50,-1,0.3157894736842105,15,17,-2,0.29411764705882354,17,15,-1,-1,0.0,12,25,-13,0.23529411764705882,0,0,0,0,0,0,0,0,0.4,0.2,4,51,0,0.3157894736842105,0.05882352941176472,11
2002-12-14,Charlton,Man City,2,2,D,17,23,44,-11,0.2631578947368421,18,20,-2,0.4117647058823529,17,23,-1,-1,0.0,20,23,-3,0.4117647058823529,1,0,0,0,0,0,0,0,0.8,0.6,0,45,-10,0.2631578947368421,0.0,1
2002-12-14,Everton,Blackburn,2,1,H,17,29,43,-12,0.2894736842105263,20,20,0,0.5294117647058824,17,24,46,4,0.3157894736842105,23,20,3,0.35294117647058826,0,0,0,0,0,0,0,0,0.6,0.2,5,-3,-16,-0.02631578947368418,0.1764705882352941,-3
2002-12-14,Man United,West Ham,3,0,H,17,32,77,42,0.631578947368421,27,17,10,0.5294117647058824,17,13,53,-9,0.3947368421052632,17,31,-14,0.17647058823529413,1,0,0,0,0,0,0,0,0.6,0.0,19,24,51,0.2368421052631578,0.3529411764705882,24
2002-12-14,Middlesboro,Chelsea,1,1,D,17,25,-1,-1,0.0,21,15,6,0.4117647058823529,17,33,64,28,0.4473684210526316,31,14,17,0.5294117647058824,0,0,0,0,0,0,0,0,0.4,0.8,-8,-65,-29,-0.4473684210526316,-0.11764705882352944,-11
2002-12-14,Southampton,Newcastle,1,1,D,17,26,45,-8,0.3157894736842105,20,17,3,0.4117647058823529,16,28,71,22,0.5526315789473685,26,23,3,0.5625,1,0,0,0,0,0,0,0,0.6,0.6,-2,-26,-30,-0.23684210526315796,-0.15073529411764708,0
2002-12-15,Fulham,Birmingham,0,1,A,17,22,44,-8,0.2631578947368421,22,22,0,0.35294117647058826,17,20,-1,-1,0.0,16,21,-5,0.29411764705882354,0,0,0,0,0,0,0,0,0.4,0.2,2,45,-7,0.2631578947368421,0.05882352941176472,5
2002-12-15,Sunderland,Liverpool,2,1,H,17,14,40,-22,0.2631578947368421,8,23,-15,0.17647058823529413,17,31,80,37,0.631578947368421,27,17,10,0.5294117647058824,0,0,1,0,0,0,1,0,0.2,0.0,-17,-40,-59,-0.3684210526315789,-0.3529411764705882,-25
2002-12-15,Tottenham,Arsenal,1,1,D,17,27,50,-4,0.3684210526315789,23,23,0,0.47058823529411764,17,35,87,43,0.6842105263157895,36,19,17,0.6470588235294118,0,0,0,0,0,0,0,0,0.4,0.6,-8,-37,-47,-0.31578947368421056,-0.17647058823529416,-17
2002-12-16,Bolton,Leeds,0,3,A,16,14,40,-18,0.2368421052631579,18,28,-10,0.1875,17,17,66,16,0.4736842105263158,20,25,-5,0.29411764705882354,0,0,0,0,0,0,1,0,0.2,0.2,-3,-26,-34,-0.2368421052631579,-0.10661764705882354,-5
2002-12-21,Arsenal,Middlesboro,2,0,H,18,36,87,43,0.6842105263157895,37,20,17,0.6111111111111112,18,26,-1,-1,0.0,22,16,6,0.3888888888888889,0,0,0,0,0,0,0,0,0.4,0.2,10,88,44,0.6842105263157895,0.22222222222222227,11
2002-12-21,Birmingham,Charlton,1,1,D,18,23,-1,-1,0.0,17,21,-4,0.3333333333333333,18,24,44,-11,0.2631578947368421,20,22,-2,0.3888888888888889,0,0,0,0,0,0,0,0,0.4,0.8,-1,-45,10,-0.2631578947368421,-0.05555555555555558,-2
2002-12-21,Chelsea,Aston Villa,2,0,H,18,34,64,28,0.4473684210526316,32,15,17,0.5,18,22,50,-1,0.3157894736842105,17,18,-1,0.3333333333333333,0,0,0,0,0,0,0,0,0.6,0.4,12,14,29,0.13157894736842107,0.16666666666666669,18
2002-12-21,Leeds,Southampton,1,1,D,18,20,66,16,0.4736842105263158,23,25,-2,0.3333333333333333,18,27,45,-8,0.3157894736842105,21,18,3,0.3888888888888889,0,0,0,0,0,0,0,0,0.2,0.6,-7,21,24,0.1578947368421053,-0.05555555555555558,-5
2002-12-21,Newcastle,Fulham,2,0,H,17,29,71,22,0.5526315789473685,27,24,3,0.5294117647058824,18,22,44,-8,0.2631578947368421,22,23,-1,0.3333333333333333,0,0,0,0,0,0,0,0,0.6,0.4,7,27,30,0.2894736842105264,0.19607843137254904,4
2002-12-21,West Brom,Sunderland,2,2,D,18,15,-1,-1,0.0,13,27,-14,0.2222222222222222,18,17,40,-22,0.2631578947368421,10,24,-14,0.2222222222222222,0,0,0,0,0,0,0,0,0.2,0.2,-2,-41,21,-0.2631578947368421,0.0,0
2002-12-21,West Ham,Bolton,1,1,D,18,13,53,-9,0.3947368421052632,17,34,-17,0.16666666666666666,17,14,40,-18,0.2368421052631579,18,31,-13,0.17647058823529413,0,0,0,0,0,0,0,0,0.0,0.2,-1,13,9,0.1578947368421053,-0.009803921568627472,-4
2002-12-22,Blackburn,Man United,1,0,H,18,24,46,4,0.3157894736842105,24,22,2,0.3333333333333333,18,35,77,42,0.631578947368421,30,17,13,0.5555555555555556,0,0,0,0,1,0,0,0,0.2,0.8,-11,-31,-38,-0.3157894736842105,-0.22222222222222227,-11
2002-12-22,Liverpool,Everton,0,0,D,18,31,80,37,0.631578947368421,28,19,9,0.5,18,32,43,-12,0.2894736842105263,22,21,1,0.5555555555555556,0,0,1,0,0,0,0,0,0.0,0.6,-1,37,49,0.3421052631578947,-0.05555555555555558,8
2002-12-23,Man City,Tottenham,2,3,A,18,24,-1,-1,0.0,22,25,-3,0.3888888888888889,18,28,50,-4,0.3684210526315789,24,24,0,0.4444444444444444,0,0,0,0,0,0,0,0,0.4,0.4,-4,-51,3,-0.3684210526315789,-0.055555555555555525,-3
2002-12-26,Birmingham,Everton,1,1,D,19,24,-1,-1,0.0,18,22,-4,0.3157894736842105,19,33,43,-12,0.2894736842105263,22,21,1,0.5263157894736842,0,0,0,0,0,0,0,0,0.4,0.4,-9,-44,11,-0.2894736842105263,-0.21052631578947367,-5
2002-12-26,Bolton,Newcastle,4,3,H,18,15,40,-18,0.2368421052631579,19,32,-13,0.16666666666666666,18,32,71,22,0.5526315789473685,29,24,5,0.5555555555555556,0,0,0,0,0,0,0,0,0.0,0.6,-17,-31,-40,-0.31578947368421056,-0.38888888888888895,-18
2002-12-26,Chelsea,Southampton,0,0,D,19,37,64,28,0.4473684210526316,34,15,19,0.5263157894736842,19,28,45,-8,0.3157894736842105,22,19,3,0.3684210526315789,0,0,0,0,0,0,0,0,0.6,0.6,9,19,36,0.13157894736842107,0.15789473684210525,16
2002-12-26,Liverpool,Blackburn,1,1,D,19,32,80,37,0.631578947368421,28,19,9,0.47368421052631576,19,27,46,4,0.3157894736842105,25,22,3,0.3684210526315789,0,0,0,0,0,0,0,0,0.0,0.4,5,34,33,0.3157894736842105,0.10526315789473684,6
2002-12-26,Man City,Aston Villa,3,1,H,19,24,-1,-1,0.0,24,28,-4,0.3684210526315789,19,22,50,-1,0.3157894736842105,17,20,-3,0.3157894736842105,0,0,0,0,0,0,0,0,0.4,0.4,2,-51,0,-0.3157894736842105,0.05263157894736842,-1
2002-12-26,Middlesboro,Man United,3,1,H,19,26,-1,-1,0.0,22,18,4,0.3684210526315789,19,35,77,42,0.631578947368421,30,18,12,0.5263157894736842,0,0,0,0,0,0,0,0,0.2,0.8,-9,-78,-43,-0.631578947368421,-0.15789473684210525,-8
2002-12-26,Sunderland,Leeds,1,2,A,19,18,40,-22,0.2631578947368421,12,26,-14,0.21052631578947367,19,21,66,16,0.4736842105263158,24,26,-2,0.3157894736842105,0,0,0,0,0,0,0,0,0.2,0.2,-3,-26,-38,-0.21052631578947373,-0.10526315789473684,-12
2002-12-26,Tottenham,Charlton,2,2,D,19,31,50,-4,0.3684210526315789,27,26,1,0.47368421052631576,19,25,44,-11,0.2631578947368421,21,23,-2,0.3684210526315789,0,0,0,0,0,0,0,0,0.6,0.6,6,6,7,0.10526315789473684,0.10526315789473684,3
2002-12-26,West Brom,Arsenal,1,2,A,19,16,-1,-1,0.0,15,29,-14,0.21052631578947367,19,39,87,43,0.6842105263157895,39,20,19,0.631578947368421,0,0,0,0,0,0,0,0,0.2,0.4,-23,-88,-44,-0.6842105263157895,-0.42105263157894735,-33
2002-12-26,West Ham,Fulham,1,1,D,19,14,53,-9,0.3947368421052632,18,35,-17,0.15789473684210525,19,22,44,-8,0.2631578947368421,22,25,-3,0.3157894736842105,0,0,0,0,0,0,0,0,0.0,0.4,-8,9,-1,0.13157894736842113,-0.15789473684210525,-14
2002-12-28,Aston Villa,Middlesboro,1,0,H,20,22,50,-1,0.3157894736842105,18,23,-5,0.3,20,29,-1,-1,0.0,25,19,6,0.4,0,0,0,0,0,0,0,0,0.2,0.2,-7,51,0,0.3157894736842105,-0.10000000000000003,-11
2002-12-28,Blackburn,West Ham,2,2,D,20,28,46,4,0.3157894736842105,26,23,3,0.35,20,15,53,-9,0.3947368421052632,19,36,-17,0.15,0,0,0,0,0,0,0,0,0.4,0.0,13,-7,13,-0.07894736842105271,0.19999999999999998,20
2002-12-28,Charlton,West Brom,1,0,H,20,26,44,-11,0.2631578947368421,23,25,-2,0.35,20,16,-1,-1,0.0,16,31,-15,0.2,0,0,0,0,0,0,0,0,0.4,0.2,10,45,-10,0.2631578947368421,0.14999999999999997,13
2002-12-28,Everton,Bolton,0,0,D,20,34,43,-12,0.2894736842105263,23,22,1,0.5,19,18,40,-18,0.2368421052631579,23,35,-12,0.21052631578947367,0,0,0,0,0,0,0,0,0.2,0.2,16,3,6,0.05263157894736842,0.2894736842105263,13
2002-12-28,Fulham,Man City,0,1,A,20,23,44,-8,0.2631578947368421,23,26,-3,0.3,20,27,-1,-1,0.0,27,29,-2,0.4,0,0,0,0,0,0,0,0,0.2,0.6,-4,45,-7,0.2631578947368421,-0.10000000000000003,-1
2002-12-28,Leeds,Chelsea,2,0,H,20,24,66,16,0.4736842105263158,26,27,-1,0.35,20,38,64,28,0.4473684210526316,34,15,19,0.5,0,0,0,0,0,0,0,0,0.4,0.6,-14,2,-12,0.026315789473684237,-0.15000000000000002,-20
2002-12-28,Man United,Birmingham,2,0,H,20,35,77,42,0.631578947368421,31,21,10,0.5,20,25,-1,-1,0.0,19,23,-4,0.3,0,0,0,0,0,0,0,0,0.6,0.2,10,78,43,0.631578947368421,0.2,14
2002-12-28,Southampton,Sunderland,2,1,H,20,29,45,-8,0.3157894736842105,22,19,3,0.35,20,18,40,-22,0.2631578947368421,13,28,-15,0.2,0,0,0,0,0,0,0,0,0.4,0.2,11,5,14,0.05263157894736842,0.14999999999999997,18
2002-12-29,Arsenal,Liverpool,1,1,D,20,42,87,43,0.6842105263157895,41,21,20,0.65,20,33,80,37,0.631578947368421,29,20,9,0.45,0,0,0,0,0,0,0,0,0.6,0.0,9,7,6,0.052631578947368474,0.2,11
2002-12-29,Newcastle,Tottenham,2,1,H,19,32,71,22,0.5526315789473685,32,28,4,0.5263157894736842,20,32,50,-4,0.3684210526315789,29,28,1,0.45,0,0,0,0,0,0,0,0,0.6,0.4,0,21,26,0.18421052631578955,0.07631578947368417,3
2003-01-01,Arsenal,Chelsea,3,2,H,21,43,87,43,0.6842105263157895,42,22,20,0.6190476190476191,21,38,64,28,0.4473684210526316,34,17,17,0.47619047619047616,0,0,0,0,0,0,0,0,0.4,0.4,5,23,15,0.2368421052631579,0.1428571428571429,3
2003-01-01,Aston Villa,Bolton,2,0,H,21,25,50,-1,0.3157894736842105,19,23,-4,0.3333333333333333,20,19,40,-18,0.2368421052631579,23,35,-12,0.2,0,0,0,0,0,0,0,0,0.4,0.2,6,10,17,0.0789473684210526,0.1333333333333333,8
2003-01-01,Blackburn,Middlesboro,1,0,H,21,29,46,4,0.3157894736842105,28,25,3,0.3333333333333333,21,29,-1,-1,0.0,25,20,5,0.38095238095238093,0,0,0,0,0,0,0,0,0.2,0.2,0,47,5,0.3157894736842105,-0.047619047619047616,-2
2003-01-01,Everton,Man City,2,2,D,21,35,43,-12,0.2894736842105263,23,22,1,0.47619047619047616,21,30,-1,-1,0.0,28,29,-1,0.42857142857142855,0,0,0,0,0,0,0,0,0.2,0.6,5,44,-11,0.2894736842105263,0.047619047619047616,2
2003-01-01,Leeds,Birmingham,2,0,H,21,27,66,16,0.4736842105263158,28,27,1,0.38095238095238093,21,25,-1,-1,0.0,19,25,-6,0.2857142857142857,0,0,0,0,0,0,0,0,0.6,0.2,2,67,17,0.4736842105263158,0.09523809523809523,7
2003-01-01,Man United,Sunderland,2,1,H,21,38,77,42,0.631578947368421,33,21,12,0.5238095238095238,21,18,40,-22,0.2631578947368421,14,30,-16,0.19047619047619047,0,0,0,0,0,0,0,0,0.6,0.2,20,37,64,0.3684210526315789,0.33333333333333337,28
2003-01-01,Newcastle,Liverpool,1,0,H,20,35,71,22,0.5526315789473685,34,29,5,0.55,21,34,80,37,0.631578947368421,30,21,9,0.42857142857142855,0,0,0,0,0,0,0,0,0.6,0.0,1,-9,-15,-0.07894736842105254,0.1214285714285715,-4
2003-01-01,Southampton,Tottenham,1,0,H,21,32,45,-8,0.3157894736842105,24,20,4,0.38095238095238093,21,32,50,-4,0.3684210526315789,30,30,0,0.42857142857142855,0,0,0,0,0,0,0,0,0.4,0.4,0,-5,-4,-0.05263157894736842,-0.047619047619047616,4
2003-01-11,Bolton,Fulham,0,0,D,21,19,40,-18,0.2368421052631579,23,37,-14,0.19047619047619047,21,23,44,-8,0.2631578947368421,23,27,-4,0.2857142857142857,0,0,0,0,0,0,0,0,0.2,0.2,-4,-4,-10,-0.02631578947368418,-0.09523809523809523,-10
2003-01-11,Chelsea,Charlton,4,1,H,22,38,64,28,0.4473684210526316,36,20,16,0.45454545454545453,21,29,44,-11,0.2631578947368421,24,25,-1,0.38095238095238093,0,0,0,0,0,0,0,0,0.2,0.4,9,20,39,0.1842105263157895,0.0735930735930736,17
2003-01-11,Liverpool,Aston Villa,1,1,D,22,34,80,37,0.631578947368421,30,22,8,0.4090909090909091,22,28,50,-1,0.3157894736842105,21,23,-2,0.36363636363636365,0,0,0,0,0,0,0,0,0.0,0.6,6,30,38,0.3157894736842105,0.04545454545454547,10
2003-01-11,Man City,Leeds,2,1,H,22,31,-1,-1,0.0,30,31,-1,0.4090909090909091,22,30,66,16,0.4736842105263158,30,27,3,0.4090909090909091,0,0,0,0,1,0,0,0,0.4,0.8,1,-67,-17,-0.4736842105263158,0.0,-4
2003-01-11,Middlesboro,Southampton,2,2,D,22,29,-1,-1,0.0,25,21,4,0.36363636363636365,22,35,45,-8,0.3157894736842105,25,20,5,0.4090909090909091,0,0,0,0,0,0,0,0,0.2,0.4,-6,-46,7,-0.3157894736842105,-0.04545454545454547,-1
2003-01-11,Sunderland,Blackburn,0,0,D,22,18,40,-22,0.2631578947368421,15,32,-17,0.18181818181818182,22,32,46,4,0.3157894736842105,29,25,4,0.36363636363636365,0,0,1,0,0,0,0,0,0.2,0.4,-14,-6,-26,-0.05263157894736842,-0.18181818181818182,-21
2003-01-11,West Brom,Man United,1,3,A,21,16,-1,-1,0.0,16,32,-16,0.19047619047619047,22,41,77,42,0.631578947368421,35,22,13,0.5454545454545454,0,0,0,0,0,0,0,0,0.0,0.6,-25,-78,-43,-0.631578947368421,-0.35497835497835495,-29
2003-01-11,West Ham,Newcastle,2,2,D,21,16,53,-9,0.3947368421052632,21,38,-17,0.14285714285714285,21,38,71,22,0.5526315789473685,35,29,6,0.5714285714285714,0,0,0,0,0,0,0,0,0.0,0.6,-22,-18,-31,-0.15789473684210525,-0.42857142857142855,-23
2003-01-12,Birmingham,Arsenal,0,4,A,22,25,-1,-1,0.0,19,27,-8,0.2727272727272727,22,46,87,43,0.6842105263157895,45,24,21,0.6363636363636364,0,0,0,0,0,0,0,0,0.2,0.6,-21,-88,-44,-0.6842105263157895,-0.36363636363636365,-29
2003-01-12,Tottenham,Everton,4,3,H,22,32,50,-4,0.3684210526315789,30,31,-1,0.4090909090909091,22,36,43,-12,0.2894736842105263,25,24,1,0.45454545454545453,0,0,0,0,0,0,0,0,0.2,0.2,-4,7,8,0.0789473684210526,-0.045454545454545414,-2
2003-01-18,Aston Villa,Tottenham,0,1,A,23,29,50,-1,0.3157894736842105,22,24,-2,0.34782608695652173,23,35,50,-4,0.3684210526315789,34,34,0,0.43478260869565216,0,0,0,0,0,0,0,0,0.4,0.4,-6,0,3,-0.05263157894736842,-0.08695652173913043,-2
2003-01-18,Blackburn,Birmingham,1,1,D,23,33,46,4,0.3157894736842105,29,25,4,0.34782608695652173,23,25,-1,-1,0.0,19,31,-12,0.2608695652173913,0,0,0,0,0,0,1,0,0.4,0.0,8,47,5,0.3157894736842105,0.08695652173913043,16
2003-01-18,Charlton,Bolton,1,1,D,22,29,44,-11,0.2631578947368421,25,29,-4,0.36363636363636365,22,20,40,-18,0.2368421052631579,23,37,-14,0.18181818181818182,0,0,0,0,0,0,0,0,0.2,0.2,9,4,7,0.02631578947368418,0.18181818181818182,10
2003-01-18,Everton,Sunderland,2,1,H,23,36,43,-12,0.2894736842105263,28,28,0,0.43478260869565216,23,19,40,-22,0.2631578947368421,15,32,-17,0.17391304347826086,0,0,0,0,0,0,0,0,0.0,0.0,17,3,10,0.026315789473684237,0.2608695652173913,17
2003-01-18,Leeds,West Brom,0,0,D,23,30,66,16,0.4736842105263158,31,29,2,0.391304347826087,22,16,-1,-1,0.0,17,35,-18,0.18181818181818182,0,0,0,0,0,0,1,0,0.6,0.0,14,67,17,0.4736842105263158,0.20948616600790515,20
2003-01-18,Man United,Chelsea,2,1,H,23,44,77,42,0.631578947368421,38,23,15,0.5652173913043478,23,41,64,28,0.4473684210526316,40,21,19,0.4782608695652174,1,0,0,0,0,0,0,0,0.6,0.4,3,13,14,0.18421052631578944,0.08695652173913038,-4
2003-01-18,Newcastle,Man City,2,0,H,22,39,71,22,0.5526315789473685,37,31,6,0.5454545454545454,23,34,-1,-1,0.0,32,32,0,0.43478260869565216,0,0,0,0,0,0,0,0,0.6,0.6,5,72,23,0.5526315789473685,0.11067193675889325,6
2003-01-18,Southampton,Liverpool,0,1,A,23,36,45,-8,0.3157894736842105,27,22,5,0.391304347826087,23,35,80,37,0.631578947368421,31,23,8,0.391304347826087,0,0,0,0,0,0,0,0,0.4,0.0,1,-35,-45,-0.3157894736842105,0.0,-3
2003-01-19,Arsenal,West Ham,3,1,H,23,49,87,43,0.6842105263157895,49,24,25,0.6521739130434783,22,17,53,-9,0.3947368421052632,23,40,-17,0.13636363636363635,0,0,0,0,0,0,0,0,0.8,0.0,32,34,52,0.28947368421052627,0.5158102766798419,42
2003-01-19,Fulham,Middlesboro,1,0,H,22,24,44,-8,0.2631578947368421,23,27,-4,0.2727272727272727,23,30,-1,-1,0.0,27,23,4,0.34782608695652173,0,0,0,0,0,0,0,0,0.0,0.2,-6,45,-7,0.2631578947368421,-0.07509881422924902,-8
2003-01-22,Charlton,West Ham,4,2,H,23,30,44,-11,0.2631578947368421,26,30,-4,0.34782608695652173,23,17,53,-9,0.3947368421052632,24,43,-19,0.13043478260869565,0,0,0,0,0,0,0,0,0.2,0.0,13,-9,-2,-0.13157894736842113,0.21739130434782608,15
2003-01-22,Newcastle,Bolton,1,0,H,23,42,71,22,0.5526315789473685,39,31,8,0.5652173913043478,23,21,40,-18,0.2368421052631579,24,38,-14,0.17391304347826086,0,0,0,0,0,0,0,0,0.6,0.2,21,31,40,0.31578947368421056,0.3913043478260869,22
2003-01-28,Bolton,Everton,1,2,A,24,21,40,-18,0.2368421052631579,24,39,-15,0.16666666666666666,24,39,43,-12,0.2894736842105263,30,29,1,0.4583333333333333,0,0,0,0,0,0,0,0,0.0,0.2,-18,-3,-6,-0.05263157894736842,-0.29166666666666663,-16
2003-01-28,Chelsea,Leeds,3,2,H,24,41,64,28,0.4473684210526316,41,23,18,0.4583333333333333,24,31,66,16,0.4736842105263158,31,29,2,0.375,0,0,0,0,0,0,0,0,0.2,0.6,10,-2,12,-0.026315789473684237,0.08333333333333331,16
2003-01-28,Middlesboro,Aston Villa,2,5,A,24,30,-1,-1,0.0,27,24,3,0.3333333333333333,24,29,50,-1,0.3157894736842105,22,25,-3,0.3333333333333333,0,0,0,0,0,0,0,0,0.2,0.4,1,-51,0,-0.3157894736842105,0.0,6
2003-01-28,Sunderland,Southampton,0,1,A,24,19,40,-22,0.2631578947368421,16,34,-18,0.16666666666666666,24,36,45,-8,0.3157894736842105,27,23,4,0.375,0,0,0,0,0,0,0,0,0.0,0.4,-17,-5,-14,-0.05263157894736842,-0.20833333333333334,-22
2003-01-29,Liverpool,Arsenal,2,2,D,24,38,80,37,0.631578947368421,32,23,9,0.4166666666666667,24,52,87,43,0.6842105263157895,52,25,27,0.6666666666666666,0,0,0,0,1,0,0,0,0.2,0.8,-14,-7,-6,-0.052631578947368474,-0.24999999999999994,-18
2003-01-29,Man City,Fulham,4,1,H,24,34,-1,-1,0.0,32,34,-2,0.4166666666666667,23,27,44,-8,0.2631578947368421,24,27,-3,0.30434782608695654,0,0,0,0,0,0,0,0,0.6,0.2,7,-45,7,-0.2631578947368421,0.11231884057971014,1
2003-01-29,Tottenham,Newcastle,0,1,A,24,38,50,-4,0.3684210526315789,35,34,1,0.4583333333333333,24,45,71,22,0.5526315789473685,40,31,9,0.5833333333333334,0,0,0,0,0,0,0,0,0.4,0.8,-7,-21,-26,-0.18421052631578955,-0.12500000000000006,-8
2003-01-29,West Brom,Charlton,0,1,A,23,17,-1,-1,0.0,17,35,-18,0.17391304347826086,24,33,44,-11,0.2631578947368421,30,32,-2,0.375,0,0,0,0,0,0,0,0,0.0,0.4,-16,-45,10,-0.2631578947368421,-0.20108695652173914,-16
2003-01-29,West Ham,Blackburn,2,1,H,24,17,53,-9,0.3947368421052632,26,47,-21,0.125,24,34,46,4,0.3157894736842105,30,26,4,0.3333333333333333,0,0,0,0,0,0,0,0,0.0,0.2,-17,7,-13,0.07894736842105271,-0.20833333333333331,-25
2003-02-01,Arsenal,Fulham,2,1,H,25,53,87,43,0.6842105263157895,54,27,27,0.64,24,27,44,-8,0.2631578947368421,25,31,-6,0.2916666666666667,0,0,0,0,0,0,0,0,0.6,0.2,26,43,51,0.4210526315789474,0.34833333333333333,33
2003-02-01,Bolton,Birmingham,4,2,H,25,21,40,-18,0.2368421052631579,25,41,-16,0.16,24,26,-1,-1,0.0,20,32,-12,0.25,0,0,0,0,0,0,0,0,0.0,0.0,-5,41,-17,0.2368421052631579,-0.09,-4
2003-02-01,Chelsea,Tottenham,1,1,D,25,44,64,28,0.4473684210526316,44,25,19,0.48,25,38,50,-4,0.3684210526315789,35,35,0,0.44,0,0,0,0,0,0,0,0,0.4,0.4,6,14,32,0.07894736842105265,0.03999999999999998,19
2003-02-01,Everton,Leeds,2,0,H,25,42,43,-12,0.2894736842105263,32,30,2,0.48,25,31,66,16,0.4736842105263158,33,32,1,0.36,0,0,0,0,0,0,0,0,0.4,0.4,11,-23,-28,-0.1842105263157895,0.12,1
2003-02-01,Man City,West Brom,1,2,A,25,37,-1,-1,0.0,36,35,1,0.44,24,17,-1,-1,0.0,17,36,-19,0.16666666666666666,0,0,0,0,0,0,0,0,0.6,0.0,20,0,0,0.0,0.2733333333333333,20
2003-02-01,Southampton,Man United,0,2,A,25,39,45,-8,0.3157894736842105,28,23,5,0.4,24,47,77,42,0.631578947368421,40,24,16,0.5833333333333334,0,0,0,0,1,0,0,0,0.6,0.8,-8,-32,-50,-0.3157894736842105,-0.18333333333333335,-11
2003-02-01,Sunderland,Charlton,1,3,A,25,19,40,-22,0.2631578947368421,16,35,-19,0.16,25,36,44,-11,0.2631578947368421,31,32,-1,0.4,0,0,0,0,0,0,0,0,0.0,0.6,-17,-4,-11,0.0,-0.24000000000000002,-18
2003-02-02,Aston Villa,Blackburn,3,0,H,25,32,50,-1,0.3157894736842105,27,27,0,0.36,25,34,46,4,0.3157894736842105,31,28,3,0.32,0,0,0,0,0,0,0,0,0.6,0.2,-2,4,-5,0.0,0.03999999999999998,-3
2003-02-02,West Ham,Liverpool,0,3,A,25,20,53,-9,0.3947368421052632,28,48,-20,0.16,25,39,80,37,0.631578947368421,34,25,9,0.4,0,0,0,0,0,0,0,0,0.2,0.2,-19,-27,-46,-0.2368421052631578,-0.24000000000000002,-29
2003-02-04,Birmingham,Man United,0,1,A,25,26,-1,-1,0.0,22,36,-14,0.24,25,50,77,42,0.631578947368421,42,24,18,0.6,0,0,0,0,1,1,0,0,0.0,1.0,-24,-78,-43,-0.631578947368421,-0.36,-32
2003-02-08,Birmingham,Chelsea,1,3,A,26,26,-1,-1,0.0,22,37,-15,0.23076923076923078,26,45,64,28,0.4473684210526316,45,26,19,0.46153846153846156,0,0,0,0,0,0,0,0,0.0,0.4,-19,-65,-29,-0.4473684210526316,-0.23076923076923078,-34
2003-02-08,Blackburn,Southampton,1,0,H,26,34,46,4,0.3157894736842105,31,31,0,0.3076923076923077,26,39,45,-8,0.3157894736842105,28,25,3,0.38461538461538464,0,0,0,0,0,0,0,0,0.2,0.4,-5,1,12,0.0,-0.07692307692307693,-3
2003-02-08,Charlton,Everton,2,1,H,26,39,44,-11,0.2631578947368421,34,33,1,0.4230769230769231,26,45,43,-12,0.2894736842105263,34,30,4,0.5,1,0,0,0,1,0,0,0,0.6,0.6,-6,1,1,-0.026315789473684237,-0.07692307692307693,-3
2003-02-08,Fulham,Aston Villa,2,1,H,25,27,44,-8,0.2631578947368421,26,33,-7,0.28,26,35,50,-1,0.3157894736842105,30,27,3,0.38461538461538464,0,0,0,0,0,0,0,0,0.2,0.6,-8,-6,-7,-0.05263157894736842,-0.10461538461538461,-10
2003-02-08,Leeds,West Ham,1,0,H,26,31,66,16,0.4736842105263158,33,34,-1,0.34615384615384615,26,20,53,-9,0.3947368421052632,28,51,-23,0.15384615384615385,0,0,0,0,0,0,0,0,0.2,0.2,11,13,25,0.0789473684210526,0.1923076923076923,22
2003-02-08,Liverpool,Middlesboro,1,1,D,26,42,80,37,0.631578947368421,37,25,12,0.4230769230769231,25,30,-1,-1,0.0,29,29,0,0.32,0,0,0,0,0,0,0,0,0.4,0.0,12,81,38,0.631578947368421,0.10307692307692307,12
2003-02-08,Tottenham,Sunderland,4,1,H,26,39,50,-4,0.3684210526315789,36,36,0,0.4230769230769231,26,19,40,-22,0.2631578947368421,17,38,-21,0.15384615384615385,0,0,0,0,0,0,1,0,0.4,0.0,20,10,18,0.10526315789473684,0.2692307692307692,21
2003-02-08,West Brom,Bolton,1,1,D,25,20,-1,-1,0.0,19,37,-18,0.2,26,24,40,-18,0.2368421052631579,29,43,-14,0.19230769230769232,0,0,0,0,0,0,0,0,0.2,0.2,-4,-41,17,-0.2368421052631579,0.007692307692307693,-4
2003-02-09,Man United,Man City,1,1,D,26,53,77,42,0.631578947368421,43,24,19,0.6153846153846154,26,37,-1,-1,0.0,37,37,0,0.4230769230769231,1,1,0,0,0,0,0,0,1.0,0.4,16,78,43,0.631578947368421,0.19230769230769235,19
2003-02-09,Newcastle,Arsenal,1,1,D,25,48,71,22,0.5526315789473685,41,31,10,0.6,26,56,87,43,0.6842105263157895,56,28,28,0.6538461538461539,1,0,0,0,0,0,0,0,0.8,0.8,-8,-16,-21,-0.13157894736842102,-0.05384615384615388,-18
2003-02-19,Fulham,West Brom,3,0,H,26,30,44,-8,0.2631578947368421,28,34,-6,0.3076923076923077,26,21,-1,-1,0.0,20,38,-18,0.19230769230769232,0,0,0,0,0,0,0,0,0.4,0.2,9,45,-7,0.2631578947368421,0.11538461538461539,12
2003-02-22,Bolton,Man United,1,1,D,27,25,40,-18,0.2368421052631579,30,44,-14,0.18518518518518517,27,54,77,42,0.631578947368421,44,25,19,0.5925925925925926,0,0,0,0,0,0,0,0,0.2,0.8,-29,-37,-60,-0.3947368421052631,-0.4074074074074074,-33
2003-02-22,Charlton,Aston Villa,3,0,H,27,42,44,-11,0.2631578947368421,36,34,2,0.4444444444444444,27,35,50,-1,0.3157894736842105,31,29,2,0.37037037037037035,1,0,0,0,0,0,0,0,0.8,0.4,7,-6,-10,-0.05263157894736842,0.07407407407407407,0
2003-02-22,Chelsea,Blackburn,1,2,A,27,48,64,28,0.4473684210526316,48,27,21,0.48148148148148145,27,37,46,4,0.3157894736842105,32,31,1,0.3333333333333333,0,0,0,0,0,0,0,0,0.6,0.2,11,18,24,0.13157894736842107,0.14814814814814814,20
2003-02-22,Everton,Southampton,2,1,H,27,45,43,-12,0.2894736842105263,35,32,3,0.48148148148148145,27,39,45,-8,0.3157894736842105,28,26,2,0.37037037037037035,0,0,0,0,0,0,0,0,0.6,0.2,6,-2,-4,-0.02631578947368418,0.1111111111111111,1
2003-02-22,Leeds,Newcastle,0,3,A,27,34,66,16,0.4736842105263158,34,34,0,0.37037037037037035,26,49,71,22,0.5526315789473685,42,32,10,0.5769230769230769,0,0,0,0,0,0,0,0,0.2,0.6,-15,-5,-6,-0.07894736842105265,-0.20655270655270652,-10
2003-02-22,Man City,Arsenal,1,5,A,27,38,-1,-1,0.0,38,38,0,0.4074074074074074,27,57,87,43,0.6842105263157895,57,29,28,0.6296296296296297,0,0,0,0,0,0,0,0,0.4,0.6,-19,-88,-44,-0.6842105263157895,-0.22222222222222227,-28
2003-02-22,Sunderland,Middlesboro,1,3,A,27,19,40,-22,0.2631578947368421,18,42,-24,0.14814814814814814,26,31,-1,-1,0.0,30,30,0,0.3076923076923077,0,0,1,0,0,0,0,0,0.0,0.0,-12,41,-21,0.2631578947368421,-0.15954415954415957,-24
2003-02-23,Birmingham,Liverpool,2,1,H,27,26,-1,-1,0.0,23,40,-17,0.2222222222222222,27,43,80,37,0.631578947368421,38,26,12,0.4074074074074074,0,0,1,0,0,0,0,0,0.0,0.4,-17,-81,-38,-0.631578947368421,-0.18518518518518517,-29
2003-02-23,West Brom,West Ham,1,2,A,27,21,-1,-1,0.0,20,41,-21,0.18518518518518517,27,20,53,-9,0.3947368421052632,28,52,-24,0.14814814814814814,0,0,0,0,0,0,0,0,0.2,0.2,1,-54,8,-0.3947368421052632,0.037037037037037035,3
2003-02-24,Tottenham,Fulham,1,1,D,27,42,50,-4,0.3684210526315789,40,37,3,0.4444444444444444,27,33,44,-8,0.2631578947368421,31,34,-3,0.3333333333333333,0,0,0,0,0,0,0,0,0.6,0.6,9,6,4,0.10526315789473684,0.1111111111111111,6
2003-03-01,Blackburn,Man City,1,0,H,28,40,46,4,0.3157894736842105,34,32,2,0.35714285714285715,28,38,-1,-1,0.0,39,43,-4,0.39285714285714285,0,0,0,0,0,0,0,0,0.4,0.2,2,47,5,0.3157894736842105,-0.0357142857142857,6
2003-03-01,Fulham,Sunderland,1,0,H,28,34,44,-8,0.2631578947368421,32,35,-3,0.32142857142857145,28,19,40,-22,0.2631578947368421,19,45,-26,0.14285714285714285,0,0,0,0,0,0,1,1,0.4,0.0,15,4,14,0.0,0.1785714285714286,23
2003-03-01,Middlesboro,Everton,1,1,D,27,34,-1,-1,0.0,33,31,2,0.3333333333333333,28,48,43,-12,0.2894736842105263,37,33,4,0.5,0,0,0,0,0,0,0,0,0.2,0.8,-14,-44,11,-0.2894736842105263,-0.16666666666666669,-2
2003-03-01,Newcastle,Chelsea,2,1,H,27,52,71,22,0.5526315789473685,45,32,13,0.5925925925925926,28,48,64,28,0.4473684210526316,49,29,20,0.4642857142857143,0,0,0,0,0,0,0,0,0.8,0.4,4,7,-6,0.10526315789473689,0.12830687830687826,-7
2003-03-01,Southampton,West Brom,1,0,H,28,39,45,-8,0.3157894736842105,29,28,1,0.35714285714285715,28,21,-1,-1,0.0,21,43,-22,0.17857142857142858,0,0,1,0,0,0,0,0,0.2,0.2,18,46,-7,0.3157894736842105,0.17857142857142858,23
2003-03-01,West Ham,Tottenham,2,0,H,28,23,53,-9,0.3947368421052632,30,53,-23,0.17857142857142858,28,43,50,-4,0.3684210526315789,41,38,3,0.42857142857142855,0,0,0,0,0,0,0,0,0.4,0.4,-20,3,-5,0.026315789473684292,-0.24999999999999997,-26
2003-03-02,Arsenal,Charlton,2,0,H,28,60,87,43,0.6842105263157895,62,30,32,0.6428571428571429,28,45,44,-11,0.2631578947368421,39,34,5,0.4642857142857143,0,0,0,0,1,1,0,0,0.6,1.0,15,43,54,0.4210526315789474,0.1785714285714286,27
2003-03-03,Aston Villa,Birmingham,0,2,A,28,35,50,-1,0.3157894736842105,31,32,-1,0.35714285714285715,28,29,-1,-1,0.0,25,41,-16,0.25,0,0,0,0,0,0,0,0,0.4,0.2,6,51,0,0.3157894736842105,0.10714285714285715,15
2003-03-05,Man United,Leeds,2,1,H,28,55,77,42,0.631578947368421,45,26,19,0.5714285714285714,28,34,66,16,0.4736842105263158,34,37,-3,0.35714285714285715,0,0,0,0,0,0,0,0,0.6,0.2,21,11,26,0.1578947368421052,0.21428571428571425,22
2003-03-05,Middlesboro,Newcastle,1,0,H,28,35,-1,-1,0.0,34,32,2,0.32142857142857145,28,55,71,22,0.5526315789473685,47,33,14,0.6071428571428571,0,0,0,0,0,0,0,0,0.2,0.8,-20,-72,-23,-0.5526315789473685,-0.28571428571428564,-12
2003-03-08,Liverpool,Bolton,2,0,H,28,43,80,37,0.631578947368421,39,28,11,0.39285714285714285,28,26,40,-18,0.2368421052631579,31,45,-14,0.17857142857142858,0,0,0,0,0,0,0,0,0.4,0.2,17,40,55,0.3947368421052631,0.21428571428571427,25
2003-03-15,Aston Villa,Man United,0,1,A,29,35,50,-1,0.3157894736842105,31,34,-3,0.3448275862068966,29,58,77,42,0.631578947368421,47,27,20,0.5862068965517241,0,0,1,0,0,0,0,0,0.4,0.6,-23,-27,-43,-0.3157894736842105,-0.2413793103448275,-23
2003-03-15,Blackburn,Arsenal,2,0,H,29,43,46,4,0.3157894736842105,35,32,3,0.3793103448275862,29,63,87,43,0.6842105263157895,64,30,34,0.6551724137931034,1,0,0,0,0,0,0,0,0.6,0.6,-20,-41,-39,-0.368421052631579,-0.27586206896551724,-31
2003-03-15,Charlton,Newcastle,0,2,A,29,45,44,-11,0.2631578947368421,39,36,3,0.4482758620689655,29,55,71,22,0.5526315789473685,47,34,13,0.5862068965517241,0,0,0,0,0,0,0,0,0.8,0.6,-10,-27,-33,-0.2894736842105264,-0.13793103448275856,-10
2003-03-15,Everton,West Ham,0,0,D,29,49,43,-12,0.2894736842105263,38,34,4,0.4827586206896552,29,26,53,-9,0.3947368421052632,32,53,-21,0.20689655172413793,0,0,0,0,0,0,0,0,0.6,0.6,23,-10,-3,-0.10526315789473689,0.27586206896551724,25
2003-03-15,Fulham,Southampton,2,2,D,29,37,44,-8,0.2631578947368421,33,35,-2,0.3448275862068966,29,42,45,-8,0.3157894736842105,30,28,2,0.3793103448275862,0,0,0,0,0,0,0,0,0.6,0.4,-5,-1,0,-0.05263157894736842,-0.03448275862068961,-4
2003-03-15,Leeds,Middlesboro,2,3,A,29,34,66,16,0.4736842105263158,35,39,-4,0.3448275862068966,29,38,-1,-1,0.0,35,32,3,0.3448275862068966,0,0,0,0,0,0,0,0,0.2,0.4,-4,67,17,0.4736842105263158,0.0,-7
2003-03-15,Sunderland,Bolton,0,2,A,29,19,40,-22,0.2631578947368421,19,46,-27,0.13793103448275862,29,26,40,-18,0.2368421052631579,31,47,-16,0.1724137931034483,0,0,1,1,0,0,0,0,0.0,0.2,-7,0,-4,0.02631578947368418,-0.03448275862068967,-11
2003-03-16,Man City,Birmingham,1,0,H,29,38,-1,-1,0.0,39,44,-5,0.3793103448275862,29,32,-1,-1,0.0,27,41,-14,0.27586206896551724,0,0,0,0,0,0,0,0,0.2,0.4,6,0,0,0.0,0.10344827586206895,9
2003-03-16,Tottenham,Liverpool,2,3,A,29,43,50,-4,0.3684210526315789,41,40,1,0.41379310344827586,29,46,80,37,0.631578947368421,41,28,13,0.41379310344827586,0,0,0,0,0,0,0,0,0.2,0.4,-3,-30,-41,-0.2631578947368421,0.0,-12
2003-03-16,West Brom,Chelsea,0,2,A,29,21,-1,-1,0.0,21,44,-23,0.1724137931034483,29,48,64,28,0.4473684210526316,50,31,19,0.4482758620689655,0,0,1,0,0,0,0,0,0.2,0.4,-27,-65,-29,-0.4473684210526316,-0.27586206896551724,-42
2003-03-22,Birmingham,West Brom,1,0,H,30,32,-1,-1,0.0,27,42,-15,0.26666666666666666,30,21,-1,-1,0.0,21,46,-25,0.16666666666666666,0,0,0,0,0,0,1,0,0.4,0.0,11,0,0,0.0,0.1,10
2003-03-22,Chelsea,Man City,5,0,H,30,51,64,28,0.4473684210526316,52,31,21,0.4666666666666667,30,41,-1,-1,0.0,40,44,-4,0.4,0,0,0,0,0,0,0,0,0.4,0.2,10,65,29,0.4473684210526316,0.06666666666666665,25
2003-03-22,Man United,Fulham,3,0,H,30,61,77,42,0.631578947368421,48,27,21,0.6,30,38,44,-8,0.2631578947368421,35,37,-2,0.3333333333333333,0,0,0,0,0,0,0,0,0.6,0.6,23,33,50,0.3684210526315789,0.26666666666666666,23
2003-03-22,Middlesboro,Charlton,1,1,D,30,41,-1,-1,0.0,38,34,4,0.36666666666666664,30,45,44,-11,0.2631578947368421,39,38,1,0.43333333333333335,0,0,0,0,0,0,0,0,0.6,0.6,-4,-45,10,-0.2631578947368421,-0.06666666666666671,3
2003-03-22,Newcastle,Blackburn,5,1,H,30,58,71,22,0.5526315789473685,49,34,15,0.6,30,46,46,4,0.3157894736842105,37,32,5,0.4,0,0,0,0,1,0,0,0,0.6,0.8,12,25,18,0.23684210526315796,0.19999999999999996,10
2003-03-22,Southampton,Aston Villa,2,2,D,30,43,45,-8,0.3157894736842105,32,30,2,0.36666666666666664,30,35,50,-1,0.3157894736842105,31,35,-4,0.3333333333333333,0,0,0,0,0,0,1,0,0.2,0.2,8,-5,-7,0.0,0.033333333333333326,6
2003-03-22,West Ham,Sunderland,2,0,H,30,27,53,-9,0.3947368421052632,32,53,-21,0.2,30,19,40,-22,0.2631578947368421,19,48,-29,0.13333333333333333,0,0,0,0,0,0,1,1,0.4,0.0,8,13,13,0.13157894736842113,0.06666666666666668,8
2003-03-23,Arsenal,Everton,2,1,H,30,63,87,43,0.6842105263157895,64,32,32,0.6333333333333333,30,50,43,-12,0.2894736842105263,38,34,4,0.4666666666666667,0,0,0,0,0,0,0,0,0.6,0.4,13,44,55,0.39473684210526316,0.16666666666666663,28
2003-03-23,Liverpool,Leeds,3,1,H,30,49,80,37,0.631578947368421,44,30,14,0.43333333333333335,30,34,66,16,0.4736842105263158,37,42,-5,0.3333333333333333,0,0,0,0,0,0,1,0,0.6,0.2,15,14,21,0.1578947368421052,0.10000000000000003,19
2003-03-24,Bolton,Tottenham,1,0,H,30,29,40,-18,0.2368421052631579,33,47,-14,0.2,30,43,50,-4,0.3684210526315789,43,43,0,0.4,0,0,0,0,0,0,0,0,0.4,0.2,-14,-10,-14,-0.13157894736842102,-0.2,-14
2003-04-05,Aston Villa,Arsenal,1,1,D,31,36,50,-1,0.3157894736842105,33,37,-4,0.3225806451612903,31,66,87,43,0.6842105263157895,66,33,33,0.6451612903225806,0,0,0,0,0,0,0,0,0.0,0.6,-30,-37,-44,-0.368421052631579,-0.3225806451612903,-37
2003-04-05,Bolton,Man City,2,0,H,31,32,40,-18,0.2368421052631579,34,47,-13,0.22580645161290322,31,41,-1,-1,0.0,40,49,-9,0.3870967741935484,0,0,0,0,0,0,0,0,0.4,0.2,-9,41,-17,0.2368421052631579,-0.16129032258064516,-4
2003-04-05,Charlton,Leeds,1,6,A,31,46,44,-11,0.2631578947368421,40,39,1,0.41935483870967744,31,34,66,16,0.4736842105263158,38,45,-7,0.3225806451612903,0,0,0,0,0,0,1,0,0.4,0.2,12,-22,-27,-0.21052631578947373,0.09677419354838712,8
2003-04-05,Man United,Liverpool,4,0,H,31,64,77,42,0.631578947368421,51,27,24,0.6129032258064516,31,52,80,37,0.631578947368421,47,31,16,0.45161290322580644,1,0,0,0,1,0,0,0,0.6,0.6,12,-3,5,0.0,0.16129032258064518,8
2003-04-05,Middlesboro,West Brom,3,0,H,31,42,-1,-1,0.0,39,35,4,0.3548387096774194,31,21,-1,-1,0.0,21,47,-26,0.16129032258064516,0,0,0,0,0,0,1,1,0.6,0.0,21,0,0,0.0,0.19354838709677422,30
2003-04-05,Southampton,West Ham,1,1,D,31,44,45,-8,0.3157894736842105,34,32,2,0.3548387096774194,31,30,53,-9,0.3947368421052632,34,53,-19,0.22580645161290322,0,0,0,0,0,0,0,0,0.2,0.6,14,-8,1,-0.07894736842105271,0.12903225806451615,21
2003-04-05,Sunderland,Chelsea,1,2,A,31,19,40,-22,0.2631578947368421,19,50,-31,0.12903225806451613,31,54,64,28,0.4473684210526316,57,31,26,0.4838709677419355,0,0,1,1,0,0,0,0,0.0,0.6,-35,-24,-50,-0.1842105263157895,-0.3548387096774194,-57
2003-04-05,Tottenham,Birmingham,2,1,H,31,43,50,-4,0.3684210526315789,43,44,-1,0.3870967741935484,31,35,-1,-1,0.0,28,42,-14,0.2903225806451613,0,0,1,0,0,0,0,0,0.2,0.6,8,51,-3,0.3684210526315789,0.09677419354838707,13
2003-04-06,Everton,Newcastle,2,1,H,31,50,43,-12,0.2894736842105263,39,36,3,0.45161290322580644,31,61,71,22,0.5526315789473685,54,35,19,0.6129032258064516,0,0,0,0,0,0,0,0,0.2,0.8,-11,-28,-34,-0.26315789473684215,-0.16129032258064518,-16
2003-04-07,Fulham,Blackburn,0,4,A,31,38,44,-8,0.2631578947368421,35,40,-5,0.3225806451612903,31,46,46,4,0.3157894736842105,38,37,1,0.3870967741935484,0,0,0,0,0,0,0,0,0.4,0.8,-8,-2,-12,-0.05263157894736842,-0.06451612903225806,-6
2003-04-12,Birmingham,Sunderland,2,0,H,32,35,-1,-1,0.0,29,44,-15,0.28125,32,19,40,-22,0.2631578947368421,20,52,-32,0.125,0,0,0,0,0,0,1,1,0.6,0.0,16,-41,21,-0.2631578947368421,0.15625,17
2003-04-12,Blackburn,Charlton,1,0,H,32,49,46,4,0.3157894736842105,42,37,5,0.40625,32,46,44,-11,0.2631578947368421,41,45,-4,0.40625,0,0,0,0,0,0,0,0,0.8,0.2,3,2,15,0.05263157894736842,0.0,9
2003-04-12,Chelsea,Bolton,1,0,H,32,57,64,28,0.4473684210526316,59,32,27,0.5,32,35,40,-18,0.2368421052631579,36,47,-11,0.25,1,0,0,0,1,0,0,0,0.6,0.6,22,24,46,0.21052631578947367,0.25,38
2003-04-12,Leeds,Tottenham,2,2,D,32,37,66,16,0.4736842105263158,44,46,-2,0.34375,32,46,50,-4,0.3684210526315789,45,45,0,0.40625,0,0,0,0,0,0,0,0,0.2,0.2,-9,16,20,0.10526315789473689,-0.0625,-2
2003-04-12,Liverpool,Fulham,2,0,H,32,52,80,37,0.631578947368421,47,35,12,0.4375,32,38,44,-8,0.2631578947368421,35,44,-9,0.3125,0,0,0,0,0,0,0,0,0.6,0.2,14,36,45,0.3684210526315789,0.125,21
2003-04-12,Man City,Middlesboro,0,0,D,32,41,-1,-1,0.0,40,51,-11,0.375,32,45,-1,-1,0.0,42,35,7,0.375,0,0,0,0,0,0,0,0,0.2,0.6,-4,0,0,0.0,0.0,-18
2003-04-12,Newcastle,Man United,2,6,A,32,61,71,22,0.5526315789473685,55,37,18,0.59375,32,67,77,42,0.631578947368421,55,27,28,0.625,0,0,0,0,1,0,0,0,0.6,0.8,-6,-6,-20,-0.07894736842105254,-0.03125,-10
2003-04-12,West Brom,Everton,1,2,A,32,21,-1,-1,0.0,21,50,-29,0.15625,32,53,43,-12,0.2894736842105263,41,37,4,0.46875,0,0,1,1,0,0,0,0,0.0,0.4,-32,-44,11,-0.2894736842105263,-0.3125,-33
2003-04-12,West Ham,Aston Villa,2,2,D,32,31,53,-9,0.3947368421052632,35,54,-19,0.21875,32,37,50,-1,0.3157894736842105,34,38,-4,0.3125,0,0,0,0,0,0,0,0,0.6,0.0,-6,3,-8,0.07894736842105271,-0.09375,-15
2003-04-16,Arsenal,Man United,2,2,D,32,67,87,43,0.6842105263157895,67,34,33,0.625,33,70,77,42,0.631578947368421,61,29,32,0.6363636363636364,0,0,0,0,1,1,0,0,0.6,1.0,-3,10,1,0.052631578947368474,-0.011363636363636354,1
2003-04-18,Tottenham,Man City,0,2,A,33,47,50,-4,0.3684210526315789,47,47,0,0.3939393939393939,33,42,-1,-1,0.0,40,51,-11,0.36363636363636365,0,0,0,0,0,0,0,0,0.2,0.2,5,51,-3,0.3684210526315789,0.030303030303030276,11
2003-04-19,Aston Villa,Chelsea,2,1,H,33,38,50,-1,0.3157894736842105,36,40,-4,0.30303030303030304,33,60,64,28,0.4473684210526316,60,32,28,0.5151515151515151,0,0,0,0,1,0,0,0,0.0,0.8,-22,-14,-29,-0.13157894736842107,-0.2121212121212121,-32
2003-04-19,Bolton,West Ham,1,0,H,33,35,40,-18,0.2368421052631579,36,48,-12,0.24242424242424243,33,32,53,-9,0.3947368421052632,37,56,-19,0.21212121212121213,0,0,0,0,0,0,0,0,0.6,0.4,3,-13,-9,-0.1578947368421053,0.030303030303030304,7
2003-04-19,Charlton,Birmingham,0,2,A,33,46,44,-11,0.2631578947368421,41,46,-5,0.3939393939393939,33,38,-1,-1,0.0,31,44,-13,0.30303030303030304,0,0,0,0,0,0,0,0,0.0,0.6,8,45,-10,0.2631578947368421,0.09090909090909088,8
2003-04-19,Everton,Liverpool,1,2,A,33,56,43,-12,0.2894736842105263,43,38,5,0.48484848484848486,33,55,80,37,0.631578947368421,49,35,14,0.45454545454545453,0,0,0,0,0,0,0,0,0.4,0.8,1,-37,-49,-0.3421052631578947,0.03030303030303033,-9
2003-04-19,Fulham,Newcastle,2,1,H,33,38,44,-8,0.2631578947368421,35,46,-11,0.30303030303030304,33,61,71,22,0.5526315789473685,57,43,14,0.5757575757575758,0,0,1,0,0,0,0,0,0.2,0.4,-23,-27,-30,-0.2894736842105264,-0.27272727272727276,-25
2003-04-19,Man United,Blackburn,3,1,H,34,71,77,42,0.631578947368421,63,31,32,0.6176470588235294,33,52,46,4,0.3157894736842105,43,37,6,0.42424242424242425,0,0,0,0,0,0,0,0,0.8,0.8,19,31,38,0.3157894736842105,0.19340463458110518,26
2003-04-19,Middlesboro,Arsenal,0,2,A,33,46,-1,-1,0.0,42,35,7,0.36363636363636365,33,68,87,43,0.6842105263157895,69,36,33,0.6060606060606061,0,0,0,0,0,0,0,0,0.6,0.4,-22,-88,-44,-0.6842105263157895,-0.24242424242424243,-26
2003-04-19,Southampton,Leeds,3,2,H,32,45,45,-8,0.3157894736842105,35,33,2,0.34375,33,38,66,16,0.4736842105263158,46,48,-2,0.3333333333333333,0,0,0,0,0,0,0,0,0.2,0.2,7,-21,-24,-0.1578947368421053,0.010416666666666685,4
2003-04-19,Sunderland,West Brom,1,2,A,33,19,40,-22,0.2631578947368421,20,54,-34,0.12121212121212122,33,21,-1,-1,0.0,22,52,-30,0.15151515151515152,0,0,1,1,0,0,1,1,0.0,0.0,-2,41,-21,0.2631578947368421,-0.030303030303030304,-4
2003-04-21,Birmingham,Southampton,3,2,H,34,41,-1,-1,0.0,33,44,-11,0.3235294117647059,33,48,45,-8,0.3157894736842105,38,35,3,0.36363636363636365,0,0,0,0,0,0,0,0,0.6,0.4,-7,-46,7,-0.3157894736842105,-0.04010695187165775,-14
2003-04-21,Blackburn,Bolton,0,0,D,34,52,46,4,0.3157894736842105,44,40,4,0.4117647058823529,34,38,40,-18,0.2368421052631579,37,48,-11,0.2647058823529412,0,0,0,0,0,0,0,0,0.6,0.8,14,6,22,0.0789473684210526,0.14705882352941174,15
2003-04-21,Chelsea,Everton,4,1,H,34,60,64,28,0.4473684210526316,61,34,27,0.5,34,56,43,-12,0.2894736842105263,44,40,4,0.47058823529411764,0,0,0,0,0,0,0,0,0.8,0.4,4,21,40,0.15789473684210525,0.02941176470588236,23
2003-04-21,Liverpool,Charlton,2,1,H,34,58,80,37,0.631578947368421,51,36,15,0.47058823529411764,34,46,44,-11,0.2631578947368421,41,48,-7,0.38235294117647056,0,0,0,0,0,0,1,0,0.8,0.0,12,36,48,0.3684210526315789,0.08823529411764708,22
2003-04-21,Man City,Sunderland,3,0,H,34,45,-1,-1,0.0,42,51,-9,0.38235294117647056,34,19,40,-22,0.2631578947368421,21,56,-35,0.11764705882352941,0,0,0,0,0,0,1,1,0.4,0.0,26,-41,21,-0.2631578947368421,0.2647058823529411,26
2003-04-21,Newcastle,Aston Villa,1,1,D,34,61,71,22,0.5526315789473685,58,45,13,0.5588235294117647,34,41,50,-1,0.3157894736842105,38,41,-3,0.3235294117647059,0,0,1,0,0,0,0,0,0.4,0.2,20,21,23,0.23684210526315796,0.23529411764705882,16
2003-04-21,West Brom,Tottenham,2,3,A,34,24,-1,-1,0.0,24,53,-29,0.17647058823529413,34,47,50,-4,0.3684210526315789,47,49,-2,0.38235294117647056,0,0,0,0,0,0,0,0,0.2,0.2,-23,-51,3,-0.3684210526315789,-0.20588235294117643,-27
2003-04-21,West Ham,Middlesboro,1,0,H,34,32,53,-9,0.3947368421052632,37,57,-20,0.20588235294117646,34,46,-1,-1,0.0,42,37,5,0.35294117647058826,0,0,0,0,0,0,0,0,0.2,0.4,-14,54,-8,0.3947368421052632,-0.1470588235294118,-25
2003-04-22,Leeds,Fulham,2,0,H,34,38,66,16,0.4736842105263158,48,51,-3,0.3235294117647059,34,41,44,-8,0.2631578947368421,37,47,-10,0.3235294117647059,0,0,0,0,0,0,0,0,0.2,0.2,-3,22,24,0.21052631578947373,0.0,7
2003-04-26,Birmingham,Middlesboro,3,0,H,35,44,-1,-1,0.0,36,46,-10,0.34285714285714286,35,46,-1,-1,0.0,42,38,4,0.34285714285714286,1,0,0,0,0,0,0,0,0.8,0.2,-2,0,0,0.0,0.0,-14
2003-04-26,Bolton,Arsenal,2,2,D,35,39,40,-18,0.2368421052631579,37,48,-11,0.2571428571428571,34,71,87,43,0.6842105263157895,71,36,35,0.6176470588235294,0,0,0,0,0,0,0,0,0.6,0.4,-32,-47,-61,-0.4473684210526316,-0.3605042016806723,-46
2003-04-26,Charlton,Southampton,2,1,H,35,46,44,-11,0.2631578947368421,42,50,-8,0.37142857142857144,34,48,45,-8,0.3157894736842105,40,38,2,0.35294117647058826,0,0,1,0,0,0,0,0,0.0,0.2,-2,-1,-3,-0.05263157894736842,0.018487394957983183,-10
2003-04-26,Chelsea,Fulham,1,1,D,35,63,64,28,0.4473684210526316,65,35,30,0.5142857142857142,35,41,44,-8,0.2631578947368421,37,49,-12,0.3142857142857143,0,0,0,0,0,0,0,0,0.8,0.2,22,20,36,0.1842105263157895,0.19999999999999996,42
2003-04-26,Everton,Aston Villa,2,1,H,35,56,43,-12,0.2894736842105263,45,44,1,0.45714285714285713,35,42,50,-1,0.3157894736842105,39,42,-3,0.3142857142857143,0,0,0,0,0,0,0,0,0.4,0.2,14,-7,-11,-0.02631578947368418,0.14285714285714285,4
2003-04-26,Leeds,Blackburn,2,3,A,35,41,66,16,0.4736842105263158,50,51,-1,0.34285714285714286,35,53,46,4,0.3157894736842105,44,40,4,0.4,0,0,0,0,0,0,0,0,0.4,0.4,-12,20,12,0.1578947368421053,-0.05714285714285716,-5
2003-04-26,Sunderland,Newcastle,0,1,A,35,19,40,-22,0.2631578947368421,21,59,-38,0.11428571428571428,35,62,71,22,0.5526315789473685,59,46,13,0.5428571428571428,0,0,1,1,0,0,0,0,0.0,0.2,-43,-31,-44,-0.2894736842105264,-0.42857142857142855,-51
2003-04-26,West Brom,Liverpool,0,6,A,35,24,-1,-1,0.0,26,56,-30,0.17142857142857143,35,61,80,37,0.631578947368421,53,37,16,0.4857142857142857,0,0,0,0,1,0,0,0,0.2,0.8,-37,-81,-38,-0.631578947368421,-0.3142857142857143,-46
2003-04-27,Man City,West Ham,0,1,A,35,48,-1,-1,0.0,45,51,-6,0.4,35,35,53,-9,0.3947368421052632,38,57,-19,0.22857142857142856,0,0,0,0,0,0,0,0,0.4,0.4,13,-54,8,-0.3947368421052632,0.17142857142857146,13
2003-04-27,Tottenham,Man United,0,2,A,35,50,50,-4,0.3684210526315789,50,51,-1,0.4,35,74,77,42,0.631578947368421,66,32,34,0.6285714285714286,0,0,0,0,0,0,0,0,0.4,0.8,-24,-27,-46,-0.2631578947368421,-0.22857142857142854,-35
2003-05-03,Aston Villa,Sunderland,1,0,H,36,42,50,-1,0.3157894736842105,40,44,-4,0.3055555555555556,36,19,40,-22,0.2631578947368421,21,60,-39,0.1111111111111111,0,0,0,0,0,0,1,1,0.2,0.0,23,10,21,0.05263157894736842,0.19444444444444448,35
2003-05-03,Blackburn,West Brom,1,1,D,36,56,46,4,0.3157894736842105,47,42,5,0.4166666666666667,36,24,-1,-1,0.0,26,62,-36,0.16666666666666666,0,0,0,0,0,0,0,0,0.6,0.2,32,47,5,0.3157894736842105,0.25,41
2003-05-03,Fulham,Everton,2,0,H,36,42,44,-8,0.2631578947368421,38,50,-12,0.3055555555555556,36,59,43,-12,0.2894736842105263,47,45,2,0.4722222222222222,0,0,0,0,0,0,0,0,0.2,0.6,-17,1,4,-0.026315789473684237,-0.16666666666666663,-14
2003-05-03,Liverpool,Man City,1,2,A,36,64,80,37,0.631578947368421,59,37,22,0.5,36,48,-1,-1,0.0,45,52,-7,0.3888888888888889,1,0,0,0,0,0,0,0,0.8,0.4,16,81,38,0.631578947368421,0.1111111111111111,29
2003-05-03,Man United,Charlton,4,1,H,36,77,77,42,0.631578947368421,68,32,36,0.6388888888888888,36,49,44,-11,0.2631578947368421,44,51,-7,0.3888888888888889,0,0,0,0,0,0,0,0,0.8,0.2,28,33,53,0.3684210526315789,0.24999999999999994,43
2003-05-03,Middlesboro,Tottenham,5,1,H,36,46,-1,-1,0.0,42,41,1,0.3333333333333333,36,50,50,-4,0.3684210526315789,50,53,-3,0.3888888888888889,0,0,1,0,0,0,0,0,0.2,0.4,-4,-51,3,-0.3684210526315789,-0.05555555555555558,4
2003-05-03,Newcastle,Birmingham,1,0,H,36,65,71,22,0.5526315789473685,60,46,14,0.5555555555555556,36,47,-1,-1,0.0,39,46,-7,0.3611111111111111,0,0,0,0,1,0,0,0,0.2,0.8,18,72,23,0.5526315789473685,0.19444444444444448,21
2003-05-03,Southampton,Bolton,0,0,D,35,48,45,-8,0.3157894736842105,41,40,1,0.34285714285714286,36,40,40,-18,0.2368421052631579,39,50,-11,0.25,0,0,0,0,0,0,0,0,0.2,0.4,8,5,10,0.0789473684210526,0.09285714285714286,12
2003-05-03,West Ham,Chelsea,1,0,H,36,38,53,-9,0.3947368421052632,39,57,-18,0.25,36,64,64,28,0.4473684210526316,66,36,30,0.5,0,0,0,0,0,0,0,0,0.4,0.6,-26,-11,-37,-0.05263157894736836,-0.25,-48
2003-05-04,Arsenal,Leeds,2,3,A,35,72,87,43,0.6842105263157895,73,38,35,0.6,36,41,66,16,0.4736842105263158,52,54,-2,0.3333333333333333,0,0,0,0,0,0,0,0,0.4,0.4,31,21,27,0.21052631578947367,0.26666666666666666,37
2003-05-07,Arsenal,Southampton,6,1,H,36,72,87,43,0.6842105263157895,75,41,34,0.5833333333333334,36,49,45,-8,0.3157894736842105,41,40,1,0.3333333333333333,0,0,0,0,0,0,0,0,0.2,0.2,23,42,51,0.368421052631579,0.25000000000000006,33
2003-05-11,Birmingham,West Ham,2,2,D,37,47,-1,-1,0.0,39,47,-8,0.35135135135135137,37,41,53,-9,0.3947368421052632,40,57,-17,0.2702702702702703,0,0,0,0,1,0,0,0,0.8,0.6,6,-54,8,-0.3947368421052632,0.08108108108108109,9
2003-05-11,Bolton,Middlesboro,2,1,H,37,41,40,-18,0.2368421052631579,39,50,-11,0.24324324324324326,37,49,-1,-1,0.0,47,42,5,0.35135135135135137,0,0,0,0,0,0,0,0,0.2,0.2,-8,41,-17,0.2368421052631579,-0.10810810810810811,-16
2003-05-11,Charlton,Fulham,0,1,A,37,49,44,-11,0.2631578947368421,45,55,-10,0.3783783783783784,37,45,44,-8,0.2631578947368421,40,50,-10,0.32432432432432434,0,0,0,0,0,0,0,0,0.2,0.4,4,0,-3,0.0,0.05405405405405406,0
2003-05-11,Chelsea,Liverpool,2,1,H,37,64,64,28,0.4473684210526316,66,37,29,0.4864864864864865,37,64,80,37,0.631578947368421,60,39,21,0.4864864864864865,0,0,0,0,0,0,0,0,0.4,0.8,0,-16,-9,-0.18421052631578944,0.0,8
2003-05-11,Everton,Man United,1,2,A,37,59,43,-12,0.2894736842105263,47,47,0,0.4594594594594595,37,80,77,42,0.631578947368421,72,33,39,0.6486486486486487,0,0,0,0,1,0,0,0,0.4,0.8,-21,-34,-54,-0.3421052631578947,-0.1891891891891892,-39
2003-05-11,Leeds,Aston Villa,3,1,H,37,44,66,16,0.4736842105263158,55,56,-1,0.35135135135135137,37,45,50,-1,0.3157894736842105,41,44,-3,0.32432432432432434,0,0,0,0,0,0,0,0,0.4,0.4,-1,16,17,0.1578947368421053,0.02702702702702703,2
2003-05-11,Man City,Southampton,0,1,A,37,51,-1,-1,0.0,47,53,-6,0.40540540540540543,37,49,45,-8,0.3157894736842105,42,46,-4,0.32432432432432434,0,0,0,0,0,0,0,0,0.6,0.2,2,-46,7,-0.3157894736842105,0.08108108108108109,-2
2003-05-11,Sunderland,Arsenal,0,4,A,37,19,40,-22,0.2631578947368421,21,61,-40,0.10810810810810811,37,75,87,43,0.6842105263157895,81,42,39,0.5945945945945946,0,0,1,1,0,0,0,0,0.0,0.4,-56,-47,-65,-0.4210526315789474,-0.4864864864864865,-79
2003-05-11,Tottenham,Blackburn,0,4,A,37,50,50,-4,0.3684210526315789,51,58,-7,0.3783783783783784,37,57,46,4,0.3157894736842105,48,43,5,0.40540540540540543,0,0,0,0,0,0,0,0,0.2,0.4,-7,4,-8,0.05263157894736842,-0.02702702702702703,-12
2003-05-11,West Brom,Newcastle,2,2,D,37,25,-1,-1,0.0,27,63,-36,0.16216216216216217,37,68,71,22,0.5526315789473685,61,46,15,0.5675675675675675,0,0,0,0,0,0,0,0,0.2,0.4,-43,-72,-23,-0.5526315789473685,-0.4054054054054054,-51
