Date,HomeTeam,AwayTeam,FTHG,FTAG,FTR,HT_match_played,HT_current_standing,HT_past_standing,HT_past_goal_diff,HT_past_win_rate,HT_goal_for,HT_goal_against,HT_goal_diff,HT_win_rate_season,AT_match_played,AT_current_standing,AT_past_standing,AT_past_goal_diff,AT_past_win_rate,AT_goal_for,AT_goal_against,AT_goal_diff,AT_win_rate_season,HT_3_win_streak,HT_5_win_streak,HT_3_lose_Streak,HT_5_lose_Streak,AT_3_win_streak,AT_5_win_streak,AT_3_lose_Streak,AT_5_lose_Streak,HT_5_win_rate,AT_5_win_rate,current_standing_diff,past_standing_diff,past_goal_diff_diff,past_win_rate_diff,win_rate_season_diff,goal_diff_diff
2004-08-14,Aston Villa,Southampton,2,0,H,0,0,56,4,0.3947368421052632,0,0,0,,0,0,47,-1,0.3157894736842105,0,0,0,,0,0,0,0,0,0,0,0,,,0,9,5,0.07894736842105271,,0
2004-08-14,Blackburn,West Brom,1,1,D,0,0,44,-8,0.3157894736842105,0,0,0,,0,0,-1,-1,0.0,0,0,0,,0,0,0,0,0,0,0,0,,,0,45,-7,0.3157894736842105,,0
2004-08-14,Bolton,Charlton,4,1,H,0,0,53,-8,0.3684210526315789,0,0,0,,0,0,53,0,0.3684210526315789,0,0,0,,0,0,0,0,0,0,0,0,,,0,0,-8,0.0,,0
2004-08-14,Man City,Fulham,1,1,D,0,0,41,1,0.2368421052631579,0,0,0,,0,0,52,6,0.3684210526315789,0,0,0,,0,0,0,0,0,0,0,0,,,0,-11,-5,-0.13157894736842102,,0
2004-08-14,Middlesbrough,Newcastle,2,2,D,0,0,48,-8,0.34210526315789475,0,0,0,,0,0,56,12,0.34210526315789475,0,0,0,,0,0,0,0,0,0,0,0,,,0,-8,-20,0.0,,0
2004-08-14,Norwich,Crystal Palace,1,1,D,0,0,-1,-1,0.0,0,0,0,,0,0,-1,-1,0.0,0,0,0,,0,0,0,0,0,0,0,0,,,0,0,0,0.0,,0
2004-08-14,Portsmouth,Birmingham,1,1,D,0,0,45,-7,0.3157894736842105,0,0,0,,0,0,50,-5,0.3157894736842105,0,0,0,,0,0,0,0,0,0,0,0,,,0,-5,-2,0.0,,0
2004-08-14,Tottenham,Liverpool,1,1,D,0,0,45,-10,0.34210526315789475,0,0,0,,0,0,60,18,0.42105263157894735,0,0,0,,0,0,0,0,0,0,0,0,,,0,-15,-28,-0.0789473684210526,,0
2004-08-15,Chelsea,Man United,1,0,H,0,0,79,37,0.631578947368421,0,0,0,,0,0,75,29,0.6052631578947368,0,0,0,,0,0,0,0,0,0,0,0,,,0,4,8,0.02631578947368418,,0
2004-08-15,Everton,Arsenal,1,4,A,0,0,39,-12,0.2368421052631579,0,0,0,,0,0,90,47,0.6842105263157895,0,0,0,,0,0,0,0,0,0,0,0,,,0,-51,-59,-0.4473684210526316,,0
2004-08-21,Birmingham,Chelsea,0,1,A,1,1,50,-5,0.3157894736842105,1,1,0,0.0,1,3,79,37,0.631578947368421,1,0,1,1.0,0,0,0,0,0,0,0,0,,,-2,-29,-42,-0.3157894736842105,-1.0,-1
2004-08-21,Charlton,Portsmouth,2,1,H,1,0,53,0,0.3684210526315789,1,4,-3,0.0,1,1,45,-7,0.3157894736842105,1,1,0,0.0,0,0,0,0,0,0,0,0,,,-1,8,7,0.05263157894736842,0.0,-3
2004-08-21,Crystal Palace,Everton,1,3,A,1,1,-1,-1,0.0,1,1,0,0.0,1,0,39,-12,0.2368421052631579,1,4,-3,0.0,0,0,0,0,0,0,0,0,,,1,-40,11,-0.2368421052631579,0.0,3
2004-08-21,Fulham,Bolton,2,0,H,1,1,52,6,0.3684210526315789,1,1,0,0.0,1,3,53,-8,0.3684210526315789,4,1,3,1.0,0,0,0,0,0,0,0,0,,,-2,-1,14,0.0,-1.0,-3
2004-08-21,Liverpool,Man City,2,1,H,1,1,60,18,0.42105263157894735,1,1,0,0.0,1,1,41,1,0.2368421052631579,1,1,0,0.0,0,0,0,0,0,0,0,0,,,0,19,17,0.18421052631578944,0.0,0
2004-08-21,Man United,Norwich,2,1,H,1,0,75,29,0.6052631578947368,0,1,-1,0.0,1,1,-1,-1,0.0,1,1,0,0.0,0,0,0,0,0,0,0,0,,,-1,76,30,0.6052631578947368,0.0,-1
2004-08-21,Newcastle,Tottenham,0,1,A,1,1,56,12,0.34210526315789475,2,2,0,0.0,1,1,45,-10,0.34210526315789475,1,1,0,0.0,0,0,0,0,0,0,0,0,,,0,11,22,0.0,0.0,0
2004-08-21,Southampton,Blackburn,3,2,H,1,0,47,-1,0.3157894736842105,0,2,-2,0.0,1,1,44,-8,0.3157894736842105,1,1,0,0.0,0,0,0,0,0,0,0,0,,,-1,3,7,0.0,0.0,-2
2004-08-22,Arsenal,Middlesbrough,5,3,H,1,3,90,47,0.6842105263157895,4,1,3,1.0,1,1,48,-8,0.34210526315789475,2,2,0,0.0,0,0,0,0,0,0,0,0,,,2,42,55,0.34210526315789475,1.0,3
2004-08-22,West Brom,Aston Villa,1,1,D,1,1,-1,-1,0.0,1,1,0,0.0,1,3,56,4,0.3947368421052632,2,0,2,1.0,0,0,0,0,0,0,0,0,,,-2,-57,-5,-0.3947368421052632,-1.0,-2
2004-08-24,Birmingham,Man City,1,0,H,2,1,50,-5,0.3157894736842105,1,2,-1,0.0,2,1,41,1,0.2368421052631579,2,3,-1,0.0,0,0,0,0,0,0,0,0,,,0,9,-6,0.0789473684210526,0.0,0
2004-08-24,Crystal Palace,Chelsea,0,2,A,2,1,-1,-1,0.0,2,4,-2,0.0,2,6,79,37,0.631578947368421,2,0,2,1.0,0,0,0,0,0,0,0,0,,,-5,-80,-38,-0.631578947368421,-1.0,-4
2004-08-25,Arsenal,Blackburn,3,0,H,2,6,90,47,0.6842105263157895,9,4,5,1.0,2,1,44,-8,0.3157894736842105,3,4,-1,0.0,0,0,0,0,0,0,0,0,,,5,46,55,0.368421052631579,1.0,6
2004-08-25,Charlton,Aston Villa,3,0,H,2,3,53,0,0.3684210526315789,3,5,-2,0.5,2,4,56,4,0.3947368421052632,3,1,2,0.5,0,0,0,0,0,0,0,0,,,-1,-3,-4,-0.026315789473684292,0.0,-4
2004-08-25,Fulham,Middlesbrough,0,2,A,2,4,52,6,0.3684210526315789,3,1,2,0.5,2,1,48,-8,0.34210526315789475,5,7,-2,0.0,0,0,0,0,0,0,0,0,,,3,4,14,0.02631578947368418,0.5,4
2004-08-25,Newcastle,Norwich,2,2,D,2,1,56,12,0.34210526315789475,2,3,-1,0.0,2,1,-1,-1,0.0,2,3,-1,0.0,0,0,0,0,0,0,0,0,,,0,57,13,0.34210526315789475,0.0,0
2004-08-25,Southampton,Bolton,1,2,A,2,3,47,-1,0.3157894736842105,3,4,-1,0.5,2,3,53,-8,0.3684210526315789,4,3,1,0.5,0,0,0,0,0,0,0,0,,,0,-6,7,-0.05263157894736842,0.0,-2
2004-08-25,West Brom,Tottenham,1,1,D,2,2,-1,-1,0.0,2,2,0,0.0,2,4,45,-10,0.34210526315789475,2,1,1,0.5,0,0,0,0,0,0,0,0,,,-2,-46,9,-0.34210526315789475,-0.5,-1
2004-08-28,Aston Villa,Newcastle,4,2,H,3,4,56,4,0.3947368421052632,3,4,-1,0.3333333333333333,3,2,56,12,0.34210526315789475,4,5,-1,0.0,0,0,0,0,0,0,0,0,,,2,0,-8,0.052631578947368474,0.3333333333333333,0
2004-08-28,Blackburn,Man United,1,1,D,3,1,44,-8,0.3157894736842105,3,7,-4,0.0,2,3,75,29,0.6052631578947368,2,2,0,0.5,0,0,0,0,0,0,0,0,,,-2,-31,-37,-0.2894736842105263,-0.5,-4
2004-08-28,Chelsea,Southampton,2,1,H,3,9,79,37,0.631578947368421,4,0,4,1.0,3,3,47,-1,0.3157894736842105,4,6,-2,0.3333333333333333,0,0,0,0,0,0,0,0,,,6,32,38,0.3157894736842105,0.6666666666666667,6
2004-08-28,Everton,West Brom,2,1,H,2,3,39,-12,0.2368421052631579,4,5,-1,0.5,3,3,-1,-1,0.0,3,3,0,0.0,0,0,0,0,0,0,0,0,,,0,40,-11,0.2368421052631579,0.5,-1
2004-08-28,Man City,Charlton,4,0,H,3,1,41,1,0.2368421052631579,2,4,-2,0.0,3,6,53,0,0.3684210526315789,6,5,1,0.6666666666666666,0,0,0,0,0,0,0,0,,,-5,-12,1,-0.13157894736842102,-0.6666666666666666,-3
2004-08-28,Middlesbrough,Crystal Palace,2,1,H,3,4,48,-8,0.34210526315789475,7,7,0,0.3333333333333333,3,1,-1,-1,0.0,2,6,-4,0.0,0,0,0,0,0,0,0,0,,,3,49,-7,0.34210526315789475,0.3333333333333333,4
2004-08-28,Norwich,Arsenal,1,4,A,3,2,-1,-1,0.0,4,5,-1,0.0,3,9,90,47,0.6842105263157895,12,4,8,1.0,0,0,0,0,0,0,0,0,,,-7,-91,-48,-0.6842105263157895,-1.0,-9
2004-08-28,Tottenham,Birmingham,1,0,H,3,5,45,-10,0.34210526315789475,3,2,1,0.3333333333333333,3,4,50,-5,0.3157894736842105,2,2,0,0.3333333333333333,0,0,0,0,0,0,0,0,,,1,-5,-5,0.026315789473684237,0.0,1
2004-08-29,Bolton,Liverpool,1,0,H,3,6,53,-8,0.3684210526315789,6,4,2,0.6666666666666666,2,4,60,18,0.42105263157894735,3,2,1,0.5,0,0,0,0,0,0,0,0,,,2,-7,-26,-0.05263157894736842,0.16666666666666663,1
2004-08-30,Man United,Everton,0,0,D,3,4,75,29,0.6052631578947368,3,3,0,0.3333333333333333,3,6,39,-12,0.2368421052631579,6,6,0,0.6666666666666666,0,0,0,0,0,0,0,0,,,-2,36,41,0.3684210526315789,-0.3333333333333333,0
2004-08-30,Portsmouth,Fulham,4,3,H,2,1,45,-7,0.3157894736842105,2,3,-1,0.0,3,4,52,6,0.3684210526315789,3,3,0,0.3333333333333333,0,0,0,0,0,0,0,0,,,-3,-7,-13,-0.05263157894736842,-0.3333333333333333,-1
2004-09-11,Aston Villa,Chelsea,0,0,D,4,7,56,4,0.3947368421052632,7,6,1,0.5,4,12,79,37,0.631578947368421,6,1,5,1.0,0,0,0,0,1,0,0,0,,,-5,-23,-33,-0.2368421052631578,-0.5,-4
2004-09-11,Bolton,Man United,2,2,D,4,9,53,-8,0.3684210526315789,7,4,3,0.75,4,5,75,29,0.6052631578947368,3,3,0,0.25,0,0,0,0,0,0,0,0,,,4,-22,-37,-0.2368421052631579,0.5,3
2004-09-11,Fulham,Arsenal,0,3,A,4,4,52,6,0.3684210526315789,6,7,-1,0.25,4,12,90,47,0.6842105263157895,16,5,11,1.0,0,0,0,0,1,0,0,0,,,-8,-38,-41,-0.31578947368421056,-0.75,-12
2004-09-11,Liverpool,West Brom,3,0,H,3,4,60,18,0.42105263157894735,3,3,0,0.3333333333333333,4,3,-1,-1,0.0,4,5,-1,0.0,0,0,0,0,0,0,0,0,,,1,61,19,0.42105263157894735,0.3333333333333333,1
2004-09-11,Man City,Everton,0,1,A,4,4,41,1,0.2368421052631579,6,4,2,0.25,4,7,39,-12,0.2368421052631579,6,6,0,0.5,0,0,0,0,0,0,0,0,,,-3,2,13,0.0,-0.25,2
2004-09-11,Middlesbrough,Birmingham,2,1,H,4,7,48,-8,0.34210526315789475,9,8,1,0.5,4,4,50,-5,0.3157894736842105,2,3,-1,0.25,0,0,0,0,0,0,0,0,,,3,-2,-3,0.026315789473684237,0.25,2
2004-09-11,Newcastle,Blackburn,3,0,H,4,2,56,12,0.34210526315789475,6,9,-3,0.0,4,2,44,-8,0.3157894736842105,4,8,-4,0.0,0,0,0,0,0,0,0,0,,,0,12,20,0.026315789473684237,0.0,1
2004-09-11,Portsmouth,Crystal Palace,3,1,H,3,4,45,-7,0.3157894736842105,6,6,0,0.3333333333333333,4,1,-1,-1,0.0,3,8,-5,0.0,0,0,0,0,0,0,1,0,,,3,46,-6,0.3157894736842105,0.3333333333333333,5
2004-09-12,Tottenham,Norwich,0,0,D,4,8,45,-10,0.34210526315789475,4,2,2,0.5,4,2,-1,-1,0.0,5,9,-4,0.0,0,0,0,0,0,0,0,0,,,6,46,-9,0.34210526315789475,0.5,6
2004-09-13,Charlton,Southampton,0,0,D,4,6,53,0,0.3684210526315789,6,9,-3,0.5,4,3,47,-1,0.3157894736842105,5,8,-3,0.25,0,0,0,0,0,0,0,0,,,3,6,1,0.05263157894736842,0.25,0
2004-09-18,Arsenal,Bolton,2,2,D,5,15,90,47,0.6842105263157895,19,5,14,1.0,5,10,53,-8,0.3684210526315789,9,6,3,0.6,1,1,0,0,0,0,0,0,1.0,0.6,5,37,55,0.31578947368421056,0.4,11
2004-09-18,Birmingham,Charlton,1,1,D,5,4,50,-5,0.3157894736842105,3,5,-2,0.2,5,7,53,0,0.3684210526315789,6,9,-3,0.4,0,0,0,0,0,0,0,0,0.2,0.4,-3,-3,-5,-0.05263157894736842,-0.2,1
2004-09-18,Blackburn,Portsmouth,1,0,H,5,2,44,-8,0.3157894736842105,4,11,-7,0.0,4,7,45,-7,0.3157894736842105,9,7,2,0.5,0,0,0,0,0,0,0,0,0.0,,-5,-1,-1,0.0,-0.5,-9
2004-09-18,Crystal Palace,Man City,1,2,A,5,1,-1,-1,0.0,4,11,-7,0.0,5,4,41,1,0.2368421052631579,6,5,1,0.2,0,0,1,0,0,0,0,0,0.0,0.2,-3,-42,-2,-0.2368421052631579,-0.2,-8
2004-09-18,Norwich,Aston Villa,0,0,D,5,3,-1,-1,0.0,5,9,-4,0.0,5,8,56,4,0.3947368421052632,7,6,1,0.4,0,0,0,0,0,0,0,0,0.0,0.4,-5,-57,-5,-0.3947368421052632,-0.4,-5
2004-09-18,West Brom,Fulham,1,1,D,5,3,-1,-1,0.0,4,8,-4,0.0,5,4,52,6,0.3684210526315789,6,10,-4,0.2,0,0,0,0,0,0,1,0,0.0,0.2,-1,-53,-7,-0.3684210526315789,-0.2,0
2004-09-19,Chelsea,Tottenham,0,0,D,5,13,79,37,0.631578947368421,6,1,5,0.8,5,9,45,-10,0.34210526315789475,4,2,2,0.4,0,0,0,0,0,0,0,0,0.8,0.4,4,34,47,0.28947368421052627,0.4,3
2004-09-19,Everton,Middlesbrough,1,0,H,5,10,39,-12,0.2368421052631579,7,6,1,0.6,5,10,48,-8,0.34210526315789475,11,9,2,0.6,0,0,0,0,1,0,0,0,0.6,0.6,0,-9,-4,-0.10526315789473684,0.0,-1
2004-09-19,Southampton,Newcastle,1,2,A,5,4,47,-1,0.3157894736842105,5,8,-3,0.2,5,5,56,12,0.34210526315789475,9,9,0,0.2,0,0,0,0,0,0,0,0,0.2,0.2,-1,-9,-13,-0.026315789473684237,0.0,-3
2004-09-20,Man United,Liverpool,2,1,H,5,6,75,29,0.6052631578947368,5,5,0,0.2,4,7,60,18,0.42105263157894735,6,3,3,0.5,0,0,0,0,0,0,0,0,0.2,,-1,15,11,0.1842105263157895,-0.3,-3
2004-09-25,Aston Villa,Crystal Palace,1,1,D,6,9,56,4,0.3947368421052632,7,6,1,0.3333333333333333,6,1,-1,-1,0.0,5,13,-8,0.0,0,0,0,0,0,0,1,1,0.2,0.0,8,57,5,0.3947368421052632,0.3333333333333333,9
2004-09-25,Bolton,Birmingham,1,1,D,6,11,53,-8,0.3684210526315789,11,8,3,0.5,6,5,50,-5,0.3157894736842105,4,6,-2,0.16666666666666666,0,0,0,0,0,0,0,0,0.4,0.2,6,3,-3,0.05263157894736842,0.33333333333333337,5
2004-09-25,Fulham,Southampton,1,0,H,6,5,52,6,0.3684210526315789,7,11,-4,0.16666666666666666,6,4,47,-1,0.3157894736842105,6,10,-4,0.16666666666666666,0,0,0,0,0,0,0,0,0.2,0.2,1,5,7,0.05263157894736842,0.0,0
2004-09-25,Liverpool,Norwich,3,0,H,5,7,60,18,0.42105263157894735,7,5,2,0.4,6,4,-1,-1,0.0,5,9,-4,0.0,0,0,0,0,0,0,0,0,0.4,0.0,3,61,19,0.42105263157894735,0.4,6
2004-09-25,Man City,Arsenal,0,1,A,6,7,41,1,0.2368421052631579,8,6,2,0.3333333333333333,6,16,90,47,0.6842105263157895,21,7,14,0.8333333333333334,0,0,0,0,0,0,0,0,0.4,0.8,-9,-49,-46,-0.4473684210526316,-0.5,-12
2004-09-25,Middlesbrough,Chelsea,0,1,A,6,10,48,-8,0.34210526315789475,11,10,1,0.5,6,14,79,37,0.631578947368421,6,1,5,0.6666666666666666,0,0,0,0,0,0,0,0,0.6,0.6,-4,-31,-45,-0.28947368421052627,-0.16666666666666663,-4
2004-09-25,Newcastle,West Brom,3,1,H,6,8,56,12,0.34210526315789475,11,10,1,0.3333333333333333,6,4,-1,-1,0.0,5,9,-4,0.0,0,0,0,0,0,0,0,0,0.4,0.0,4,57,13,0.34210526315789475,0.3333333333333333,5
2004-09-25,Tottenham,Man United,0,1,A,6,10,45,-10,0.34210526315789475,4,2,2,0.3333333333333333,6,9,75,29,0.6052631578947368,7,6,1,0.3333333333333333,0,0,0,0,0,0,0,0,0.4,0.4,1,-30,-39,-0.2631578947368421,0.0,1
2004-09-26,Portsmouth,Everton,0,1,A,5,7,45,-7,0.3157894736842105,9,8,1,0.4,6,13,39,-12,0.2368421052631579,8,6,2,0.6666666666666666,0,0,0,0,0,0,0,0,0.4,0.8,-6,6,5,0.0789473684210526,-0.2666666666666666,-1
2004-09-27,Charlton,Blackburn,1,0,H,6,8,53,0,0.3684210526315789,7,10,-3,0.3333333333333333,6,5,44,-8,0.3157894736842105,5,11,-6,0.16666666666666666,0,0,0,0,0,0,0,0,0.4,0.2,3,9,8,0.05263157894736842,0.16666666666666666,3
2004-10-02,Arsenal,Charlton,4,0,H,7,19,90,47,0.6842105263157895,22,7,15,0.8571428571428571,7,11,53,0,0.3684210526315789,8,10,-2,0.42857142857142855,0,0,0,0,0,0,0,0,0.8,0.4,8,37,47,0.31578947368421056,0.42857142857142855,17
2004-10-02,Blackburn,Aston Villa,2,2,D,7,5,44,-8,0.3157894736842105,5,12,-7,0.14285714285714285,7,10,56,4,0.3947368421052632,8,7,1,0.2857142857142857,0,0,0,0,0,0,0,0,0.2,0.2,-5,-12,-12,-0.07894736842105271,-0.14285714285714285,-8
2004-10-02,Everton,Tottenham,0,1,A,7,16,39,-12,0.2368421052631579,9,6,3,0.7142857142857143,7,10,45,-10,0.34210526315789475,4,3,1,0.2857142857142857,1,0,0,0,0,0,0,0,0.8,0.2,6,-6,-2,-0.10526315789473684,0.4285714285714286,2
2004-10-02,Norwich,Portsmouth,2,2,D,7,4,-1,-1,0.0,5,12,-7,0.0,6,7,45,-7,0.3157894736842105,9,9,0,0.3333333333333333,0,0,0,0,0,0,0,0,0.0,0.4,-3,-46,6,-0.3157894736842105,-0.3333333333333333,-7
2004-10-02,Southampton,Man City,0,0,D,7,4,47,-1,0.3157894736842105,6,11,-5,0.14285714285714285,7,7,41,1,0.2368421052631579,8,7,1,0.2857142857142857,0,0,0,0,0,0,0,0,0.0,0.4,-3,6,-2,0.0789473684210526,-0.14285714285714285,-6
2004-10-02,West Brom,Bolton,2,1,H,7,4,-1,-1,0.0,6,12,-6,0.0,7,12,53,-8,0.3684210526315789,12,9,3,0.42857142857142855,0,0,0,0,0,0,0,0,0.0,0.4,-8,-54,7,-0.3684210526315789,-0.42857142857142855,-9
2004-10-03,Birmingham,Newcastle,2,2,D,7,6,50,-5,0.3157894736842105,5,7,-2,0.14285714285714285,7,11,56,12,0.34210526315789475,14,11,3,0.42857142857142855,0,0,0,0,1,0,0,0,0.2,0.6,-5,-6,-17,-0.026315789473684237,-0.2857142857142857,-5
2004-10-03,Chelsea,Liverpool,1,0,H,7,17,79,37,0.631578947368421,7,1,6,0.7142857142857143,6,10,60,18,0.42105263157894735,10,5,5,0.5,0,0,0,0,0,0,0,0,0.6,0.6,7,19,19,0.21052631578947367,0.2142857142857143,1
2004-10-03,Man United,Middlesbrough,1,1,D,7,12,75,29,0.6052631578947368,8,6,2,0.42857142857142855,7,10,48,-8,0.34210526315789475,11,11,0,0.42857142857142855,0,0,0,0,0,0,0,0,0.4,0.6,2,27,37,0.2631578947368421,0.0,2
2004-10-04,Crystal Palace,Fulham,2,0,H,7,2,-1,-1,0.0,6,14,-8,0.0,7,8,52,6,0.3684210526315789,8,11,-3,0.2857142857142857,0,0,0,0,0,0,0,0,0.0,0.2,-6,-53,-7,-0.3684210526315789,-0.2857142857142857,-5
2004-10-16,Arsenal,Aston Villa,3,1,H,8,22,90,47,0.6842105263157895,26,7,19,0.875,8,11,56,4,0.3947368421052632,10,9,1,0.25,0,0,0,0,0,0,0,0,0.8,0.2,11,34,43,0.28947368421052627,0.625,18
2004-10-16,Birmingham,Man United,0,0,D,8,7,50,-5,0.3157894736842105,7,9,-2,0.125,8,13,75,29,0.6052631578947368,9,7,2,0.375,0,0,0,0,0,0,0,0,0.0,0.4,-6,-25,-34,-0.2894736842105263,-0.25,-4
2004-10-16,Blackburn,Middlesbrough,0,4,A,8,6,44,-8,0.3157894736842105,7,14,-7,0.125,8,11,48,-8,0.34210526315789475,12,12,0,0.375,0,0,0,0,0,0,0,0,0.2,0.4,-5,-4,0,-0.026315789473684237,-0.25,-7
2004-10-16,Bolton,Crystal Palace,1,0,H,8,12,53,-8,0.3684210526315789,13,11,2,0.375,8,5,-1,-1,0.0,8,14,-6,0.125,0,0,0,0,0,0,0,0,0.2,0.2,7,54,-7,0.3684210526315789,0.25,8
2004-10-16,Everton,Southampton,1,0,H,8,16,39,-12,0.2368421052631579,9,7,2,0.625,8,5,47,-1,0.3157894736842105,6,11,-5,0.125,0,0,0,0,0,0,0,0,0.6,0.0,11,-8,-11,-0.0789473684210526,0.5,7
2004-10-16,Fulham,Liverpool,2,4,A,8,8,52,6,0.3684210526315789,8,13,-5,0.25,7,10,60,18,0.42105263157894735,10,6,4,0.42857142857142855,0,0,0,0,0,0,0,0,0.2,0.4,-2,-8,-12,-0.05263157894736842,-0.17857142857142855,-9
2004-10-16,Man City,Chelsea,1,0,H,8,8,41,1,0.2368421052631579,8,7,1,0.25,8,20,79,37,0.631578947368421,8,1,7,0.75,0,0,0,0,0,0,0,0,0.4,0.6,-12,-38,-36,-0.3947368421052631,-0.5,-6
2004-10-16,West Brom,Norwich,0,0,D,8,7,-1,-1,0.0,8,13,-5,0.125,8,5,-1,-1,0.0,7,14,-7,0.0,0,0,0,0,0,0,0,0,0.2,0.0,2,0,0,0.0,0.125,2
2004-10-17,Charlton,Newcastle,1,1,D,8,11,53,0,0.3684210526315789,8,14,-6,0.375,8,12,56,12,0.34210526315789475,16,13,3,0.375,0,0,0,0,0,0,0,0,0.2,0.6,-1,-3,-12,0.02631578947368418,0.0,-9
2004-10-18,Portsmouth,Tottenham,1,0,H,7,8,45,-7,0.3157894736842105,11,11,0,0.2857142857142857,8,13,45,-10,0.34210526315789475,5,3,2,0.375,0,0,0,0,0,0,0,0,0.4,0.4,-5,0,3,-0.026315789473684237,-0.0892857142857143,-2
2004-10-23,Aston Villa,Fulham,2,0,H,9,11,56,4,0.3947368421052632,11,12,-1,0.2222222222222222,9,8,52,6,0.3684210526315789,10,17,-7,0.2222222222222222,0,0,0,0,0,0,0,0,0.0,0.2,3,4,-2,0.026315789473684292,0.0,6
2004-10-23,Chelsea,Blackburn,4,0,H,9,20,79,37,0.631578947368421,8,2,6,0.6666666666666666,9,6,44,-8,0.3157894736842105,7,18,-11,0.1111111111111111,0,0,0,0,0,0,0,0,0.4,0.2,14,35,45,0.3157894736842105,0.5555555555555556,17
2004-10-23,Crystal Palace,West Brom,3,0,H,9,5,-1,-1,0.0,8,15,-7,0.1111111111111111,9,8,-1,-1,0.0,8,13,-5,0.1111111111111111,0,0,0,0,0,0,0,0,0.2,0.2,-3,0,0,0.0,0.0,-2
2004-10-23,Liverpool,Charlton,2,0,H,8,13,60,18,0.42105263157894735,14,8,6,0.5,9,12,53,0,0.3684210526315789,9,15,-6,0.3333333333333333,0,0,0,0,0,0,0,0,0.6,0.2,1,7,18,0.05263157894736842,0.16666666666666669,12
2004-10-23,Norwich,Everton,2,3,A,9,6,-1,-1,0.0,7,14,-7,0.0,9,19,39,-12,0.2368421052631579,10,7,3,0.6666666666666666,0,0,0,0,0,0,0,0,0.0,0.8,-13,-40,11,-0.2368421052631579,-0.6666666666666666,-10
2004-10-23,Tottenham,Bolton,1,2,A,9,13,45,-10,0.34210526315789475,5,4,1,0.3333333333333333,9,15,53,-8,0.3684210526315789,14,11,3,0.4444444444444444,0,0,0,0,0,0,0,0,0.2,0.2,-2,-8,-2,-0.02631578947368418,-0.1111111111111111,-2
2004-10-24,Man United,Arsenal,2,0,H,9,14,75,29,0.6052631578947368,9,7,2,0.3333333333333333,9,25,90,47,0.6842105263157895,29,8,21,0.8888888888888888,0,0,0,0,1,0,0,0,0.4,0.8,-11,-15,-18,-0.07894736842105265,-0.5555555555555556,-19
2004-10-24,Middlesbrough,Portsmouth,1,1,D,9,14,48,-8,0.34210526315789475,16,12,4,0.4444444444444444,8,11,45,-7,0.3157894736842105,12,11,1,0.375,0,0,0,0,0,0,0,0,0.4,0.4,3,3,-1,0.026315789473684237,0.06944444444444442,3
2004-10-24,Newcastle,Man City,4,3,H,9,13,56,12,0.34210526315789475,17,14,3,0.3333333333333333,9,11,41,1,0.2368421052631579,9,7,2,0.3333333333333333,0,0,0,0,0,0,0,0,0.6,0.4,2,15,11,0.10526315789473684,0.0,1
2004-10-24,Southampton,Birmingham,0,0,D,9,5,47,-1,0.3157894736842105,6,12,-6,0.1111111111111111,9,8,50,-5,0.3157894736842105,7,9,-2,0.1111111111111111,0,0,0,0,0,0,0,0,0.0,0.0,-3,-3,4,0.0,0.0,-4
2004-10-30,Arsenal,Southampton,2,2,D,10,25,90,47,0.6842105263157895,29,10,19,0.8,10,6,47,-1,0.3157894736842105,6,12,-6,0.1,0,0,0,0,0,0,0,0,0.6,0.0,19,43,48,0.368421052631579,0.7000000000000001,25
2004-10-30,Birmingham,Crystal Palace,0,1,A,10,9,50,-5,0.3157894736842105,7,9,-2,0.1,10,8,-1,-1,0.0,11,15,-4,0.2,0,0,0,0,0,0,0,0,0.0,0.4,1,51,-4,0.3157894736842105,-0.1,2
2004-10-30,Blackburn,Liverpool,2,2,D,10,6,44,-8,0.3157894736842105,7,22,-15,0.1,9,16,60,18,0.42105263157894735,16,8,8,0.5555555555555556,0,0,0,0,0,0,0,0,0.2,0.6,-10,-16,-26,-0.10526315789473684,-0.4555555555555556,-23
2004-10-30,Charlton,Middlesbrough,1,2,A,10,12,53,0,0.3684210526315789,9,17,-8,0.3,10,15,48,-8,0.34210526315789475,17,13,4,0.4,0,0,0,0,0,0,0,0,0.2,0.2,-3,5,8,0.02631578947368418,-0.10000000000000003,-12
2004-10-30,Everton,Aston Villa,1,1,D,10,22,39,-12,0.2368421052631579,13,9,4,0.7,10,14,56,4,0.3947368421052632,13,12,1,0.3,0,0,0,0,0,0,0,0,0.8,0.2,8,-17,-16,-0.1578947368421053,0.39999999999999997,3
2004-10-30,Fulham,Tottenham,2,0,H,10,8,52,6,0.3684210526315789,10,19,-9,0.2,10,13,45,-10,0.34210526315789475,6,6,0,0.3,0,0,1,0,0,0,0,0,0.2,0.2,-5,7,16,0.02631578947368418,-0.09999999999999998,-9
2004-10-30,Portsmouth,Man United,2,0,H,9,12,45,-7,0.3157894736842105,13,12,1,0.3333333333333333,10,17,75,29,0.6052631578947368,11,7,4,0.4,0,0,0,0,0,0,0,0,0.2,0.6,-5,-30,-36,-0.2894736842105263,-0.06666666666666671,-3
2004-10-30,West Brom,Chelsea,1,4,A,10,8,-1,-1,0.0,8,16,-8,0.1,10,23,79,37,0.631578947368421,12,2,10,0.7,0,0,0,0,0,0,0,0,0.2,0.6,-15,-80,-38,-0.631578947368421,-0.6,-18
2004-10-31,Bolton,Newcastle,2,1,H,10,18,53,-8,0.3684210526315789,16,12,4,0.5,10,16,56,12,0.34210526315789475,21,17,4,0.4,0,0,0,0,0,0,0,0,0.4,0.6,2,-3,-20,0.02631578947368418,0.09999999999999998,0
2004-11-01,Man City,Norwich,1,1,D,10,11,41,1,0.2368421052631579,12,11,1,0.3,10,6,-1,-1,0.0,9,17,-8,0.0,0,0,0,0,0,0,0,0,0.4,0.0,5,42,2,0.2368421052631579,0.3,9
2004-11-06,Aston Villa,Portsmouth,3,0,H,11,15,56,4,0.3947368421052632,14,13,1,0.2727272727272727,10,15,45,-7,0.3157894736842105,15,12,3,0.4,0,0,0,0,0,0,0,0,0.2,0.4,0,11,11,0.07894736842105271,-0.12727272727272732,-2
2004-11-06,Chelsea,Everton,1,0,H,11,26,79,37,0.631578947368421,16,3,13,0.7272727272727273,11,23,39,-12,0.2368421052631579,14,10,4,0.6363636363636364,0,0,0,0,0,0,0,0,0.8,0.6,3,40,49,0.3947368421052631,0.09090909090909094,9
2004-11-06,Crystal Palace,Arsenal,1,1,D,11,11,-1,-1,0.0,12,15,-3,0.2727272727272727,11,26,90,47,0.6842105263157895,31,12,19,0.7272727272727273,0,0,0,0,0,0,0,0,0.6,0.6,-15,-91,-48,-0.6842105263157895,-0.4545454545454546,-22
2004-11-06,Liverpool,Birmingham,0,1,A,10,17,60,18,0.42105263157894735,18,10,8,0.5,11,9,50,-5,0.3157894736842105,7,10,-3,0.09090909090909091,0,0,0,0,0,0,0,0,0.6,0.0,8,10,23,0.10526315789473684,0.40909090909090906,11
2004-11-06,Norwich,Blackburn,1,1,D,11,7,-1,-1,0.0,10,18,-8,0.0,11,7,44,-8,0.3157894736842105,9,24,-15,0.09090909090909091,0,0,0,0,0,0,0,0,0.0,0.0,0,-45,7,-0.3157894736842105,-0.09090909090909091,7
2004-11-06,Southampton,West Brom,2,2,D,11,7,47,-1,0.3157894736842105,8,14,-6,0.09090909090909091,11,8,-1,-1,0.0,9,20,-11,0.09090909090909091,0,0,0,0,0,0,0,0,0.0,0.2,-1,48,0,0.3157894736842105,0.0,5
2004-11-06,Tottenham,Charlton,2,3,A,11,13,45,-10,0.34210526315789475,6,8,-2,0.2727272727272727,11,12,53,0,0.3684210526315789,10,19,-9,0.2727272727272727,0,0,1,0,0,0,0,0,0.2,0.2,1,-8,-10,-0.02631578947368418,0.0,7
2004-11-07,Man United,Man City,0,0,D,11,17,75,29,0.6052631578947368,11,9,2,0.36363636363636365,11,12,41,1,0.2368421052631579,13,12,1,0.2727272727272727,0,0,0,0,0,0,0,0,0.4,0.2,5,34,28,0.3684210526315789,0.09090909090909094,1
2004-11-07,Middlesbrough,Bolton,1,1,D,11,18,48,-8,0.34210526315789475,19,14,5,0.45454545454545453,11,21,53,-8,0.3684210526315789,18,13,5,0.5454545454545454,0,0,0,0,1,0,0,0,0.4,0.6,-3,-5,0,-0.02631578947368418,-0.09090909090909088,0
2004-11-07,Newcastle,Fulham,1,4,A,11,16,56,12,0.34210526315789475,22,19,3,0.36363636363636365,11,11,52,6,0.3684210526315789,12,19,-7,0.2727272727272727,0,0,0,0,0,0,0,0,0.4,0.4,5,4,6,-0.02631578947368418,0.09090909090909094,10
2004-11-13,Birmingham,Everton,0,1,A,12,12,50,-5,0.3157894736842105,8,10,-2,0.16666666666666666,12,23,39,-12,0.2368421052631579,14,11,3,0.5833333333333334,0,0,0,0,0,0,0,0,0.2,0.4,-11,11,7,0.0789473684210526,-0.41666666666666674,-5
2004-11-13,Bolton,Aston Villa,1,2,A,12,22,53,-8,0.3684210526315789,19,14,5,0.5,12,18,56,4,0.3947368421052632,17,13,4,0.3333333333333333,0,0,0,0,0,0,0,0,0.6,0.4,4,-3,-12,-0.026315789473684292,0.16666666666666669,1
2004-11-13,Charlton,Norwich,4,0,H,12,15,53,0,0.3684210526315789,13,21,-8,0.3333333333333333,12,8,-1,-1,0.0,11,19,-8,0.0,0,0,0,0,0,0,0,0,0.2,0.0,7,54,1,0.3684210526315789,0.3333333333333333,0
2004-11-13,Fulham,Chelsea,1,4,A,12,14,52,6,0.3684210526315789,16,20,-4,0.3333333333333333,12,29,79,37,0.631578947368421,17,3,14,0.75,0,0,0,0,1,0,0,0,0.4,0.8,-15,-27,-31,-0.2631578947368421,-0.4166666666666667,-18
2004-11-13,Liverpool,Crystal Palace,3,2,H,11,17,60,18,0.42105263157894735,18,11,7,0.45454545454545453,12,12,-1,-1,0.0,13,16,-3,0.25,0,0,0,0,0,0,0,0,0.4,0.6,5,61,19,0.42105263157894735,0.20454545454545453,10
2004-11-13,Man City,Blackburn,1,1,D,12,13,41,1,0.2368421052631579,13,12,1,0.25,12,8,44,-8,0.3157894736842105,10,25,-15,0.08333333333333333,0,0,0,0,0,0,0,0,0.2,0.0,5,-3,9,-0.0789473684210526,0.16666666666666669,16
2004-11-13,Southampton,Portsmouth,2,1,H,12,8,47,-1,0.3157894736842105,10,16,-6,0.08333333333333333,11,15,45,-7,0.3157894736842105,15,15,0,0.36363636363636365,0,0,0,0,0,0,0,0,0.0,0.4,-7,2,6,0.0,-0.28030303030303033,-6
2004-11-13,Tottenham,Arsenal,4,5,A,12,13,45,-10,0.34210526315789475,8,11,-3,0.25,12,27,90,47,0.6842105263157895,32,13,19,0.6666666666666666,0,0,1,0,0,0,0,0,0.2,0.4,-14,-45,-57,-0.34210526315789475,-0.41666666666666663,-22
2004-11-14,Newcastle,Man United,1,3,A,12,16,56,12,0.34210526315789475,23,23,0,0.3333333333333333,12,18,75,29,0.6052631578947368,11,9,2,0.3333333333333333,0,0,0,0,0,0,0,0,0.2,0.2,-2,-19,-17,-0.2631578947368421,0.0,-2
2004-11-14,West Brom,Middlesbrough,1,2,A,12,9,-1,-1,0.0,11,22,-11,0.08333333333333333,12,19,48,-8,0.34210526315789475,20,15,5,0.4166666666666667,0,0,0,0,0,0,0,0,0.2,0.4,-10,-49,7,-0.34210526315789475,-0.33333333333333337,-16
2004-11-20,Arsenal,West Brom,1,1,D,13,30,90,47,0.6842105263157895,37,17,20,0.6923076923076923,13,9,-1,-1,0.0,12,24,-12,0.07692307692307693,0,0,0,0,0,0,0,0,0.4,0.0,21,91,48,0.6842105263157895,0.6153846153846154,32
2004-11-20,Chelsea,Bolton,2,2,D,13,32,79,37,0.631578947368421,21,4,17,0.7692307692307693,13,22,53,-8,0.3684210526315789,20,16,4,0.46153846153846156,1,0,0,0,0,0,0,0,0.8,0.6,10,26,45,0.2631578947368421,0.3076923076923077,13
2004-11-20,Crystal Palace,Newcastle,0,2,A,13,12,-1,-1,0.0,15,19,-4,0.23076923076923078,13,16,56,12,0.34210526315789475,24,26,-2,0.3076923076923077,0,0,0,0,0,0,1,0,0.4,0.2,-4,-57,-13,-0.34210526315789475,-0.07692307692307693,-2
2004-11-20,Everton,Fulham,1,0,H,13,26,39,-12,0.2368421052631579,15,11,4,0.6153846153846154,13,14,52,6,0.3684210526315789,17,24,-7,0.3076923076923077,0,0,0,0,0,0,0,0,0.6,0.4,12,-13,-18,-0.13157894736842102,0.3076923076923077,11
2004-11-20,Man United,Charlton,2,0,H,13,21,75,29,0.6052631578947368,14,10,4,0.38461538461538464,13,18,53,0,0.3684210526315789,17,21,-4,0.38461538461538464,0,0,0,0,0,0,0,0,0.4,0.4,3,22,29,0.2368421052631579,0.0,8
2004-11-20,Middlesbrough,Liverpool,2,0,H,13,22,48,-8,0.34210526315789475,22,16,6,0.46153846153846156,12,20,60,18,0.42105263157894735,21,13,8,0.5,0,0,0,0,0,0,0,0,0.6,0.6,2,-12,-26,-0.0789473684210526,-0.038461538461538436,-2
2004-11-20,Norwich,Southampton,2,1,H,13,8,-1,-1,0.0,11,23,-12,0.0,13,11,47,-1,0.3157894736842105,12,17,-5,0.15384615384615385,0,0,0,0,0,0,0,0,0.0,0.2,-3,-48,0,-0.3157894736842105,-0.15384615384615385,-7
2004-11-20,Portsmouth,Man City,1,3,A,12,15,45,-7,0.3157894736842105,16,17,-1,0.3333333333333333,13,14,41,1,0.2368421052631579,14,13,1,0.23076923076923078,0,0,0,0,0,0,0,0,0.4,0.2,1,4,-8,0.0789473684210526,0.10256410256410253,-2
2004-11-21,Blackburn,Birmingham,3,3,D,13,9,44,-8,0.3157894736842105,11,26,-15,0.07692307692307693,13,12,50,-5,0.3157894736842105,8,11,-3,0.15384615384615385,0,0,0,0,0,0,0,0,0.0,0.2,-3,-6,-3,0.0,-0.07692307692307693,-12
2004-11-22,Aston Villa,Tottenham,1,0,H,13,21,56,4,0.3947368421052632,19,14,5,0.38461538461538464,13,13,45,-10,0.34210526315789475,12,16,-4,0.23076923076923078,0,0,0,0,0,0,1,1,0.6,0.0,8,11,14,0.052631578947368474,0.15384615384615385,9
2004-11-27,Birmingham,Norwich,1,1,D,14,13,50,-5,0.3157894736842105,11,14,-3,0.14285714285714285,14,11,-1,-1,0.0,13,24,-11,0.07142857142857142,0,0,0,0,0,0,0,0,0.2,0.2,2,51,-4,0.3157894736842105,0.07142857142857142,8
2004-11-27,Bolton,Portsmouth,0,1,A,14,23,53,-8,0.3684210526315789,22,18,4,0.42857142857142855,13,15,45,-7,0.3157894736842105,17,20,-3,0.3076923076923077,0,0,0,0,0,0,1,0,0.4,0.2,8,8,-1,0.05263157894736842,0.12087912087912084,7
2004-11-27,Charlton,Chelsea,0,4,A,14,18,53,0,0.3684210526315789,17,23,-6,0.35714285714285715,14,33,79,37,0.631578947368421,23,6,17,0.7142857142857143,0,0,0,0,0,0,0,0,0.4,0.8,-15,-26,-37,-0.2631578947368421,-0.35714285714285715,-23
2004-11-27,Fulham,Blackburn,0,2,A,14,14,52,6,0.3684210526315789,17,25,-8,0.2857142857142857,14,10,44,-8,0.3157894736842105,14,29,-15,0.07142857142857142,0,0,0,0,0,0,0,0,0.4,0.0,4,8,14,0.05263157894736842,0.21428571428571427,7
2004-11-27,Man City,Aston Villa,2,0,H,14,17,41,1,0.2368421052631579,17,14,3,0.2857142857142857,14,24,56,4,0.3947368421052632,20,14,6,0.42857142857142855,0,0,0,0,1,0,0,0,0.2,0.8,-7,-15,-3,-0.1578947368421053,-0.14285714285714285,-3
2004-11-27,Southampton,Crystal Palace,2,2,D,14,11,47,-1,0.3157894736842105,13,19,-6,0.14285714285714285,14,12,-1,-1,0.0,15,21,-6,0.21428571428571427,0,0,0,0,0,0,0,0,0.2,0.4,-1,48,0,0.3157894736842105,-0.07142857142857142,0
2004-11-27,West Brom,Man United,0,3,A,14,10,-1,-1,0.0,13,25,-12,0.07142857142857142,14,24,75,29,0.6052631578947368,16,10,6,0.42857142857142855,0,0,0,0,0,0,0,0,0.0,0.6,-14,-76,-30,-0.6052631578947368,-0.3571428571428571,-18
2004-11-28,Liverpool,Arsenal,2,1,H,13,20,60,18,0.42105263157894735,21,15,6,0.46153846153846156,14,31,90,47,0.6842105263157895,38,18,20,0.6428571428571429,0,0,0,0,0,0,0,0,0.4,0.2,-11,-30,-29,-0.26315789473684215,-0.18131868131868134,-14
2004-11-28,Newcastle,Everton,1,1,D,14,19,56,12,0.34210526315789475,26,26,0,0.35714285714285715,14,29,39,-12,0.2368421052631579,16,11,5,0.6428571428571429,0,0,0,0,0,0,0,0,0.4,0.6,-10,17,24,0.10526315789473684,-0.28571428571428575,-5
2004-11-28,Tottenham,Middlesbrough,2,0,H,14,13,45,-10,0.34210526315789475,12,17,-5,0.21428571428571427,14,25,48,-8,0.34210526315789475,24,16,8,0.5,0,0,1,1,0,0,0,0,0.0,0.6,-12,-3,-2,0.0,-0.2857142857142857,-13
2004-12-04,Arsenal,Birmingham,3,0,H,15,31,90,47,0.6842105263157895,39,20,19,0.6,15,14,50,-5,0.3157894736842105,12,15,-3,0.13333333333333333,0,0,0,0,0,0,0,0,0.2,0.2,17,40,52,0.368421052631579,0.4666666666666667,22
2004-12-04,Aston Villa,Liverpool,1,1,D,15,24,56,4,0.3947368421052632,20,16,4,0.4,14,23,60,18,0.42105263157894735,23,16,7,0.5,0,0,0,0,0,0,0,0,0.6,0.4,1,-4,-14,-0.026315789473684126,-0.09999999999999998,-3
2004-12-04,Blackburn,Tottenham,0,1,A,15,13,44,-8,0.3157894736842105,16,29,-13,0.13333333333333333,15,16,45,-10,0.34210526315789475,14,17,-3,0.26666666666666666,0,0,0,0,0,0,0,0,0.2,0.2,-3,-1,2,-0.026315789473684237,-0.13333333333333333,-10
2004-12-04,Chelsea,Newcastle,4,0,H,15,36,79,37,0.631578947368421,27,6,21,0.7333333333333333,15,20,56,12,0.34210526315789475,27,27,0,0.3333333333333333,0,0,0,0,0,0,0,0,0.8,0.2,16,23,25,0.28947368421052627,0.39999999999999997,21
2004-12-04,Everton,Bolton,3,2,H,15,30,39,-12,0.2368421052631579,17,12,5,0.6,15,23,53,-8,0.3684210526315789,22,19,3,0.4,0,0,0,0,0,0,0,0,0.4,0.2,7,-14,-4,-0.13157894736842102,0.19999999999999996,2
2004-12-04,Man United,Southampton,3,0,H,15,27,75,29,0.6052631578947368,19,10,9,0.4666666666666667,15,12,47,-1,0.3157894736842105,15,21,-6,0.13333333333333333,1,0,0,0,0,0,0,0,0.6,0.2,15,28,30,0.2894736842105263,0.33333333333333337,15
2004-12-04,Norwich,Fulham,0,1,A,15,12,-1,-1,0.0,14,25,-11,0.06666666666666667,15,14,52,6,0.3684210526315789,17,27,-10,0.26666666666666666,0,0,0,0,0,0,1,0,0.2,0.4,-2,-53,-7,-0.3684210526315789,-0.2,-1
2004-12-04,Portsmouth,West Brom,3,2,H,14,18,45,-7,0.3157894736842105,18,20,-2,0.35714285714285715,15,10,-1,-1,0.0,13,28,-15,0.06666666666666667,0,0,0,0,0,0,0,0,0.4,0.0,8,46,-6,0.3157894736842105,0.2904761904761905,13
2004-12-05,Crystal Palace,Charlton,0,1,A,15,13,-1,-1,0.0,17,23,-6,0.2,15,18,53,0,0.3684210526315789,17,27,-10,0.3333333333333333,0,0,0,0,0,0,0,0,0.2,0.4,-5,-54,-1,-0.3684210526315789,-0.1333333333333333,4
2004-12-06,Middlesbrough,Man City,3,2,H,15,25,48,-8,0.34210526315789475,24,18,6,0.4666666666666667,15,20,41,1,0.2368421052631579,19,14,5,0.3333333333333333,0,0,0,0,0,0,0,0,0.6,0.4,5,7,-9,0.10526315789473684,0.13333333333333336,1
2004-12-11,Crystal Palace,Blackburn,0,0,D,16,13,-1,-1,0.0,17,24,-7,0.1875,16,13,44,-8,0.3157894736842105,16,30,-14,0.125,0,0,0,0,0,0,0,0,0.0,0.2,0,-45,7,-0.3157894736842105,0.0625,7
2004-12-11,Everton,Liverpool,1,0,H,16,33,39,-12,0.2368421052631579,20,14,6,0.625,15,24,60,18,0.42105263157894735,24,17,7,0.4666666666666667,0,0,0,0,0,0,0,0,0.6,0.4,9,-21,-30,-0.18421052631578944,0.15833333333333333,-1
2004-12-11,Man City,Tottenham,0,1,A,16,20,41,1,0.2368421052631579,21,17,4,0.3125,16,19,45,-10,0.34210526315789475,15,17,-2,0.3125,0,0,0,0,0,0,0,0,0.4,0.4,1,-4,11,-0.10526315789473684,0.0,6
2004-12-11,Newcastle,Portsmouth,1,1,D,16,20,56,12,0.34210526315789475,27,31,-4,0.3125,15,21,45,-7,0.3157894736842105,21,22,-1,0.4,0,0,0,0,0,0,0,0,0.2,0.4,-1,11,19,0.026315789473684237,-0.08750000000000002,-3
2004-12-11,Norwich,Bolton,3,2,H,16,12,-1,-1,0.0,14,26,-12,0.0625,16,23,53,-8,0.3684210526315789,24,22,2,0.375,0,0,0,0,0,0,0,0,0.2,0.0,-11,-54,7,-0.3684210526315789,-0.3125,-14
2004-12-11,Southampton,Middlesbrough,2,2,D,16,12,47,-1,0.3157894736842105,15,24,-9,0.125,16,28,48,-8,0.34210526315789475,27,20,7,0.5,0,0,0,0,0,0,0,0,0.2,0.6,-16,-1,7,-0.026315789473684237,-0.375,-16
2004-12-11,West Brom,Charlton,0,1,A,16,10,-1,-1,0.0,15,31,-16,0.0625,16,21,53,0,0.3684210526315789,18,27,-9,0.375,0,0,0,0,0,0,0,0,0.0,0.6,-11,-54,-1,-0.3684210526315789,-0.3125,-7
2004-12-12,Arsenal,Chelsea,2,2,D,16,34,90,47,0.6842105263157895,42,20,22,0.625,16,39,79,37,0.631578947368421,31,6,25,0.75,0,0,0,0,0,0,0,0,0.4,0.8,-5,11,10,0.052631578947368474,-0.125,-3
2004-12-12,Aston Villa,Birmingham,1,2,A,16,25,56,4,0.3947368421052632,21,17,4,0.375,16,14,50,-5,0.3157894736842105,12,18,-6,0.125,0,0,0,0,0,0,0,0,0.6,0.2,11,6,9,0.07894736842105271,0.25,10
2004-12-13,Fulham,Man United,1,1,D,16,17,52,6,0.3684210526315789,18,27,-9,0.3125,16,30,75,29,0.6052631578947368,22,10,12,0.5,0,0,0,0,1,0,0,0,0.4,0.8,-13,-23,-23,-0.2368421052631579,-0.1875,-21
2004-12-14,Liverpool,Portsmouth,1,1,D,16,24,60,18,0.42105263157894735,24,18,6,0.4375,16,22,45,-7,0.3157894736842105,22,23,-1,0.375,0,0,0,0,0,0,0,0,0.4,0.4,2,15,25,0.10526315789473684,0.0625,7
2004-12-18,Birmingham,West Brom,4,0,H,17,17,50,-5,0.3157894736842105,14,19,-5,0.17647058823529413,17,10,-1,-1,0.0,15,32,-17,0.058823529411764705,0,0,0,0,0,0,1,0,0.2,0.0,7,51,-4,0.3157894736842105,0.11764705882352942,12
2004-12-18,Blackburn,Everton,0,0,D,17,14,44,-8,0.3157894736842105,16,30,-14,0.11764705882352941,17,36,39,-12,0.2368421052631579,21,14,7,0.6470588235294118,0,0,0,0,0,0,0,0,0.2,0.8,-22,5,4,0.0789473684210526,-0.5294117647058824,-21
2004-12-18,Bolton,Man City,0,1,A,17,23,53,-8,0.3684210526315789,26,25,1,0.35294117647058826,17,20,41,1,0.2368421052631579,21,18,3,0.29411764705882354,0,0,1,0,0,0,0,0,0.0,0.4,3,12,-9,0.13157894736842102,0.05882352941176472,-2
2004-12-18,Chelsea,Norwich,4,0,H,17,40,79,37,0.631578947368421,33,8,25,0.7058823529411765,17,15,-1,-1,0.0,17,28,-11,0.11764705882352941,0,0,0,0,0,0,0,0,0.6,0.4,25,80,38,0.631578947368421,0.5882352941176471,36
2004-12-18,Man United,Crystal Palace,5,2,H,17,31,75,29,0.6052631578947368,23,11,12,0.47058823529411764,17,14,-1,-1,0.0,17,24,-7,0.17647058823529413,0,0,0,0,0,0,0,0,0.8,0.0,17,76,30,0.6052631578947368,0.2941176470588235,19
2004-12-18,Middlesbrough,Aston Villa,3,0,H,17,29,48,-8,0.34210526315789475,29,22,7,0.47058823529411764,17,25,56,4,0.3947368421052632,22,19,3,0.35294117647058826,0,0,0,0,0,0,0,0,0.6,0.4,4,-8,-12,-0.052631578947368474,0.11764705882352938,4
2004-12-18,Tottenham,Southampton,5,1,H,17,22,45,-10,0.34210526315789475,16,17,-1,0.35294117647058826,17,13,47,-1,0.3157894736842105,17,26,-9,0.11764705882352941,1,0,0,0,0,0,0,0,0.6,0.2,9,-2,-9,0.026315789473684237,0.23529411764705885,8
2004-12-19,Liverpool,Newcastle,3,1,H,17,25,60,18,0.42105263157894735,25,19,6,0.4117647058823529,17,21,56,12,0.34210526315789475,28,32,-4,0.29411764705882354,0,0,0,0,0,0,0,0,0.2,0.2,4,4,6,0.0789473684210526,0.11764705882352938,10
2004-12-19,Portsmouth,Arsenal,0,1,A,17,23,45,-7,0.3157894736842105,23,24,-1,0.35294117647058826,17,35,90,47,0.6842105263157895,44,22,22,0.5882352941176471,0,0,0,0,0,0,0,0,0.4,0.4,-12,-45,-54,-0.368421052631579,-0.23529411764705882,-23
2004-12-20,Charlton,Fulham,2,1,H,17,24,53,0,0.3684210526315789,19,27,-8,0.4117647058823529,17,18,52,6,0.3684210526315789,19,28,-9,0.29411764705882354,0,0,0,0,0,0,0,0,0.6,0.2,6,1,-6,0.0,0.11764705882352938,1
2004-12-26,Arsenal,Fulham,2,0,H,18,38,90,47,0.6842105263157895,45,22,23,0.6111111111111112,18,18,52,6,0.3684210526315789,20,30,-10,0.2777777777777778,0,0,0,0,0,0,0,0,0.4,0.2,20,38,41,0.31578947368421056,0.33333333333333337,33
2004-12-26,Birmingham,Middlesbrough,2,0,H,18,20,50,-5,0.3157894736842105,18,19,-1,0.2222222222222222,18,32,48,-8,0.34210526315789475,32,22,10,0.5,0,0,0,0,0,0,0,0,0.4,0.6,-12,2,3,-0.026315789473684237,-0.2777777777777778,-11
2004-12-26,Blackburn,Newcastle,2,2,D,18,15,44,-8,0.3157894736842105,16,30,-14,0.1111111111111111,18,21,56,12,0.34210526315789475,29,35,-6,0.2777777777777778,0,0,0,0,0,0,0,0,0.2,0.2,-6,-12,-20,-0.026315789473684237,-0.16666666666666669,-8
2004-12-26,Chelsea,Aston Villa,1,0,H,18,43,79,37,0.631578947368421,37,8,29,0.7222222222222222,18,25,56,4,0.3947368421052632,22,22,0,0.3333333333333333,0,0,0,0,0,0,0,0,0.6,0.2,18,23,33,0.2368421052631578,0.3888888888888889,29
2004-12-26,Crystal Palace,Portsmouth,0,1,A,18,14,-1,-1,0.0,19,29,-10,0.16666666666666666,18,23,45,-7,0.3157894736842105,23,25,-2,0.3333333333333333,0,0,0,0,0,0,0,0,0.0,0.4,-9,-46,6,-0.3157894736842105,-0.16666666666666666,-8
2004-12-26,Everton,Man City,2,1,H,18,37,39,-12,0.2368421052631579,21,14,7,0.6111111111111112,18,23,41,1,0.2368421052631579,22,18,4,0.3333333333333333,0,0,0,0,0,0,0,0,0.6,0.6,14,-2,-13,0.0,0.27777777777777785,3
2004-12-26,Man United,Bolton,2,0,H,18,34,75,29,0.6052631578947368,28,13,15,0.5,18,23,53,-8,0.3684210526315789,26,26,0,0.3333333333333333,0,0,0,0,0,0,1,0,0.8,0.0,11,22,37,0.2368421052631579,0.16666666666666669,15
2004-12-26,Norwich,Tottenham,0,2,A,18,15,-1,-1,0.0,17,32,-15,0.1111111111111111,18,25,45,-10,0.34210526315789475,21,18,3,0.3888888888888889,0,0,0,0,1,0,0,0,0.4,0.8,-10,-46,9,-0.34210526315789475,-0.2777777777777778,-18
2004-12-26,Southampton,Charlton,0,0,D,18,13,47,-1,0.3157894736842105,18,31,-13,0.1111111111111111,18,27,53,0,0.3684210526315789,21,28,-7,0.4444444444444444,0,0,0,0,1,0,0,0,0.0,0.6,-14,-6,-1,-0.05263157894736842,-0.3333333333333333,-6
2004-12-26,West Brom,Liverpool,0,5,A,18,10,-1,-1,0.0,15,36,-21,0.05555555555555555,18,28,60,18,0.42105263157894735,28,20,8,0.4444444444444444,0,0,1,0,0,0,0,0,0.0,0.4,-18,-61,-19,-0.42105263157894735,-0.38888888888888884,-29
2004-12-28,Aston Villa,Man United,0,1,A,19,25,56,4,0.3947368421052632,22,23,-1,0.3157894736842105,19,37,75,29,0.6052631578947368,30,13,17,0.5263157894736842,0,0,1,0,0,0,0,0,0.0,0.8,-12,-19,-25,-0.21052631578947362,-0.21052631578947367,-18
2004-12-28,Bolton,Blackburn,0,1,A,19,23,53,-8,0.3684210526315789,26,28,-2,0.3157894736842105,19,16,44,-8,0.3157894736842105,18,32,-14,0.10526315789473684,0,0,1,1,0,0,0,0,0.0,0.2,7,9,0,0.05263157894736842,0.21052631578947367,12
2004-12-28,Charlton,Everton,2,0,H,19,28,53,0,0.3684210526315789,21,28,-7,0.42105263157894735,19,40,39,-12,0.2368421052631579,23,15,8,0.631578947368421,0,0,0,0,0,0,0,0,0.6,0.6,-12,14,12,0.13157894736842102,-0.21052631578947367,-15
2004-12-28,Fulham,Birmingham,2,3,A,19,18,52,6,0.3684210526315789,20,32,-12,0.2631578947368421,19,23,50,-5,0.3157894736842105,20,19,1,0.2631578947368421,0,0,0,0,1,0,0,0,0.2,0.6,-5,2,11,0.05263157894736842,0.0,-13
2004-12-28,Liverpool,Southampton,1,0,H,19,31,60,18,0.42105263157894735,33,20,13,0.47368421052631576,19,14,47,-1,0.3157894736842105,18,31,-13,0.10526315789473684,0,0,0,0,0,0,0,0,0.4,0.0,17,13,19,0.10526315789473684,0.3684210526315789,26
2004-12-28,Man City,West Brom,1,1,D,19,23,41,1,0.2368421052631579,23,20,3,0.3157894736842105,19,10,-1,-1,0.0,15,41,-26,0.05263157894736842,0,0,0,0,0,0,1,1,0.4,0.0,13,42,2,0.2368421052631579,0.2631578947368421,29
2004-12-28,Middlesbrough,Norwich,2,0,H,19,32,48,-8,0.34210526315789475,32,24,8,0.47368421052631576,19,15,-1,-1,0.0,17,34,-17,0.10526315789473684,0,0,0,0,0,0,0,0,0.4,0.2,17,49,-7,0.34210526315789475,0.3684210526315789,25
2004-12-28,Portsmouth,Chelsea,0,2,A,19,26,45,-7,0.3157894736842105,24,25,-1,0.3684210526315789,19,46,79,37,0.631578947368421,38,8,30,0.7368421052631579,0,0,0,0,0,0,0,0,0.4,0.8,-20,-34,-44,-0.3157894736842105,-0.3684210526315789,-31
2004-12-28,Tottenham,Crystal Palace,1,1,D,19,28,45,-10,0.34210526315789475,23,18,5,0.42105263157894735,19,14,-1,-1,0.0,19,30,-11,0.15789473684210525,1,1,0,0,0,0,0,0,1.0,0.0,14,46,-9,0.34210526315789475,0.2631578947368421,16
2004-12-29,Newcastle,Arsenal,0,1,A,19,22,56,12,0.34210526315789475,31,37,-6,0.2631578947368421,19,41,90,47,0.6842105263157895,47,22,25,0.631578947368421,0,0,0,0,0,0,0,0,0.0,0.6,-19,-34,-35,-0.34210526315789475,-0.3684210526315789,-31
2005-01-01,Aston Villa,Blackburn,1,0,H,20,25,56,4,0.3947368421052632,22,24,-2,0.3,20,19,44,-8,0.3157894736842105,19,32,-13,0.15,0,0,1,0,0,0,0,0,0.0,0.2,6,12,12,0.07894736842105271,0.15,11
2005-01-01,Bolton,West Brom,1,1,D,20,23,53,-8,0.3684210526315789,26,29,-3,0.3,20,11,-1,-1,0.0,16,42,-26,0.05,0,0,1,1,0,0,0,0,0.0,0.0,12,54,-7,0.3684210526315789,0.25,23
2005-01-01,Charlton,Arsenal,1,3,A,20,31,53,0,0.3684210526315789,23,28,-5,0.45,20,44,90,47,0.6842105263157895,48,22,26,0.65,0,0,0,0,1,0,0,0,0.8,0.8,-13,-37,-47,-0.31578947368421056,-0.2,-31
2005-01-01,Fulham,Crystal Palace,3,1,H,20,18,52,6,0.3684210526315789,22,35,-13,0.25,20,15,-1,-1,0.0,20,31,-11,0.15,0,0,1,0,0,0,0,0,0.2,0.0,3,53,7,0.3684210526315789,0.1,-2
2005-01-01,Liverpool,Chelsea,0,1,A,20,34,60,18,0.42105263157894735,34,20,14,0.5,20,49,79,37,0.631578947368421,40,8,32,0.75,1,0,0,0,1,0,0,0,0.6,0.8,-15,-19,-19,-0.21052631578947367,-0.25,-18
2005-01-01,Man City,Southampton,2,1,H,20,24,41,1,0.2368421052631579,24,21,3,0.3,20,14,47,-1,0.3157894736842105,18,32,-14,0.1,0,0,0,0,0,0,0,0,0.2,0.0,10,-6,2,-0.0789473684210526,0.19999999999999998,17
2005-01-01,Middlesbrough,Man United,0,2,A,20,35,48,-8,0.34210526315789475,34,24,10,0.5,20,40,75,29,0.6052631578947368,31,13,18,0.55,0,0,0,0,1,0,0,0,0.6,0.8,-5,-27,-37,-0.2631578947368421,-0.050000000000000044,-8
2005-01-01,Newcastle,Birmingham,2,1,H,20,22,56,12,0.34210526315789475,31,38,-7,0.25,20,26,50,-5,0.3157894736842105,23,21,2,0.3,0,0,0,0,1,0,0,0,0.0,0.8,-4,6,17,0.026315789473684237,-0.04999999999999999,-9
2005-01-01,Portsmouth,Norwich,1,1,D,20,26,45,-7,0.3157894736842105,24,27,-3,0.35,20,15,-1,-1,0.0,17,36,-19,0.1,0,0,0,0,0,0,1,0,0.2,0.2,11,46,-6,0.3157894736842105,0.24999999999999997,16
2005-01-01,Tottenham,Everton,5,2,H,20,29,45,-10,0.34210526315789475,24,19,5,0.4,20,40,39,-12,0.2368421052631579,23,17,6,0.6,0,0,0,0,0,0,0,0,0.8,0.6,-11,6,2,0.10526315789473684,-0.19999999999999996,-1
2005-01-03,Blackburn,Charlton,1,0,H,21,19,44,-8,0.3157894736842105,19,33,-14,0.14285714285714285,21,31,53,0,0.3684210526315789,24,31,-7,0.42857142857142855,0,0,0,0,0,0,0,0,0.2,0.6,-12,-9,-8,-0.05263157894736842,-0.2857142857142857,-7
2005-01-03,Crystal Palace,Aston Villa,2,0,H,21,15,-1,-1,0.0,21,34,-13,0.14285714285714285,21,28,56,4,0.3947368421052632,23,24,-1,0.3333333333333333,0,0,0,0,0,0,0,0,0.0,0.2,-13,-57,-5,-0.3947368421052632,-0.19047619047619047,-12
2005-01-03,Norwich,Liverpool,1,2,A,21,16,-1,-1,0.0,18,37,-19,0.09523809523809523,21,34,60,18,0.42105263157894735,34,21,13,0.47619047619047616,0,0,0,0,0,0,0,0,0.2,0.6,-18,-61,-19,-0.42105263157894735,-0.38095238095238093,-32
2005-01-03,West Brom,Newcastle,0,0,D,21,12,-1,-1,0.0,17,43,-26,0.047619047619047616,21,25,56,12,0.34210526315789475,33,39,-6,0.2857142857142857,0,0,0,0,0,0,0,0,0.0,0.2,-13,-57,-13,-0.34210526315789475,-0.23809523809523808,-20
2005-01-04,Arsenal,Man City,1,1,D,21,47,90,47,0.6842105263157895,51,23,28,0.6666666666666666,21,27,41,1,0.2368421052631579,26,22,4,0.3333333333333333,1,0,0,0,0,0,0,0,0.8,0.4,20,49,46,0.4473684210526316,0.3333333333333333,24
2005-01-04,Birmingham,Bolton,1,2,A,21,26,50,-5,0.3157894736842105,24,23,1,0.2857142857142857,21,24,53,-8,0.3684210526315789,27,30,-3,0.2857142857142857,0,0,0,0,0,0,0,0,0.8,0.0,2,-3,3,-0.05263157894736842,0.0,4
2005-01-04,Chelsea,Middlesbrough,2,0,H,21,52,79,37,0.631578947368421,41,8,33,0.7619047619047619,21,35,48,-8,0.34210526315789475,34,26,8,0.47619047619047616,1,0,0,0,0,0,0,0,0.8,0.4,17,31,45,0.28947368421052627,0.2857142857142857,25
2005-01-04,Everton,Portsmouth,2,1,H,21,40,39,-12,0.2368421052631579,25,22,3,0.5714285714285714,21,27,45,-7,0.3157894736842105,25,28,-3,0.3333333333333333,0,0,0,0,0,0,0,0,0.4,0.2,13,-6,-5,-0.0789473684210526,0.23809523809523808,6
2005-01-04,Man United,Tottenham,0,0,D,21,43,75,29,0.6052631578947368,33,13,20,0.5714285714285714,21,32,45,-10,0.34210526315789475,29,21,8,0.42857142857142855,1,0,0,0,0,0,0,0,0.8,0.8,11,30,39,0.2631578947368421,0.14285714285714285,12
2005-01-05,Southampton,Fulham,3,3,D,21,14,47,-1,0.3157894736842105,19,34,-15,0.09523809523809523,21,21,52,6,0.3684210526315789,25,36,-11,0.2857142857142857,0,0,0,0,0,0,0,0,0.0,0.2,-7,-5,-7,-0.05263157894736842,-0.19047619047619047,-4
2005-01-15,Aston Villa,Norwich,3,0,H,22,28,56,4,0.3947368421052632,23,26,-3,0.3181818181818182,22,16,-1,-1,0.0,19,39,-20,0.09090909090909091,0,0,0,0,0,0,0,0,0.2,0.0,12,57,5,0.3947368421052632,0.22727272727272727,17
2005-01-15,Bolton,Arsenal,1,0,H,22,27,53,-8,0.3684210526315789,29,31,-2,0.3181818181818182,22,48,90,47,0.6842105263157895,52,24,28,0.6363636363636364,0,0,0,0,0,0,0,0,0.2,0.8,-21,-37,-55,-0.31578947368421056,-0.3181818181818182,-30
2005-01-15,Charlton,Birmingham,3,1,H,22,31,53,0,0.3684210526315789,24,32,-8,0.4090909090909091,22,26,50,-5,0.3157894736842105,25,25,0,0.2727272727272727,0,0,0,0,0,0,0,0,0.4,0.6,5,3,5,0.05263157894736842,0.1363636363636364,-8
2005-01-15,Liverpool,Man United,0,1,A,22,37,60,18,0.42105263157894735,36,22,14,0.5,22,44,75,29,0.6052631578947368,33,13,20,0.5454545454545454,0,0,0,0,0,0,0,0,0.8,0.8,-7,-15,-11,-0.1842105263157895,-0.045454545454545414,-6
2005-01-15,Man City,Crystal Palace,3,1,H,22,28,41,1,0.2368421052631579,27,23,4,0.3181818181818182,22,18,-1,-1,0.0,23,34,-11,0.18181818181818182,0,0,0,0,0,0,0,0,0.4,0.2,10,42,2,0.2368421052631579,0.13636363636363635,15
2005-01-15,Newcastle,Southampton,2,1,H,22,26,56,12,0.34210526315789475,33,39,-6,0.2727272727272727,22,15,47,-1,0.3157894736842105,22,37,-15,0.09090909090909091,0,0,0,0,0,0,0,0,0.2,0.0,11,9,13,0.026315789473684237,0.1818181818181818,9
2005-01-15,Portsmouth,Blackburn,0,1,A,22,27,45,-7,0.3157894736842105,26,30,-4,0.3181818181818182,22,22,44,-8,0.3157894736842105,20,33,-13,0.18181818181818182,0,0,0,0,0,0,0,0,0.2,0.4,5,1,1,0.0,0.13636363636363635,9
2005-01-15,Tottenham,Chelsea,0,2,A,22,33,45,-10,0.34210526315789475,29,21,8,0.4090909090909091,22,55,79,37,0.631578947368421,43,8,35,0.7727272727272727,0,0,0,0,1,1,0,0,0.6,1.0,-22,-34,-47,-0.28947368421052627,-0.3636363636363636,-27
2005-01-16,Fulham,West Brom,1,0,H,22,22,52,6,0.3684210526315789,28,39,-11,0.2727272727272727,22,13,-1,-1,0.0,17,43,-26,0.045454545454545456,0,0,0,0,0,0,0,0,0.2,0.0,9,53,7,0.3684210526315789,0.22727272727272724,15
2005-01-16,Middlesbrough,Everton,1,1,D,22,35,48,-8,0.34210526315789475,34,28,6,0.45454545454545453,22,43,39,-12,0.2368421052631579,27,23,4,0.5909090909090909,0,0,0,0,0,0,0,0,0.4,0.4,-8,9,4,0.10526315789473684,-0.1363636363636364,2
2005-01-22,Birmingham,Fulham,1,2,A,23,26,50,-5,0.3157894736842105,26,28,-2,0.2608695652173913,23,25,52,6,0.3684210526315789,29,39,-10,0.30434782608695654,0,0,1,0,0,0,0,0,0.4,0.4,1,-2,-11,-0.05263157894736842,-0.043478260869565244,8
2005-01-22,Chelsea,Portsmouth,3,0,H,23,58,79,37,0.631578947368421,45,8,37,0.782608695652174,23,27,45,-7,0.3157894736842105,26,31,-5,0.30434782608695654,1,1,0,0,0,0,0,0,1.0,0.2,31,34,44,0.3157894736842105,0.4782608695652174,42
2005-01-22,Crystal Palace,Tottenham,3,0,H,23,18,-1,-1,0.0,24,37,-13,0.17391304347826086,23,33,45,-10,0.34210526315789475,29,23,6,0.391304347826087,0,0,0,0,0,0,0,0,0.2,0.4,-15,-46,9,-0.34210526315789475,-0.2173913043478261,-19
2005-01-22,Everton,Charlton,0,1,A,23,44,39,-12,0.2368421052631579,28,24,4,0.5652173913043478,23,34,53,0,0.3684210526315789,27,33,-6,0.43478260869565216,0,0,0,0,0,0,0,0,0.4,0.4,10,-14,-12,-0.13157894736842102,0.13043478260869562,10
2005-01-22,Man United,Aston Villa,3,1,H,23,47,75,29,0.6052631578947368,34,13,21,0.5652173913043478,23,31,56,4,0.3947368421052632,26,26,0,0.34782608695652173,0,0,0,0,0,0,0,0,0.8,0.4,16,19,25,0.21052631578947362,0.21739130434782605,21
2005-01-22,Norwich,Middlesbrough,4,4,D,23,16,-1,-1,0.0,19,42,-23,0.08695652173913043,23,36,48,-8,0.34210526315789475,35,29,6,0.43478260869565216,0,0,0,0,0,0,0,0,0.0,0.2,-20,-49,7,-0.34210526315789475,-0.34782608695652173,-29
2005-01-22,Southampton,Liverpool,2,0,H,23,15,47,-1,0.3157894736842105,23,39,-16,0.08695652173913043,23,37,60,18,0.42105263157894735,36,23,13,0.4782608695652174,0,0,0,0,0,0,0,0,0.0,0.6,-22,-13,-19,-0.10526315789473684,-0.391304347826087,-29
2005-01-22,West Brom,Man City,2,0,H,23,13,-1,-1,0.0,17,44,-27,0.043478260869565216,23,31,41,1,0.2368421052631579,30,24,6,0.34782608695652173,0,0,0,0,0,0,0,0,0.0,0.4,-18,-42,-2,-0.2368421052631579,-0.30434782608695654,-33
2005-01-23,Arsenal,Newcastle,1,0,H,23,48,90,47,0.6842105263157895,52,25,27,0.6086956521739131,23,29,56,12,0.34210526315789475,35,40,-5,0.30434782608695654,0,0,0,0,0,0,0,0,0.6,0.4,19,34,35,0.34210526315789475,0.30434782608695654,32
2005-01-24,Blackburn,Bolton,0,1,A,23,25,44,-8,0.3157894736842105,21,33,-12,0.21739130434782608,23,30,53,-8,0.3684210526315789,30,31,-1,0.34782608695652173,0,0,0,0,0,0,0,0,0.6,0.4,-5,-9,0,-0.05263157894736842,-0.13043478260869565,-11
2005-02-01,Arsenal,Man United,2,4,A,24,51,90,47,0.6842105263157895,53,25,28,0.625,24,50,75,29,0.6052631578947368,37,14,23,0.5833333333333334,0,0,0,0,0,0,0,0,0.6,0.8,1,15,18,0.07894736842105265,0.04166666666666663,5
2005-02-01,Bolton,Tottenham,3,1,H,24,33,53,-8,0.3684210526315789,31,31,0,0.375,24,33,45,-10,0.34210526315789475,29,26,3,0.375,1,0,0,0,0,0,0,0,0.6,0.2,0,8,2,0.02631578947368418,0.0,-3
2005-02-01,Charlton,Liverpool,1,2,A,24,37,53,0,0.3684210526315789,28,33,-5,0.4583333333333333,24,37,60,18,0.42105263157894735,36,25,11,0.4583333333333333,0,0,0,0,0,0,0,0,0.6,0.4,0,-7,-18,-0.05263157894736842,0.0,-16
2005-02-01,Portsmouth,Middlesbrough,2,1,H,24,27,45,-7,0.3157894736842105,26,34,-8,0.2916666666666667,24,37,48,-8,0.34210526315789475,39,33,6,0.4166666666666667,0,0,1,0,0,0,0,0,0.0,0.2,-10,-3,1,-0.026315789473684237,-0.125,-14
2005-02-01,West Brom,Crystal Palace,2,2,D,24,16,-1,-1,0.0,19,44,-25,0.08333333333333333,24,21,-1,-1,0.0,27,37,-10,0.20833333333333334,0,0,0,0,0,0,0,0,0.2,0.4,-5,0,0,0.0,-0.125,-15
2005-02-02,Birmingham,Southampton,2,1,H,24,26,50,-5,0.3157894736842105,27,30,-3,0.25,24,18,47,-1,0.3157894736842105,25,39,-14,0.125,0,0,1,0,0,0,0,0,0.2,0.2,8,3,-4,0.0,0.125,11
2005-02-02,Blackburn,Chelsea,0,1,A,24,25,44,-8,0.3157894736842105,21,34,-13,0.20833333333333334,24,61,79,37,0.631578947368421,48,8,40,0.7916666666666666,0,0,0,0,1,1,0,0,0.6,1.0,-36,-35,-45,-0.3157894736842105,-0.5833333333333333,-53
2005-02-02,Everton,Norwich,1,0,H,24,44,39,-12,0.2368421052631579,28,25,3,0.5416666666666666,24,17,-1,-1,0.0,23,46,-23,0.08333333333333333,0,0,0,0,0,0,0,0,0.2,0.0,27,40,-11,0.2368421052631579,0.4583333333333333,26
2005-02-02,Fulham,Aston Villa,1,1,D,24,28,52,6,0.3684210526315789,31,40,-9,0.3333333333333333,24,31,56,4,0.3947368421052632,27,29,-2,0.3333333333333333,0,0,0,0,0,0,0,0,0.6,0.4,-3,-4,2,-0.026315789473684292,0.0,-7
2005-02-02,Man City,Newcastle,1,1,D,24,31,41,1,0.2368421052631579,30,26,4,0.3333333333333333,24,29,56,12,0.34210526315789475,35,41,-6,0.2916666666666667,0,0,0,0,0,0,0,0,0.4,0.4,2,-15,-11,-0.10526315789473684,0.04166666666666663,10
2005-02-05,Aston Villa,Arsenal,1,3,A,25,32,56,4,0.3947368421052632,28,30,-2,0.32,25,51,90,47,0.6842105263157895,55,29,26,0.6,0,0,0,0,0,0,0,0,0.4,0.4,-19,-34,-43,-0.28947368421052627,-0.27999999999999997,-28
2005-02-05,Crystal Palace,Bolton,0,1,A,25,22,-1,-1,0.0,29,39,-10,0.2,25,36,53,-8,0.3684210526315789,34,32,2,0.4,0,0,0,0,1,0,0,0,0.4,0.8,-14,-54,7,-0.3684210526315789,-0.2,-12
2005-02-05,Liverpool,Fulham,3,1,H,25,40,60,18,0.42105263157894735,38,26,12,0.48,25,29,52,6,0.3684210526315789,32,41,-9,0.32,0,0,0,0,0,0,0,0,0.4,0.6,11,8,12,0.05263157894736842,0.15999999999999998,21
2005-02-05,Man United,Birmingham,2,0,H,25,53,75,29,0.6052631578947368,41,16,25,0.6,25,29,50,-5,0.3157894736842105,29,31,-2,0.28,1,0,0,0,0,0,0,0,0.8,0.2,24,25,34,0.2894736842105263,0.31999999999999995,27
2005-02-05,Middlesbrough,Blackburn,1,0,H,25,37,48,-8,0.34210526315789475,40,35,5,0.4,25,25,44,-8,0.3157894736842105,21,35,-14,0.2,0,0,0,0,0,0,0,0,0.0,0.4,12,4,0,0.026315789473684237,0.2,19
2005-02-05,Newcastle,Charlton,1,1,D,25,30,56,12,0.34210526315789475,36,42,-6,0.28,25,37,53,0,0.3684210526315789,29,35,-6,0.44,0,0,0,0,0,0,0,0,0.4,0.4,-7,3,12,-0.02631578947368418,-0.15999999999999998,0
2005-02-05,Norwich,West Brom,3,2,H,25,17,-1,-1,0.0,23,47,-24,0.08,25,17,-1,-1,0.0,21,46,-25,0.08,0,0,0,0,0,0,0,0,0.0,0.2,0,0,0,0.0,0.0,1
2005-02-05,Tottenham,Portsmouth,3,1,H,25,33,45,-10,0.34210526315789475,30,29,1,0.36,25,30,45,-7,0.3157894736842105,28,35,-7,0.32,0,0,1,0,0,0,0,0,0.2,0.2,3,0,-3,0.026315789473684237,0.03999999999999998,8
2005-02-06,Chelsea,Man City,0,0,D,25,64,79,37,0.631578947368421,49,8,41,0.8,25,32,41,1,0.2368421052631579,31,27,4,0.32,1,1,0,0,0,0,0,0,1.0,0.4,32,38,36,0.3947368421052631,0.48000000000000004,37
2005-02-06,Southampton,Everton,2,2,D,25,18,47,-1,0.3157894736842105,26,41,-15,0.12,25,47,39,-12,0.2368421052631579,29,25,4,0.56,0,0,0,0,0,0,0,0,0.2,0.4,-29,8,11,0.0789473684210526,-0.44000000000000006,-19
2005-02-12,Birmingham,Liverpool,2,0,H,26,29,50,-5,0.3157894736842105,29,33,-4,0.2692307692307692,26,43,60,18,0.42105263157894735,41,27,14,0.5,0,0,0,0,0,0,0,0,0.2,0.6,-14,-10,-23,-0.10526315789473684,-0.23076923076923078,-18
2005-02-12,Blackburn,Norwich,3,0,H,26,25,44,-8,0.3157894736842105,21,36,-15,0.19230769230769232,26,20,-1,-1,0.0,26,49,-23,0.11538461538461539,0,0,1,0,0,0,0,0,0.4,0.2,5,45,-7,0.3157894736842105,0.07692307692307693,8
2005-02-12,Bolton,Middlesbrough,0,0,D,26,39,53,-8,0.3684210526315789,35,32,3,0.4230769230769231,26,40,48,-8,0.34210526315789475,41,35,6,0.4230769230769231,1,1,0,0,0,0,0,0,1.0,0.2,-1,5,0,0.02631578947368418,0.0,-3
2005-02-12,Everton,Chelsea,0,1,A,26,48,39,-12,0.2368421052631579,31,27,4,0.5384615384615384,26,65,79,37,0.631578947368421,49,8,41,0.7692307692307693,0,0,0,0,0,0,0,0,0.4,0.8,-17,-40,-49,-0.3947368421052631,-0.23076923076923084,-37
2005-02-12,Portsmouth,Aston Villa,1,2,A,26,30,45,-7,0.3157894736842105,29,38,-9,0.3076923076923077,26,32,56,4,0.3947368421052632,29,33,-4,0.3076923076923077,0,0,0,0,0,0,0,0,0.2,0.2,-2,-11,-11,-0.07894736842105271,0.0,-5
2005-02-13,Man City,Man United,0,2,A,26,33,41,1,0.2368421052631579,31,27,4,0.3076923076923077,26,56,75,29,0.6052631578947368,43,16,27,0.6153846153846154,0,0,0,0,1,0,0,0,0.2,0.8,-23,-34,-28,-0.3684210526315789,-0.3076923076923077,-23
2005-02-14,Arsenal,Crystal Palace,5,1,H,26,54,90,47,0.6842105263157895,58,30,28,0.6153846153846154,26,22,-1,-1,0.0,29,40,-11,0.19230769230769232,0,0,0,0,0,0,0,0,0.4,0.4,32,91,48,0.6842105263157895,0.42307692307692313,39
2005-02-22,West Brom,Southampton,0,0,D,26,17,-1,-1,0.0,23,49,-26,0.07692307692307693,26,19,47,-1,0.3157894736842105,28,43,-15,0.11538461538461539,0,0,0,0,0,0,0,0,0.2,0.2,-2,-48,0,-0.3157894736842105,-0.038461538461538464,-11
2005-02-26,Aston Villa,Everton,1,3,A,27,35,56,4,0.3947368421052632,31,34,-3,0.3333333333333333,27,48,39,-12,0.2368421052631579,31,28,3,0.5185185185185185,0,0,0,0,0,0,0,0,0.4,0.2,-13,17,16,0.1578947368421053,-0.18518518518518517,-6
2005-02-26,Crystal Palace,Birmingham,2,0,H,27,22,-1,-1,0.0,30,45,-15,0.18518518518518517,27,32,50,-5,0.3157894736842105,31,33,-2,0.2962962962962963,0,0,0,0,0,0,0,0,0.2,0.4,-10,-51,4,-0.3157894736842105,-0.1111111111111111,-13
2005-02-26,Man United,Portsmouth,2,1,H,27,59,75,29,0.6052631578947368,45,16,29,0.6296296296296297,27,30,45,-7,0.3157894736842105,30,40,-10,0.2962962962962963,1,1,0,0,0,0,0,0,1.0,0.2,29,30,36,0.2894736842105263,0.33333333333333337,39
2005-02-26,Southampton,Arsenal,1,1,D,27,20,47,-1,0.3157894736842105,28,43,-15,0.1111111111111111,27,57,90,47,0.6842105263157895,63,31,32,0.6296296296296297,0,0,0,0,0,0,0,0,0.2,0.6,-37,-43,-48,-0.368421052631579,-0.5185185185185186,-47
2005-02-26,Tottenham,Fulham,2,0,H,26,36,45,-10,0.34210526315789475,33,30,3,0.38461538461538464,26,29,52,6,0.3684210526315789,33,44,-11,0.3076923076923077,0,0,0,0,0,0,0,0,0.2,0.4,7,-7,-16,-0.02631578947368418,0.07692307692307693,14
2005-02-27,Middlesbrough,Charlton,2,2,D,27,41,48,-8,0.34210526315789475,41,35,6,0.4074074074074074,26,38,53,0,0.3684210526315789,30,36,-6,0.4230769230769231,0,0,0,0,0,0,0,0,0.2,0.4,3,-5,-8,-0.02631578947368418,-0.015669515669515688,12
2005-02-27,Newcastle,Bolton,2,1,H,26,31,56,12,0.34210526315789475,37,43,-6,0.2692307692307692,27,40,53,-8,0.3684210526315789,35,32,3,0.4074074074074074,0,0,0,0,0,0,0,0,0.2,0.8,-9,3,20,-0.02631578947368418,-0.13817663817663817,-9
2005-02-28,Norwich,Man City,2,3,A,27,20,-1,-1,0.0,26,52,-26,0.1111111111111111,27,33,41,1,0.2368421052631579,31,29,2,0.2962962962962963,0,0,0,0,0,0,0,0,0.2,0.2,-13,-42,-2,-0.2368421052631579,-0.18518518518518517,-28
2005-03-05,Arsenal,Portsmouth,3,0,H,28,58,90,47,0.6842105263157895,64,32,32,0.6071428571428571,28,30,45,-7,0.3157894736842105,31,42,-11,0.2857142857142857,0,0,0,0,0,0,1,0,0.6,0.2,28,45,54,0.368421052631579,0.3214285714285714,43
2005-03-05,Aston Villa,Middlesbrough,2,0,H,28,35,56,4,0.3947368421052632,32,37,-5,0.32142857142857145,28,42,48,-8,0.34210526315789475,43,37,6,0.39285714285714285,0,0,0,0,0,0,0,0,0.2,0.2,-7,8,12,0.052631578947368474,-0.0714285714285714,-11
2005-03-05,Crystal Palace,Man United,0,0,D,28,25,-1,-1,0.0,32,45,-13,0.21428571428571427,28,62,75,29,0.6052631578947368,47,17,30,0.6428571428571429,0,0,0,0,1,1,0,0,0.4,1.0,-37,-76,-30,-0.6052631578947368,-0.4285714285714286,-43
2005-03-05,Fulham,Charlton,0,0,D,27,29,52,6,0.3684210526315789,33,46,-13,0.2962962962962963,27,39,53,0,0.3684210526315789,32,38,-6,0.4074074074074074,0,0,0,0,0,0,0,0,0.4,0.4,-10,-1,6,0.0,-0.1111111111111111,-7
2005-03-05,Newcastle,Liverpool,1,0,H,27,34,56,12,0.34210526315789475,39,44,-5,0.2962962962962963,27,43,60,18,0.42105263157894735,41,29,12,0.48148148148148145,0,0,0,0,0,0,0,0,0.4,0.4,-9,-4,-6,-0.0789473684210526,-0.18518518518518517,-17
2005-03-05,Norwich,Chelsea,1,3,A,28,20,-1,-1,0.0,28,55,-27,0.10714285714285714,27,68,79,37,0.631578947368421,50,8,42,0.7777777777777778,0,0,0,0,0,0,0,0,0.2,0.8,-48,-80,-38,-0.631578947368421,-0.6706349206349207,-69
2005-03-05,Southampton,Tottenham,1,0,H,28,21,47,-1,0.3157894736842105,29,44,-15,0.10714285714285714,27,39,45,-10,0.34210526315789475,35,30,5,0.4074074074074074,0,0,0,0,0,0,0,0,0.2,0.4,-18,2,9,-0.026315789473684237,-0.30026455026455023,-20
2005-03-06,Everton,Blackburn,0,1,A,28,51,39,-12,0.2368421052631579,34,29,5,0.5357142857142857,27,28,44,-8,0.3157894736842105,24,36,-12,0.2222222222222222,0,0,0,0,0,0,0,0,0.4,0.4,23,-5,-4,-0.0789473684210526,0.3134920634920635,17
2005-03-06,West Brom,Birmingham,2,0,H,27,18,-1,-1,0.0,23,49,-26,0.07407407407407407,28,32,50,-5,0.3157894736842105,31,35,-4,0.2857142857142857,0,0,0,0,0,0,0,0,0.2,0.4,-14,-51,4,-0.3157894736842105,-0.21164021164021163,-22
2005-03-07,Man City,Bolton,0,1,A,28,36,41,1,0.2368421052631579,34,31,3,0.32142857142857145,28,40,53,-8,0.3684210526315789,36,34,2,0.39285714285714285,0,0,0,0,0,0,0,0,0.2,0.6,-4,-12,9,-0.13157894736842102,-0.0714285714285714,1
2005-03-15,Chelsea,West Brom,1,0,H,28,71,79,37,0.631578947368421,53,9,44,0.7857142857142857,28,21,-1,-1,0.0,25,49,-24,0.10714285714285714,0,0,0,0,0,0,0,0,0.8,0.4,50,80,38,0.631578947368421,0.6785714285714286,68
2005-03-16,Charlton,Tottenham,2,0,H,28,40,53,0,0.3684210526315789,32,38,-6,0.39285714285714285,28,39,45,-10,0.34210526315789475,35,31,4,0.39285714285714285,0,0,0,0,0,0,0,0,0.2,0.4,1,8,10,0.02631578947368418,0.0,-10
2005-03-16,Liverpool,Blackburn,0,0,D,28,43,60,18,0.42105263157894735,41,30,11,0.4642857142857143,28,31,44,-8,0.3157894736842105,25,36,-11,0.25,0,0,0,0,0,0,0,0,0.4,0.4,12,16,26,0.10526315789473684,0.2142857142857143,22
2005-03-19,Blackburn,Arsenal,0,1,A,29,32,44,-8,0.3157894736842105,25,36,-11,0.2413793103448276,29,61,90,47,0.6842105263157895,67,32,35,0.6206896551724138,0,0,0,0,0,0,0,0,0.4,0.6,-29,-46,-55,-0.368421052631579,-0.3793103448275862,-46
2005-03-19,Bolton,Norwich,1,0,H,29,43,53,-8,0.3684210526315789,37,34,3,0.41379310344827586,29,20,-1,-1,0.0,29,58,-29,0.10344827586206896,0,0,0,0,0,0,1,0,0.6,0.2,23,54,-7,0.3684210526315789,0.3103448275862069,32
2005-03-19,Charlton,West Brom,1,4,A,29,43,53,0,0.3684210526315789,34,38,-4,0.41379310344827586,29,21,-1,-1,0.0,25,50,-25,0.10344827586206896,0,0,0,0,0,0,0,0,0.2,0.2,22,54,1,0.3684210526315789,0.3103448275862069,21
2005-03-19,Chelsea,Crystal Palace,4,1,H,29,74,79,37,0.631578947368421,54,9,45,0.7931034482758621,29,26,-1,-1,0.0,32,45,-13,0.20689655172413793,1,0,0,0,0,0,0,0,0.8,0.2,48,80,38,0.631578947368421,0.5862068965517242,58
2005-03-19,Man United,Fulham,1,0,H,29,63,75,29,0.6052631578947368,47,17,30,0.6206896551724138,28,30,52,6,0.3684210526315789,33,46,-13,0.2857142857142857,0,0,0,0,0,0,0,0,0.8,0.2,33,23,23,0.2368421052631579,0.3349753694581281,43
2005-03-19,Portsmouth,Newcastle,1,1,D,29,30,45,-7,0.3157894736842105,31,45,-14,0.27586206896551724,28,37,56,12,0.34210526315789475,40,44,-4,0.32142857142857145,0,0,1,0,0,0,0,0,0.2,0.4,-7,-11,-19,-0.026315789473684237,-0.045566502463054215,-10
2005-03-19,Tottenham,Man City,2,1,H,29,39,45,-10,0.34210526315789475,35,33,2,0.3793103448275862,29,36,41,1,0.2368421052631579,34,32,2,0.3103448275862069,0,0,0,0,0,0,0,0,0.4,0.2,3,4,-11,0.10526315789473684,0.06896551724137928,0
2005-03-20,Birmingham,Aston Villa,2,0,H,29,32,50,-5,0.3157894736842105,31,37,-6,0.27586206896551724,29,38,56,4,0.3947368421052632,34,37,-3,0.3448275862068966,0,0,0,0,0,0,0,0,0.4,0.4,-6,-6,-9,-0.07894736842105271,-0.06896551724137934,-3
2005-03-20,Liverpool,Everton,2,1,H,29,44,60,18,0.42105263157894735,41,30,11,0.4482758620689655,29,51,39,-12,0.2368421052631579,34,30,4,0.5172413793103449,0,0,0,0,0,0,0,0,0.4,0.4,-7,21,30,0.18421052631578944,-0.06896551724137934,7
2005-03-20,Middlesbrough,Southampton,1,3,A,29,42,48,-8,0.34210526315789475,43,39,4,0.3793103448275862,29,24,47,-1,0.3157894736842105,30,44,-14,0.13793103448275862,0,0,0,0,0,0,0,0,0.2,0.2,18,1,-7,0.026315789473684237,0.24137931034482757,18
2005-04-02,Arsenal,Norwich,4,1,H,30,64,90,47,0.6842105263157895,68,32,36,0.6333333333333333,30,20,-1,-1,0.0,29,59,-30,0.1,0,0,0,0,0,0,1,0,0.8,0.2,44,91,48,0.6842105263157895,0.5333333333333333,66
2005-04-02,Birmingham,Tottenham,1,1,D,30,35,50,-5,0.3157894736842105,33,37,-4,0.3,30,42,45,-10,0.34210526315789475,37,34,3,0.4,0,0,0,0,0,0,0,0,0.4,0.6,-7,5,5,-0.026315789473684237,-0.10000000000000003,-7
2005-04-02,Charlton,Man City,2,2,D,30,43,53,0,0.3684210526315789,35,42,-7,0.4,30,36,41,1,0.2368421052631579,35,34,1,0.3,0,0,0,0,0,0,0,0,0.2,0.2,7,12,-1,0.13157894736842102,0.10000000000000003,-8
2005-04-02,Crystal Palace,Middlesbrough,0,1,A,30,26,-1,-1,0.0,33,49,-16,0.2,30,42,48,-8,0.34210526315789475,44,42,2,0.36666666666666664,0,0,0,0,0,0,0,0,0.2,0.2,-16,-49,7,-0.34210526315789475,-0.16666666666666663,-18
2005-04-02,Liverpool,Bolton,1,0,H,30,47,60,18,0.42105263157894735,43,31,12,0.4666666666666667,30,46,53,-8,0.3684210526315789,38,34,4,0.43333333333333335,0,0,0,0,0,0,0,0,0.4,0.6,1,7,26,0.05263157894736842,0.033333333333333326,8
2005-04-02,Man United,Blackburn,0,0,D,30,66,75,29,0.6052631578947368,48,17,31,0.6333333333333333,30,32,44,-8,0.3157894736842105,25,37,-12,0.23333333333333334,0,0,0,0,0,0,0,0,0.8,0.4,34,31,37,0.2894736842105263,0.39999999999999997,43
2005-04-02,Newcastle,Aston Villa,0,3,A,29,38,56,12,0.34210526315789475,41,45,-4,0.3103448275862069,30,38,56,4,0.3947368421052632,34,39,-5,0.3333333333333333,0,0,0,0,0,0,0,0,0.4,0.4,0,0,8,-0.052631578947368474,-0.02298850574712641,1
2005-04-02,Southampton,Chelsea,1,3,A,30,27,47,-1,0.3157894736842105,33,45,-12,0.16666666666666666,30,77,79,37,0.631578947368421,58,10,48,0.8,0,0,0,0,1,0,0,0,0.4,0.8,-50,-32,-38,-0.3157894736842105,-0.6333333333333334,-60
2005-04-03,Fulham,Portsmouth,3,1,H,29,30,52,6,0.3684210526315789,33,47,-14,0.27586206896551724,30,31,45,-7,0.3157894736842105,32,46,-14,0.26666666666666666,0,0,0,0,0,0,0,0,0.0,0.0,-1,7,13,0.05263157894736842,0.009195402298850575,0
2005-04-03,West Brom,Everton,1,0,H,30,24,-1,-1,0.0,29,51,-22,0.13333333333333333,30,51,39,-12,0.2368421052631579,35,32,3,0.5,0,0,0,0,0,0,0,0,0.4,0.2,-27,-40,11,-0.2368421052631579,-0.3666666666666667,-25
2005-04-09,Blackburn,Southampton,3,0,H,31,33,44,-8,0.3157894736842105,25,37,-12,0.22580645161290322,31,27,47,-1,0.3157894736842105,34,48,-14,0.16129032258064516,0,0,0,0,0,0,0,0,0.4,0.4,6,-3,-7,0.0,0.06451612903225806,2
2005-04-09,Bolton,Fulham,3,1,H,31,46,53,-8,0.3684210526315789,38,35,3,0.41935483870967744,30,33,52,6,0.3684210526315789,36,48,-12,0.3,0,0,0,0,0,0,0,0,0.4,0.2,13,1,-14,0.0,0.11935483870967745,15
2005-04-09,Chelsea,Birmingham,1,1,D,31,80,79,37,0.631578947368421,61,11,50,0.8064516129032258,31,36,50,-5,0.3157894736842105,34,38,-4,0.2903225806451613,1,1,0,0,0,0,0,0,1.0,0.4,44,29,42,0.3157894736842105,0.5161290322580645,54
2005-04-09,Man City,Liverpool,1,0,H,31,37,41,1,0.2368421052631579,37,36,1,0.2903225806451613,31,50,60,18,0.42105263157894735,44,31,13,0.4838709677419355,0,0,0,0,0,0,0,0,0.2,0.4,-13,-19,-17,-0.18421052631578944,-0.1935483870967742,-12
2005-04-09,Middlesbrough,Arsenal,0,1,A,31,45,48,-8,0.34210526315789475,45,42,3,0.3870967741935484,31,67,90,47,0.6842105263157895,72,33,39,0.6451612903225806,0,0,0,0,1,0,0,0,0.2,0.8,-22,-42,-55,-0.34210526315789475,-0.25806451612903225,-36
2005-04-09,Norwich,Man United,2,0,H,31,20,-1,-1,0.0,30,63,-33,0.0967741935483871,31,67,75,29,0.6052631578947368,48,17,31,0.6129032258064516,0,0,1,1,0,0,0,0,0.0,0.6,-47,-76,-30,-0.6052631578947368,-0.5161290322580645,-64
2005-04-09,Portsmouth,Charlton,4,2,H,31,31,45,-7,0.3157894736842105,33,49,-16,0.25806451612903225,31,44,53,0,0.3684210526315789,37,44,-7,0.3870967741935484,0,0,0,0,0,0,0,0,0.0,0.2,-13,-8,-7,-0.05263157894736842,-0.12903225806451613,-9
2005-04-10,Aston Villa,West Brom,1,1,D,31,41,56,4,0.3947368421052632,37,39,-2,0.3548387096774194,31,27,-1,-1,0.0,30,51,-21,0.16129032258064516,0,0,0,0,0,0,0,0,0.6,0.6,14,57,5,0.3947368421052632,0.19354838709677422,19
2005-04-10,Everton,Crystal Palace,4,0,H,31,51,39,-12,0.2368421052631579,35,33,2,0.4838709677419355,31,26,-1,-1,0.0,33,50,-17,0.1935483870967742,0,0,1,0,0,0,0,0,0.2,0.2,25,40,-11,0.2368421052631579,0.2903225806451613,19
2005-04-10,Tottenham,Newcastle,1,0,H,31,43,45,-10,0.34210526315789475,38,35,3,0.3870967741935484,30,38,56,12,0.34210526315789475,41,48,-7,0.3,0,0,0,0,0,0,0,0,0.4,0.4,5,-11,-22,0.0,0.08709677419354839,10
2005-04-16,Birmingham,Portsmouth,0,0,D,32,37,50,-5,0.3157894736842105,35,39,-4,0.28125,32,34,45,-7,0.3157894736842105,37,51,-14,0.28125,0,0,0,0,0,0,0,0,0.2,0.2,3,5,2,0.0,0.0,10
2005-04-16,Charlton,Bolton,1,2,A,32,44,53,0,0.3684210526315789,39,48,-9,0.375,32,49,53,-8,0.3684210526315789,41,36,5,0.4375,0,0,0,0,0,0,0,0,0.2,0.6,-5,0,8,0.0,-0.0625,-14
2005-04-16,Crystal Palace,Norwich,3,3,D,32,26,-1,-1,0.0,33,54,-21,0.1875,32,23,-1,-1,0.0,32,63,-31,0.125,0,0,1,0,0,0,0,0,0.2,0.2,3,0,0,0.0,0.0625,10
2005-04-16,Fulham,Man City,1,1,D,31,33,52,6,0.3684210526315789,37,51,-14,0.2903225806451613,32,40,41,1,0.2368421052631579,38,36,2,0.3125,0,0,0,0,0,0,0,0,0.2,0.4,-7,11,5,0.13157894736842102,-0.02217741935483869,-16
2005-04-16,Liverpool,Tottenham,2,2,D,32,50,60,18,0.42105263157894735,44,32,12,0.46875,32,46,45,-10,0.34210526315789475,39,35,4,0.40625,0,0,0,0,0,0,0,0,0.4,0.4,4,15,28,0.0789473684210526,0.0625,8
2005-04-16,Southampton,Aston Villa,2,3,A,32,27,47,-1,0.3157894736842105,34,51,-17,0.15625,32,42,56,4,0.3947368421052632,38,40,-2,0.34375,0,0,0,0,0,0,0,0,0.4,0.4,-15,-9,-5,-0.07894736842105271,-0.1875,-15
2005-04-19,Bolton,Southampton,1,1,D,33,52,53,-8,0.3684210526315789,43,37,6,0.45454545454545453,33,27,47,-1,0.3157894736842105,36,54,-18,0.15151515151515152,0,0,0,0,0,0,1,0,0.8,0.4,25,6,-7,0.05263157894736842,0.303030303030303,24
2005-04-19,Middlesbrough,Fulham,1,1,D,32,45,48,-8,0.34210526315789475,45,43,2,0.375,32,34,52,6,0.3684210526315789,38,52,-14,0.28125,0,0,0,0,0,0,0,0,0.2,0.2,11,-4,-14,-0.02631578947368418,0.09375,16
2005-04-20,Aston Villa,Charlton,0,0,D,33,45,56,4,0.3947368421052632,41,42,-1,0.36363636363636365,33,44,53,0,0.3684210526315789,40,50,-10,0.36363636363636365,0,0,0,0,0,0,0,0,0.6,0.2,1,3,4,0.026315789473684292,0.0,9
2005-04-20,Blackburn,Crystal Palace,1,0,H,32,36,44,-8,0.3157894736842105,28,37,-9,0.25,33,27,-1,-1,0.0,36,57,-21,0.18181818181818182,0,0,0,0,0,0,0,0,0.4,0.0,9,45,-7,0.3157894736842105,0.06818181818181818,12
2005-04-20,Chelsea,Arsenal,0,0,D,32,81,79,37,0.631578947368421,62,12,50,0.78125,32,70,90,47,0.6842105263157895,73,33,40,0.65625,0,0,0,0,1,0,0,0,0.8,0.8,11,-11,-10,-0.052631578947368474,0.125,10
2005-04-20,Everton,Man United,1,0,H,32,54,39,-12,0.2368421052631579,39,33,6,0.5,32,67,75,29,0.6052631578947368,48,19,29,0.59375,0,0,0,0,0,0,0,0,0.4,0.4,-13,-36,-41,-0.3684210526315789,-0.09375,-23
2005-04-20,Man City,Birmingham,3,0,H,33,41,41,1,0.2368421052631579,39,37,2,0.30303030303030304,33,38,50,-5,0.3157894736842105,35,39,-4,0.2727272727272727,0,0,0,0,0,0,0,0,0.2,0.2,3,-9,6,-0.0789473684210526,0.03030303030303033,6
2005-04-20,Norwich,Newcastle,2,1,H,33,24,-1,-1,0.0,35,66,-31,0.12121212121212122,31,38,56,12,0.34210526315789475,41,49,-8,0.2903225806451613,0,0,0,0,0,0,0,0,0.2,0.4,-14,-57,-13,-0.34210526315789475,-0.1691104594330401,-23
2005-04-20,Portsmouth,Liverpool,1,2,A,33,35,45,-7,0.3157894736842105,37,51,-14,0.2727272727272727,33,51,60,18,0.42105263157894735,46,34,12,0.45454545454545453,0,0,0,0,0,0,0,0,0.2,0.4,-16,-15,-25,-0.10526315789473684,-0.18181818181818182,-26
2005-04-20,Tottenham,West Brom,1,1,D,33,47,45,-10,0.34210526315789475,41,37,4,0.3939393939393939,32,28,-1,-1,0.0,31,52,-21,0.15625,0,0,0,0,0,0,0,0,0.4,0.6,19,46,-9,0.34210526315789475,0.23768939393939392,25
2005-04-23,Aston Villa,Bolton,1,1,D,34,46,56,4,0.3947368421052632,41,42,-1,0.35294117647058826,34,53,53,-8,0.3684210526315789,44,38,6,0.4411764705882353,0,0,0,0,0,0,0,0,0.4,0.6,-7,3,12,0.026315789473684292,-0.08823529411764702,-7
2005-04-23,Blackburn,Man City,0,0,D,33,39,44,-8,0.3157894736842105,29,37,-8,0.2727272727272727,34,44,41,1,0.2368421052631579,42,37,5,0.3235294117647059,0,0,0,0,0,0,0,0,0.4,0.4,-5,3,-9,0.0789473684210526,-0.05080213903743319,-13
2005-04-23,Chelsea,Fulham,3,1,H,33,82,79,37,0.631578947368421,62,12,50,0.7575757575757576,33,35,52,6,0.3684210526315789,39,53,-14,0.2727272727272727,0,0,0,0,0,0,0,0,0.6,0.2,47,27,31,0.2631578947368421,0.48484848484848486,64
2005-04-23,Crystal Palace,Liverpool,1,0,H,34,27,-1,-1,0.0,36,58,-22,0.17647058823529413,34,54,60,18,0.42105263157894735,48,35,13,0.47058823529411764,0,0,0,0,0,0,0,0,0.0,0.6,-27,-61,-19,-0.42105263157894735,-0.2941176470588235,-35
2005-04-23,Everton,Birmingham,1,1,D,33,57,39,-12,0.2368421052631579,40,33,7,0.5151515151515151,34,38,50,-5,0.3157894736842105,35,42,-7,0.2647058823529412,0,0,0,0,0,0,0,0,0.4,0.2,19,-11,-7,-0.0789473684210526,0.25044563279857396,14
2005-04-23,Middlesbrough,West Brom,4,0,H,33,46,48,-8,0.34210526315789475,46,44,2,0.36363636363636365,33,29,-1,-1,0.0,32,53,-21,0.15151515151515152,0,0,0,0,0,0,0,0,0.2,0.4,17,49,-7,0.34210526315789475,0.21212121212121213,23
2005-04-23,Norwich,Charlton,1,0,H,34,27,-1,-1,0.0,37,67,-30,0.14705882352941177,34,45,53,0,0.3684210526315789,40,50,-10,0.35294117647058826,0,0,0,0,0,0,0,0,0.4,0.0,-18,-54,-1,-0.3684210526315789,-0.2058823529411765,-20
2005-04-24,Man United,Newcastle,2,1,H,33,67,75,29,0.6052631578947368,48,20,28,0.5757575757575758,32,38,56,12,0.34210526315789475,42,51,-9,0.28125,0,0,0,0,0,0,1,0,0.2,0.2,29,19,17,0.2631578947368421,0.2945075757575758,37
2005-04-24,Portsmouth,Southampton,4,1,H,34,35,45,-7,0.3157894736842105,38,53,-15,0.2647058823529412,34,28,47,-1,0.3157894736842105,37,55,-18,0.14705882352941177,0,0,0,0,0,0,0,0,0.2,0.2,7,-2,-6,0.0,0.11764705882352941,3
2005-04-25,Arsenal,Tottenham,1,0,H,33,71,90,47,0.6842105263157895,73,33,40,0.6363636363636364,34,48,45,-10,0.34210526315789475,42,38,4,0.38235294117647056,0,0,0,0,0,0,0,0,0.8,0.4,23,45,57,0.34210526315789475,0.2540106951871658,36
2005-04-26,West Brom,Blackburn,1,1,D,34,29,-1,-1,0.0,32,57,-25,0.14705882352941177,34,40,44,-8,0.3157894736842105,29,37,-8,0.2647058823529412,0,0,0,0,0,0,0,0,0.4,0.4,-11,-45,7,-0.3157894736842105,-0.11764705882352941,-17
2005-04-27,Newcastle,Middlesbrough,0,0,D,33,38,56,12,0.34210526315789475,43,53,-10,0.2727272727272727,34,49,48,-8,0.34210526315789475,50,44,6,0.38235294117647056,0,0,1,0,0,0,0,0,0.0,0.4,-11,8,20,0.0,-0.10962566844919786,-16
2005-04-30,Birmingham,Blackburn,2,1,H,35,39,50,-5,0.3157894736842105,36,43,-7,0.2571428571428571,35,41,44,-8,0.3157894736842105,30,38,-8,0.2571428571428571,0,0,0,0,0,0,0,0,0.0,0.4,-2,6,3,0.0,0.0,1
2005-04-30,Bolton,Chelsea,0,2,A,35,54,53,-8,0.3684210526315789,45,39,6,0.42857142857142855,34,85,79,37,0.631578947368421,65,13,52,0.7647058823529411,0,0,0,0,0,0,0,0,0.4,0.6,-31,-26,-45,-0.2631578947368421,-0.3361344537815126,-46
2005-04-30,Fulham,Everton,2,0,H,34,35,52,6,0.3684210526315789,40,56,-16,0.2647058823529412,34,58,39,-12,0.2368421052631579,41,34,7,0.5,0,0,0,0,0,0,0,0,0.2,0.4,-23,13,18,0.13157894736842102,-0.23529411764705882,-23
2005-04-30,Liverpool,Middlesbrough,1,1,D,35,54,60,18,0.42105263157894735,48,36,12,0.45714285714285713,35,50,48,-8,0.34210526315789475,50,44,6,0.37142857142857144,0,0,0,0,0,0,0,0,0.4,0.4,4,12,26,0.0789473684210526,0.08571428571428569,6
2005-04-30,Man City,Portsmouth,2,0,H,35,45,41,1,0.2368421052631579,42,37,5,0.3142857142857143,35,38,45,-7,0.3157894736842105,42,54,-12,0.2857142857142857,0,0,0,0,0,0,0,0,0.4,0.4,7,-4,8,-0.0789473684210526,0.02857142857142858,17
2005-04-30,Newcastle,Crystal Palace,0,0,D,34,39,56,12,0.34210526315789475,43,53,-10,0.2647058823529412,35,30,-1,-1,0.0,37,58,-21,0.2,0,0,0,0,0,0,0,0,0.0,0.2,9,57,13,0.34210526315789475,0.06470588235294117,11
2005-04-30,Southampton,Norwich,4,3,H,35,28,47,-1,0.3157894736842105,38,59,-21,0.14285714285714285,35,30,-1,-1,0.0,38,67,-29,0.17142857142857143,0,0,0,0,0,0,0,0,0.0,0.6,-2,48,0,0.3157894736842105,-0.02857142857142858,8
2005-05-01,Charlton,Man United,0,4,A,35,45,53,0,0.3684210526315789,40,51,-11,0.34285714285714286,34,70,75,29,0.6052631578947368,50,21,29,0.5882352941176471,0,0,0,0,0,0,0,0,0.0,0.4,-25,-22,-29,-0.2368421052631579,-0.24537815126050422,-40
2005-05-01,Tottenham,Aston Villa,5,1,H,35,48,45,-10,0.34210526315789475,42,39,3,0.37142857142857144,35,47,56,4,0.3947368421052632,42,43,-1,0.34285714285714286,0,0,0,0,0,0,0,0,0.2,0.4,1,-11,-14,-0.052631578947368474,0.02857142857142858,4
2005-05-02,West Brom,Arsenal,0,2,A,35,30,-1,-1,0.0,33,58,-25,0.14285714285714285,34,74,90,47,0.6842105263157895,74,33,41,0.6470588235294118,0,0,0,0,0,0,0,0,0.2,0.8,-44,-91,-48,-0.6842105263157895,-0.5042016806722689,-66
2005-05-04,Fulham,Newcastle,1,3,A,35,38,52,6,0.3684210526315789,42,56,-14,0.2857142857142857,35,40,56,12,0.34210526315789475,43,53,-10,0.2571428571428571,0,0,0,0,0,0,0,0,0.2,0.0,-2,-4,-6,0.02631578947368418,0.02857142857142858,-4
2005-05-07,Aston Villa,Man City,1,2,A,36,47,56,4,0.3947368421052632,43,48,-5,0.3333333333333333,36,48,41,1,0.2368421052631579,44,37,7,0.3333333333333333,0,0,0,0,0,0,0,0,0.2,0.6,-1,15,3,0.1578947368421053,0.0,-12
2005-05-07,Blackburn,Fulham,1,3,A,36,41,44,-8,0.3157894736842105,31,40,-9,0.25,36,38,52,6,0.3684210526315789,43,59,-16,0.2777777777777778,0,0,0,0,0,0,0,0,0.4,0.2,3,-8,-14,-0.05263157894736842,-0.02777777777777779,7
2005-05-07,Chelsea,Charlton,1,0,H,35,88,79,37,0.631578947368421,67,13,54,0.7714285714285715,36,45,53,0,0.3684210526315789,40,55,-15,0.3333333333333333,0,0,0,0,0,0,0,0,0.6,0.0,43,26,37,0.2631578947368421,0.43809523809523815,69
2005-05-07,Crystal Palace,Southampton,2,2,D,36,31,-1,-1,0.0,37,58,-21,0.19444444444444445,36,31,47,-1,0.3157894736842105,42,62,-20,0.16666666666666666,0,0,0,0,0,0,0,0,0.2,0.2,0,-48,0,-0.3157894736842105,0.02777777777777779,-1
2005-05-07,Everton,Newcastle,2,0,H,35,58,39,-12,0.2368421052631579,41,36,5,0.4857142857142857,36,43,56,12,0.34210526315789475,46,54,-8,0.2777777777777778,0,0,0,0,0,0,0,0,0.4,0.2,15,-17,-24,-0.10526315789473684,0.20793650793650792,13
2005-05-07,Man United,West Brom,1,1,D,35,73,75,29,0.6052631578947368,54,21,33,0.6,36,30,-1,-1,0.0,33,60,-27,0.1388888888888889,0,0,0,0,0,0,0,0,0.4,0.0,43,76,30,0.6052631578947368,0.4611111111111111,60
2005-05-07,Middlesbrough,Tottenham,1,0,H,36,51,48,-8,0.34210526315789475,51,45,6,0.3611111111111111,36,51,45,-10,0.34210526315789475,47,40,7,0.3888888888888889,0,0,0,0,0,0,0,0,0.2,0.4,0,3,2,0.0,-0.02777777777777779,-1
2005-05-07,Norwich,Birmingham,1,0,H,36,30,-1,-1,0.0,41,71,-30,0.16666666666666666,36,42,50,-5,0.3157894736842105,38,44,-6,0.2777777777777778,0,0,0,0,0,0,0,0,0.6,0.2,-12,-51,4,-0.3157894736842105,-0.11111111111111113,-24
2005-05-07,Portsmouth,Bolton,1,1,D,36,38,45,-7,0.3157894736842105,42,56,-14,0.2777777777777778,36,54,53,-8,0.3684210526315789,45,41,4,0.4166666666666667,0,0,0,0,0,0,0,0,0.4,0.4,-16,-8,1,-0.05263157894736842,-0.1388888888888889,-18
2005-05-08,Arsenal,Liverpool,3,1,H,35,77,90,47,0.6842105263157895,76,33,43,0.6571428571428571,36,55,60,18,0.42105263157894735,49,37,12,0.4444444444444444,0,0,0,0,0,0,0,0,0.8,0.2,22,30,29,0.26315789473684215,0.21269841269841272,31
2005-05-10,Man United,Chelsea,1,3,A,36,74,75,29,0.6052631578947368,55,22,33,0.5833333333333334,36,91,79,37,0.631578947368421,68,13,55,0.7777777777777778,0,0,0,0,1,0,0,0,0.4,0.6,-17,-4,-8,-0.02631578947368418,-0.19444444444444442,-22
2005-05-11,Arsenal,Everton,7,0,H,36,80,90,47,0.6842105263157895,79,34,45,0.6666666666666666,36,61,39,-12,0.2368421052631579,43,36,7,0.5,1,0,0,0,0,0,0,0,0.8,0.6,19,51,59,0.4473684210526316,0.16666666666666663,38
2005-05-15,Birmingham,Arsenal,2,1,H,37,42,50,-5,0.3157894736842105,38,45,-7,0.2702702702702703,37,83,90,47,0.6842105263157895,86,34,52,0.6756756756756757,0,0,0,0,1,0,0,0,0.2,0.8,-41,-40,-52,-0.368421052631579,-0.4054054054054054,-59
2005-05-15,Bolton,Everton,3,2,H,37,55,53,-8,0.3684210526315789,46,42,4,0.40540540540540543,37,61,39,-12,0.2368421052631579,43,43,0,0.4864864864864865,0,0,0,0,0,0,0,0,0.2,0.4,-6,14,4,0.13157894736842102,-0.08108108108108109,4
2005-05-15,Charlton,Crystal Palace,2,2,D,37,45,53,0,0.3684210526315789,40,56,-16,0.32432432432432434,37,32,-1,-1,0.0,39,60,-21,0.1891891891891892,0,0,1,0,0,0,0,0,0.0,0.2,13,54,1,0.3684210526315789,0.13513513513513514,5
2005-05-15,Fulham,Norwich,6,0,H,37,41,52,6,0.3684210526315789,46,60,-14,0.2972972972972973,37,33,-1,-1,0.0,42,71,-29,0.1891891891891892,0,0,0,0,0,0,0,0,0.4,0.6,8,53,7,0.3684210526315789,0.10810810810810811,15
2005-05-15,Liverpool,Aston Villa,2,1,H,37,55,60,18,0.42105263157894735,50,40,10,0.43243243243243246,37,47,56,4,0.3947368421052632,44,50,-6,0.32432432432432434,0,0,0,0,0,0,0,0,0.2,0.2,8,4,14,0.026315789473684126,0.10810810810810811,16
2005-05-15,Man City,Middlesbrough,1,1,D,37,51,41,1,0.2368421052631579,46,38,8,0.35135135135135137,37,54,48,-8,0.34210526315789475,52,45,7,0.3783783783783784,0,0,0,0,0,0,0,0,0.6,0.4,-3,-7,9,-0.10526315789473684,-0.02702702702702703,1
2005-05-15,Newcastle,Chelsea,1,1,D,37,43,56,12,0.34210526315789475,46,56,-10,0.2702702702702703,37,94,79,37,0.631578947368421,71,14,57,0.7837837837837838,0,0,0,0,1,0,0,0,0.2,0.8,-51,-23,-25,-0.28947368421052627,-0.5135135135135135,-67
2005-05-15,Southampton,Man United,1,2,A,37,32,47,-1,0.3157894736842105,44,64,-20,0.16216216216216217,37,74,75,29,0.6052631578947368,56,25,31,0.5675675675675675,0,0,0,0,0,0,0,0,0.2,0.4,-42,-28,-30,-0.2894736842105263,-0.4054054054054054,-51
2005-05-15,Tottenham,Blackburn,0,0,D,37,51,45,-10,0.34210526315789475,47,41,6,0.3783783783783784,37,41,44,-8,0.3157894736842105,32,43,-11,0.24324324324324326,0,0,0,0,0,0,0,0,0.2,0.2,10,1,-2,0.026315789473684237,0.13513513513513514,17
2005-05-15,West Brom,Portsmouth,2,0,H,37,31,-1,-1,0.0,34,61,-27,0.13513513513513514,37,39,45,-7,0.3157894736842105,43,57,-14,0.2702702702702703,0,0,0,0,0,0,0,0,0.0,0.2,-8,-46,6,-0.3157894736842105,-0.13513513513513514,-13
