Date,HomeTeam,AwayTeam,FTHG,FTAG,FTR,HT_match_played,HT_current_standing,HT_past_standing,HT_past_goal_diff,HT_past_win_rate,HT_goal_for,HT_goal_against,HT_goal_diff,HT_win_rate_season,AT_match_played,AT_current_standing,AT_past_standing,AT_past_goal_diff,AT_past_win_rate,AT_goal_for,AT_goal_against,AT_goal_diff,AT_win_rate_season,HT_3_win_streak,HT_5_win_streak,HT_3_lose_Streak,HT_5_lose_Streak,AT_3_win_streak,AT_5_win_streak,AT_3_lose_Streak,AT_5_lose_Streak,HT_5_win_rate,AT_5_win_rate,current_standing_diff,past_standing_diff,past_goal_diff_diff,past_win_rate_diff,win_rate_season_diff,goal_diff_diff
2005-08-13,Aston Villa,Bolton,2,2,D,0,0,47,-7,0.3157894736842105,0,0,0,,0,0,58,5,0.42105263157894735,0,0,0,,0,0,0,0,0,0,0,0,,,0,-11,-12,-0.10526315789473684,,0
2005-08-13,Everton,Man United,0,2,A,0,0,61,-1,0.4736842105263158,0,0,0,,0,0,77,32,0.5789473684210527,0,0,0,,0,0,0,0,0,0,0,0,,,0,-16,-33,-0.10526315789473684,,0
2005-08-13,Fulham,Birmingham,0,0,D,0,0,44,-8,0.3157894736842105,0,0,0,,0,0,45,-6,0.2894736842105263,0,0,0,,0,0,0,0,0,0,0,0,,,0,-1,-2,0.02631578947368418,,0
2005-08-13,Man City,West Brom,0,0,D,0,0,52,8,0.34210526315789475,0,0,0,,0,0,34,-25,0.15789473684210525,0,0,0,,0,0,0,0,0,0,0,0,,,0,18,33,0.1842105263157895,,0
2005-08-13,Middlesbrough,Liverpool,0,0,D,0,0,55,7,0.3684210526315789,0,0,0,,0,0,58,11,0.4473684210526316,0,0,0,,0,0,0,0,0,0,0,0,,,0,-3,-4,-0.07894736842105265,,0
2005-08-13,Portsmouth,Tottenham,0,2,A,0,0,39,-16,0.2631578947368421,0,0,0,,0,0,52,6,0.3684210526315789,0,0,0,,0,0,0,0,0,0,0,0,,,0,-13,-22,-0.10526315789473684,,0
2005-08-13,Sunderland,Charlton,1,3,A,0,0,-1,-1,0.0,0,0,0,,0,0,46,-16,0.3157894736842105,0,0,0,,0,0,0,0,0,0,0,0,,,0,-47,15,-0.3157894736842105,,0
2005-08-13,West Ham,Blackburn,3,1,H,0,0,-1,-1,0.0,0,0,0,,0,0,42,-11,0.2368421052631579,0,0,0,,0,0,0,0,0,0,0,0,,,0,-43,10,-0.2368421052631579,,0
2005-08-14,Arsenal,Newcastle,2,0,H,0,0,83,51,0.6578947368421053,0,0,0,,0,0,44,-10,0.2631578947368421,0,0,0,,0,0,0,0,0,0,0,0,,,0,39,61,0.3947368421052632,,0
2005-08-14,Wigan,Chelsea,0,1,A,0,0,-1,-1,0.0,0,0,0,,0,0,95,57,0.7631578947368421,0,0,0,,0,0,0,0,0,0,0,0,,,0,-96,-58,-0.7631578947368421,,0
2005-08-20,Birmingham,Man City,1,2,A,1,1,45,-6,0.2894736842105263,0,0,0,0.0,1,1,52,8,0.34210526315789475,0,0,0,0.0,0,0,0,0,0,0,0,0,,,0,-7,-14,-0.05263157894736842,0.0,0
2005-08-20,Blackburn,Fulham,2,1,H,1,0,42,-11,0.2368421052631579,1,3,-2,0.0,1,1,44,-8,0.3157894736842105,0,0,0,0.0,0,0,0,0,0,0,0,0,,,-1,-2,-3,-0.0789473684210526,0.0,-2
2005-08-20,Charlton,Wigan,1,0,H,1,3,46,-16,0.3157894736842105,3,1,2,1.0,1,0,-1,-1,0.0,0,1,-1,0.0,0,0,0,0,0,0,0,0,,,3,47,-15,0.3157894736842105,1.0,3
2005-08-20,Liverpool,Sunderland,1,0,H,1,1,58,11,0.4473684210526316,0,0,0,0.0,1,0,-1,-1,0.0,1,3,-2,0.0,0,0,0,0,0,0,0,0,,,1,59,12,0.4473684210526316,0.0,2
2005-08-20,Man United,Aston Villa,1,0,H,1,3,77,32,0.5789473684210527,2,0,2,1.0,1,1,47,-7,0.3157894736842105,2,2,0,0.0,0,0,0,0,0,0,0,0,,,2,30,39,0.26315789473684215,1.0,2
2005-08-20,Newcastle,West Ham,0,0,D,1,0,44,-10,0.2631578947368421,0,2,-2,0.0,1,3,-1,-1,0.0,3,1,2,1.0,0,0,0,0,0,0,0,0,,,-3,45,-9,0.2631578947368421,-1.0,-4
2005-08-20,Tottenham,Middlesbrough,2,0,H,1,3,52,6,0.3684210526315789,2,0,2,1.0,1,1,55,7,0.3684210526315789,0,0,0,0.0,0,0,0,0,0,0,0,0,,,2,-3,-1,0.0,1.0,2
2005-08-20,West Brom,Portsmouth,2,1,H,1,1,34,-25,0.15789473684210525,0,0,0,0.0,1,0,39,-16,0.2631578947368421,0,2,-2,0.0,0,0,0,0,0,0,0,0,,,1,-5,-9,-0.10526315789473684,0.0,2
2005-08-21,Bolton,Everton,0,1,A,1,1,58,5,0.42105263157894735,2,2,0,0.0,1,0,61,-1,0.4736842105263158,0,2,-2,0.0,0,0,0,0,0,0,0,0,,,1,-3,6,-0.052631578947368474,0.0,2
2005-08-21,Chelsea,Arsenal,1,0,H,1,3,95,57,0.7631578947368421,1,0,1,1.0,1,3,83,51,0.6578947368421053,2,0,2,1.0,0,0,0,0,0,0,0,0,,,0,12,6,0.10526315789473684,0.0,-1
2005-08-23,Birmingham,Middlesbrough,0,3,A,2,1,45,-6,0.2894736842105263,1,2,-1,0.0,2,1,55,7,0.3684210526315789,0,2,-2,0.0,0,0,0,0,0,0,0,0,,,0,-10,-13,-0.0789473684210526,0.0,1
2005-08-23,Portsmouth,Aston Villa,1,1,D,2,0,39,-16,0.2631578947368421,1,4,-3,0.0,2,1,47,-7,0.3157894736842105,2,3,-1,0.0,0,0,0,0,0,0,0,0,,,-1,-8,-9,-0.05263157894736842,0.0,-2
2005-08-23,Sunderland,Man City,1,2,A,2,0,-1,-1,0.0,1,4,-3,0.0,2,4,52,8,0.34210526315789475,2,1,1,0.5,0,0,0,0,0,0,0,0,,,-4,-53,-9,-0.34210526315789475,-0.5,-4
2005-08-24,Arsenal,Fulham,4,1,H,2,3,83,51,0.6578947368421053,2,1,1,0.5,2,1,44,-8,0.3157894736842105,1,2,-1,0.0,0,0,0,0,0,0,0,0,,,2,39,59,0.3421052631578948,0.5,2
2005-08-24,Blackburn,Tottenham,0,0,D,2,3,42,-11,0.2368421052631579,3,4,-1,0.5,2,6,52,6,0.3684210526315789,4,0,4,1.0,0,0,0,0,0,0,0,0,,,-3,-10,-17,-0.13157894736842102,-0.5,-5
2005-08-24,Bolton,Newcastle,2,0,H,2,1,58,5,0.42105263157894735,2,3,-1,0.0,2,1,44,-10,0.2631578947368421,0,2,-2,0.0,0,0,0,0,0,0,0,0,,,0,14,15,0.15789473684210525,0.0,1
2005-08-24,Chelsea,West Brom,4,0,H,2,6,95,57,0.7631578947368421,2,0,2,1.0,2,4,34,-25,0.15789473684210525,2,1,1,0.5,0,0,0,0,0,0,0,0,,,2,61,82,0.605263157894737,0.5,1
2005-08-27,Aston Villa,Blackburn,1,0,H,3,2,47,-7,0.3157894736842105,3,4,-1,0.0,3,4,42,-11,0.2368421052631579,3,4,-1,0.3333333333333333,0,0,0,0,0,0,0,0,,,-2,5,4,0.0789473684210526,-0.3333333333333333,0
2005-08-27,Fulham,Everton,1,0,H,3,1,44,-8,0.3157894736842105,2,6,-4,0.0,2,3,61,-1,0.4736842105263158,1,2,-1,0.5,0,0,0,0,0,0,0,0,,,-2,-17,-7,-0.1578947368421053,-0.5,-3
2005-08-27,Man City,Portsmouth,2,1,H,3,7,52,8,0.34210526315789475,4,2,2,0.6666666666666666,3,1,39,-16,0.2631578947368421,2,5,-3,0.0,0,0,0,0,0,0,0,0,,,6,13,24,0.07894736842105265,0.6666666666666666,5
2005-08-27,Tottenham,Chelsea,0,2,A,3,7,52,6,0.3684210526315789,4,0,4,0.6666666666666666,3,9,95,57,0.7631578947368421,6,0,6,1.0,0,0,0,0,0,0,0,0,,,-2,-43,-51,-0.3947368421052632,-0.33333333333333337,-2
2005-08-27,West Brom,Birmingham,2,3,A,3,4,34,-25,0.15789473684210525,2,5,-3,0.3333333333333333,3,1,45,-6,0.2894736842105263,1,5,-4,0.0,0,0,0,0,0,0,0,0,,,3,-11,-19,-0.13157894736842107,0.3333333333333333,1
2005-08-27,West Ham,Bolton,1,2,A,2,4,-1,-1,0.0,3,1,2,0.5,3,4,58,5,0.42105263157894735,4,3,1,0.3333333333333333,0,0,0,0,0,0,0,0,,,0,-59,-6,-0.42105263157894735,0.16666666666666669,1
2005-08-27,Wigan,Sunderland,1,0,H,2,0,-1,-1,0.0,0,2,-2,0.0,3,0,-1,-1,0.0,2,6,-4,0.0,0,0,0,0,0,0,0,0,,,0,0,0,0.0,0.0,2
2005-08-28,Middlesbrough,Charlton,0,3,A,3,4,55,7,0.3684210526315789,3,2,1,0.3333333333333333,2,6,46,-16,0.3157894736842105,4,1,3,1.0,0,0,0,0,0,0,0,0,,,-2,9,23,0.05263157894736842,-0.6666666666666667,-2
2005-08-28,Newcastle,Man United,0,2,A,3,1,44,-10,0.2631578947368421,0,4,-4,0.0,2,6,77,32,0.5789473684210527,3,0,3,1.0,0,0,0,0,0,0,0,0,,,-5,-33,-42,-0.31578947368421056,-1.0,-7
2005-09-10,Birmingham,Charlton,0,1,A,4,4,45,-6,0.2894736842105263,4,7,-3,0.25,3,9,46,-16,0.3157894736842105,7,1,6,1.0,0,0,0,0,0,0,0,0,,,-5,-1,10,-0.02631578947368418,-0.75,-9
2005-09-10,Chelsea,Sunderland,2,0,H,4,12,95,57,0.7631578947368421,8,0,8,1.0,4,0,-1,-1,0.0,2,7,-5,0.0,1,0,0,0,0,0,1,0,,,12,96,58,0.7631578947368421,1.0,13
2005-09-10,Everton,Portsmouth,0,1,A,3,3,61,-1,0.4736842105263158,1,3,-2,0.3333333333333333,4,1,39,-16,0.2631578947368421,3,7,-4,0.0,0,0,0,0,0,0,0,0,,,2,22,15,0.21052631578947373,0.3333333333333333,2
2005-09-10,Man United,Man City,1,1,D,3,9,77,32,0.5789473684210527,5,0,5,1.0,4,10,52,8,0.34210526315789475,6,3,3,0.75,0,0,0,0,1,0,0,0,,,-1,25,24,0.2368421052631579,0.25,2
2005-09-10,Middlesbrough,Arsenal,2,1,H,4,4,55,7,0.3684210526315789,3,5,-2,0.25,3,6,83,51,0.6578947368421053,6,2,4,0.6666666666666666,0,0,0,0,0,0,0,0,,,-2,-28,-44,-0.2894736842105264,-0.41666666666666663,-6
2005-09-10,Newcastle,Fulham,1,1,D,4,1,44,-10,0.2631578947368421,0,6,-6,0.0,4,4,44,-8,0.3157894736842105,3,6,-3,0.25,0,0,0,0,0,0,0,0,,,-3,0,-2,-0.05263157894736842,-0.25,-3
2005-09-10,Tottenham,Liverpool,0,0,D,4,7,52,6,0.3684210526315789,4,2,2,0.5,2,4,58,11,0.4473684210526316,1,0,1,0.5,0,0,0,0,0,0,0,0,,,3,-6,-5,-0.07894736842105265,0.0,1
2005-09-10,West Brom,Wigan,1,2,A,4,4,34,-25,0.15789473684210525,4,8,-4,0.25,3,3,-1,-1,0.0,1,2,-1,0.3333333333333333,0,0,0,0,0,0,0,0,,,1,35,-24,0.15789473684210525,-0.08333333333333331,-3
2005-09-11,Bolton,Blackburn,0,0,D,4,7,58,5,0.42105263157894735,6,4,2,0.5,4,4,42,-11,0.2368421052631579,3,5,-2,0.25,0,0,0,0,0,0,0,0,,,3,16,16,0.18421052631578944,0.25,4
2005-09-12,West Ham,Aston Villa,4,0,H,3,4,-1,-1,0.0,4,3,1,0.3333333333333333,4,5,47,-7,0.3157894736842105,4,4,0,0.25,0,0,0,0,0,0,0,0,,,-1,-48,6,-0.3157894736842105,0.08333333333333331,1
2005-09-17,Aston Villa,Tottenham,1,1,D,5,5,47,-7,0.3157894736842105,4,8,-4,0.2,5,8,52,6,0.3684210526315789,4,2,2,0.4,0,0,0,0,0,0,0,0,0.2,0.4,-3,-5,-13,-0.05263157894736842,-0.2,-6
2005-09-17,Charlton,Chelsea,0,2,A,4,12,46,-16,0.3157894736842105,8,1,7,1.0,5,15,95,57,0.7631578947368421,10,0,10,1.0,1,0,0,0,1,1,0,0,,1.0,-3,-49,-73,-0.44736842105263164,0.0,-3
2005-09-17,Fulham,West Ham,1,2,A,5,5,44,-8,0.3157894736842105,4,7,-3,0.2,4,7,-1,-1,0.0,8,3,5,0.5,0,0,0,0,0,0,0,0,0.2,,-2,45,-7,0.3157894736842105,-0.3,-8
2005-09-17,Portsmouth,Birmingham,1,1,D,5,4,39,-16,0.2631578947368421,4,7,-3,0.2,5,4,45,-6,0.2894736842105263,4,8,-4,0.2,0,0,0,0,0,0,0,0,0.2,0.2,0,-6,-10,-0.026315789473684237,0.0,1
2005-09-17,Sunderland,West Brom,1,1,D,5,0,-1,-1,0.0,2,9,-7,0.0,5,4,34,-25,0.15789473684210525,5,10,-5,0.2,0,0,1,1,0,0,1,0,0.0,0.2,-4,-35,24,-0.15789473684210525,-0.2,-2
2005-09-18,Blackburn,Newcastle,0,3,A,5,5,42,-11,0.2368421052631579,3,5,-2,0.2,5,2,44,-10,0.2631578947368421,1,7,-6,0.0,0,0,0,0,0,0,0,0,0.2,0.0,3,-2,-1,-0.02631578947368418,0.2,4
2005-09-18,Liverpool,Man United,0,0,D,3,5,58,11,0.4473684210526316,1,0,1,0.3333333333333333,4,10,77,32,0.5789473684210527,6,1,5,0.75,0,0,0,0,0,0,0,0,,,-5,-19,-21,-0.13157894736842107,-0.4166666666666667,-4
2005-09-18,Man City,Bolton,0,1,A,5,11,52,8,0.34210526315789475,7,4,3,0.6,5,8,58,5,0.42105263157894735,6,4,2,0.4,0,0,0,0,0,0,0,0,0.6,0.4,3,-6,3,-0.0789473684210526,0.19999999999999996,1
2005-09-18,Wigan,Middlesbrough,1,1,D,4,6,-1,-1,0.0,3,3,0,0.5,5,7,55,7,0.3684210526315789,5,6,-1,0.4,0,0,0,0,0,0,0,0,,0.4,-1,-56,-8,-0.3684210526315789,0.09999999999999998,1
2005-09-19,Arsenal,Everton,2,0,H,4,6,83,51,0.6578947368421053,7,4,3,0.5,4,3,61,-1,0.4736842105263158,1,4,-3,0.25,0,0,0,0,0,0,0,0,,,3,22,52,0.1842105263157895,0.25,6
2005-09-24,Birmingham,Liverpool,2,2,D,6,5,45,-6,0.2894736842105263,5,9,-4,0.16666666666666666,4,6,58,11,0.4473684210526316,1,0,1,0.25,0,0,0,0,0,0,0,0,0.2,,-1,-13,-17,-0.15789473684210525,-0.08333333333333334,-5
2005-09-24,Bolton,Portsmouth,1,0,H,6,11,58,5,0.42105263157894735,7,4,3,0.5,6,5,39,-16,0.2631578947368421,5,8,-3,0.16666666666666666,0,0,0,0,0,0,0,0,0.6,0.2,6,19,21,0.15789473684210525,0.33333333333333337,6
2005-09-24,Chelsea,Aston Villa,2,1,H,6,18,95,57,0.7631578947368421,12,0,12,1.0,6,6,47,-7,0.3157894736842105,5,9,-4,0.16666666666666666,1,1,0,0,0,0,0,0,1.0,0.2,12,48,64,0.44736842105263164,0.8333333333333334,16
2005-09-24,Everton,Wigan,0,1,A,5,3,61,-1,0.4736842105263158,1,6,-5,0.2,5,7,-1,-1,0.0,4,4,0,0.4,0,0,1,0,0,0,0,0,0.2,0.4,-4,62,0,0.4736842105263158,-0.2,-5
2005-09-24,Man United,Blackburn,1,2,A,5,11,77,32,0.5789473684210527,6,1,5,0.6,6,5,42,-11,0.2368421052631579,3,8,-5,0.16666666666666666,0,0,0,0,0,0,0,0,0.6,0.2,6,35,43,0.34210526315789475,0.43333333333333335,10
2005-09-24,Newcastle,Man City,1,0,H,6,5,44,-10,0.2631578947368421,4,7,-3,0.16666666666666666,6,11,52,8,0.34210526315789475,7,5,2,0.5,0,0,0,0,0,0,0,0,0.2,0.6,-6,-8,-18,-0.07894736842105265,-0.33333333333333337,-5
2005-09-24,West Brom,Charlton,1,2,A,6,5,34,-25,0.15789473684210525,6,11,-5,0.16666666666666666,5,12,46,-16,0.3157894736842105,8,3,5,0.8,0,0,0,0,0,0,0,0,0.2,0.8,-7,-12,-9,-0.15789473684210525,-0.6333333333333334,-10
2005-09-24,West Ham,Arsenal,0,0,D,5,10,-1,-1,0.0,10,4,6,0.6,5,9,83,51,0.6578947368421053,9,4,5,0.6,0,0,0,0,0,0,0,0,0.6,0.6,1,-84,-52,-0.6578947368421053,0.0,1
2005-09-25,Middlesbrough,Sunderland,0,2,A,6,8,55,7,0.3684210526315789,6,7,-1,0.3333333333333333,6,1,-1,-1,0.0,3,10,-7,0.0,0,0,0,0,0,0,0,0,0.4,0.0,7,56,8,0.3684210526315789,0.3333333333333333,6
2005-09-26,Tottenham,Fulham,1,0,H,6,9,52,6,0.3684210526315789,5,3,2,0.3333333333333333,6,5,44,-8,0.3157894736842105,5,9,-4,0.16666666666666666,0,0,0,0,0,0,0,0,0.2,0.2,4,8,14,0.05263157894736842,0.16666666666666666,6
2005-10-01,Blackburn,West Brom,2,0,H,7,8,42,-11,0.2368421052631579,5,9,-4,0.2857142857142857,7,5,34,-25,0.15789473684210525,7,13,-6,0.14285714285714285,0,0,0,0,0,0,0,0,0.2,0.0,3,8,14,0.07894736842105265,0.14285714285714285,2
2005-10-01,Charlton,Tottenham,2,3,A,6,15,46,-16,0.3157894736842105,10,4,6,0.8333333333333334,7,12,52,6,0.3684210526315789,6,3,3,0.42857142857142855,0,0,0,0,0,0,0,0,0.8,0.2,3,-6,-22,-0.05263157894736842,0.4047619047619048,3
2005-10-01,Fulham,Man United,2,3,A,7,5,44,-8,0.3157894736842105,5,10,-5,0.14285714285714285,6,11,77,32,0.5789473684210527,7,3,4,0.5,0,0,0,0,0,0,0,0,0.2,0.4,-6,-33,-40,-0.26315789473684215,-0.35714285714285715,-9
2005-10-01,Portsmouth,Newcastle,0,0,D,7,5,39,-16,0.2631578947368421,5,9,-4,0.14285714285714285,7,8,44,-10,0.2631578947368421,5,7,-2,0.2857142857142857,0,0,0,0,0,0,0,0,0.2,0.4,-3,-5,-6,0.0,-0.14285714285714285,-2
2005-10-01,Sunderland,West Ham,1,1,D,7,4,-1,-1,0.0,5,10,-5,0.14285714285714285,6,11,-1,-1,0.0,10,4,6,0.5,0,0,0,0,0,0,0,0,0.2,0.4,-7,0,0,0.0,-0.35714285714285715,-11
2005-10-02,Arsenal,Birmingham,1,0,H,6,10,83,51,0.6578947368421053,9,4,5,0.5,7,6,45,-6,0.2894736842105263,7,11,-4,0.14285714285714285,0,0,0,0,0,0,0,0,0.4,0.2,4,38,57,0.368421052631579,0.35714285714285715,9
2005-10-02,Aston Villa,Middlesbrough,2,3,A,7,6,47,-7,0.3157894736842105,6,11,-5,0.14285714285714285,7,8,55,7,0.3684210526315789,6,9,-3,0.2857142857142857,0,0,0,0,0,0,0,0,0.2,0.4,-2,-8,-14,-0.05263157894736842,-0.14285714285714285,-2
2005-10-02,Liverpool,Chelsea,1,4,A,5,7,58,11,0.4473684210526316,3,2,1,0.2,7,21,95,57,0.7631578947368421,14,1,13,1.0,0,0,0,0,1,1,0,0,0.2,1.0,-14,-37,-46,-0.31578947368421056,-0.8,-12
2005-10-02,Man City,Everton,2,0,H,7,11,52,8,0.34210526315789475,7,6,1,0.42857142857142855,6,3,61,-1,0.4736842105263158,1,7,-6,0.16666666666666666,0,0,0,0,0,0,1,0,0.4,0.2,8,-9,9,-0.13157894736842107,0.26190476190476186,7
2005-10-02,Wigan,Bolton,2,1,H,6,10,-1,-1,0.0,5,4,1,0.5,7,14,58,5,0.42105263157894735,8,4,4,0.5714285714285714,0,0,0,0,0,0,0,0,0.6,0.8,-4,-59,-6,-0.42105263157894735,-0.0714285714285714,-3
2005-10-15,Chelsea,Bolton,5,1,H,8,24,95,57,0.7631578947368421,18,2,16,1.0,8,14,58,5,0.42105263157894735,9,6,3,0.5,1,1,0,0,0,0,0,0,1.0,0.6,10,37,52,0.3421052631578948,0.5,13
2005-10-15,Liverpool,Blackburn,1,0,H,6,7,58,11,0.4473684210526316,4,6,-2,0.16666666666666666,8,11,42,-11,0.2368421052631579,7,9,-2,0.375,0,0,0,0,0,0,0,0,0.2,0.4,-4,16,22,0.21052631578947367,-0.20833333333333334,0
2005-10-15,Middlesbrough,Portsmouth,1,1,D,8,11,55,7,0.3684210526315789,9,11,-2,0.375,8,6,39,-16,0.2631578947368421,5,9,-4,0.125,0,0,0,0,0,0,0,0,0.4,0.2,5,16,23,0.10526315789473684,0.25,2
2005-10-15,Sunderland,Man United,1,3,A,8,5,-1,-1,0.0,6,11,-5,0.125,7,14,77,32,0.5789473684210527,10,5,5,0.5714285714285714,0,0,0,0,0,0,0,0,0.2,0.4,-9,-78,-33,-0.5789473684210527,-0.4464285714285714,-10
2005-10-15,Tottenham,Everton,2,0,H,8,15,52,6,0.3684210526315789,9,5,4,0.5,7,3,61,-1,0.4736842105263158,1,9,-8,0.14285714285714285,0,0,0,0,0,0,1,1,0.4,0.0,12,-9,7,-0.10526315789473689,0.35714285714285715,12
2005-10-15,West Brom,Arsenal,2,1,H,8,5,34,-25,0.15789473684210525,7,15,-8,0.125,7,13,83,51,0.6578947368421053,10,4,6,0.5714285714285714,0,0,0,0,0,0,0,0,0.0,0.6,-8,-49,-76,-0.5,-0.4464285714285714,-14
2005-10-15,Wigan,Newcastle,1,0,H,7,13,-1,-1,0.0,7,5,2,0.5714285714285714,8,9,44,-10,0.2631578947368421,5,7,-2,0.25,0,0,0,0,0,0,0,0,0.8,0.4,4,-45,9,-0.2631578947368421,0.3214285714285714,4
2005-10-16,Birmingham,Aston Villa,0,1,A,8,6,45,-6,0.2894736842105263,7,12,-5,0.125,8,6,47,-7,0.3157894736842105,8,14,-6,0.125,0,0,0,0,0,0,0,0,0.2,0.2,0,-2,1,-0.02631578947368418,0.0,1
2005-10-16,Man City,West Ham,2,1,H,8,14,52,8,0.34210526315789475,9,6,3,0.5,7,12,-1,-1,0.0,11,5,6,0.42857142857142855,0,0,0,0,0,0,0,0,0.4,0.4,2,53,9,0.34210526315789475,0.07142857142857145,-3
2005-10-17,Charlton,Fulham,1,1,D,7,15,46,-16,0.3157894736842105,12,7,5,0.7142857142857143,8,5,44,-8,0.3157894736842105,7,13,-6,0.125,0,0,0,0,0,0,1,0,0.6,0.2,10,2,-8,0.0,0.5892857142857143,11
2005-10-22,Arsenal,Man City,1,0,H,8,13,83,51,0.6578947368421053,11,6,5,0.5,9,17,52,8,0.34210526315789475,11,7,4,0.5555555555555556,0,0,0,0,0,0,0,0,0.4,0.4,-4,31,43,0.31578947368421056,-0.05555555555555558,1
2005-10-22,Aston Villa,Wigan,0,2,A,9,9,47,-7,0.3157894736842105,9,14,-5,0.2222222222222222,8,16,-1,-1,0.0,8,5,3,0.625,0,0,0,0,1,0,0,0,0.2,0.8,-7,48,-6,0.3157894736842105,-0.4027777777777778,-8
2005-10-22,Blackburn,Birmingham,2,0,H,9,11,42,-11,0.2368421052631579,7,10,-3,0.3333333333333333,9,6,45,-6,0.2894736842105263,7,13,-6,0.1111111111111111,0,0,0,0,0,0,0,0,0.4,0.0,5,-3,-5,-0.05263157894736842,0.2222222222222222,3
2005-10-22,Fulham,Liverpool,2,0,H,9,6,44,-8,0.3157894736842105,8,14,-6,0.1111111111111111,7,10,58,11,0.4473684210526316,5,6,-1,0.2857142857142857,0,0,0,0,0,0,0,0,0.0,0.2,-4,-14,-19,-0.13157894736842107,-0.1746031746031746,-5
2005-10-22,Man United,Tottenham,1,1,D,8,17,77,32,0.5789473684210527,13,6,7,0.625,9,18,52,6,0.3684210526315789,11,5,6,0.5555555555555556,0,0,0,0,1,0,0,0,0.4,0.6,-1,25,26,0.21052631578947373,0.06944444444444442,1
2005-10-22,Portsmouth,Charlton,1,2,A,9,7,39,-16,0.2631578947368421,6,10,-4,0.1111111111111111,8,16,46,-16,0.3157894736842105,13,8,5,0.625,0,0,0,0,0,0,0,0,0.2,0.4,-9,-7,0,-0.05263157894736842,-0.5138888888888888,-9
2005-10-23,Bolton,West Brom,2,0,H,9,14,58,5,0.42105263157894735,10,11,-1,0.4444444444444444,9,8,34,-25,0.15789473684210525,9,16,-7,0.2222222222222222,0,0,0,0,0,0,0,0,0.4,0.2,6,24,30,0.2631578947368421,0.2222222222222222,6
2005-10-23,Everton,Chelsea,1,1,D,8,3,61,-1,0.4736842105263158,1,11,-10,0.125,9,27,95,57,0.7631578947368421,23,3,20,1.0,0,0,1,1,1,1,0,0,0.0,1.0,-24,-34,-58,-0.2894736842105263,-0.875,-30
2005-10-23,Newcastle,Sunderland,3,2,H,9,9,44,-10,0.2631578947368421,5,8,-3,0.2222222222222222,9,5,-1,-1,0.0,7,14,-7,0.1111111111111111,0,0,0,0,0,0,0,0,0.4,0.2,4,45,-9,0.2631578947368421,0.1111111111111111,4
2005-10-23,West Ham,Middlesbrough,2,1,H,8,12,-1,-1,0.0,12,7,5,0.375,9,12,55,7,0.3684210526315789,10,12,-2,0.3333333333333333,0,0,0,0,0,0,0,0,0.4,0.4,0,-56,-8,-0.3684210526315789,0.041666666666666685,7
2005-10-29,Birmingham,Everton,0,1,A,10,6,45,-6,0.2894736842105263,7,15,-8,0.1,9,4,61,-1,0.4736842105263158,2,12,-10,0.1111111111111111,0,0,1,0,0,0,0,0,0.0,0.0,2,-16,-5,-0.1842105263157895,-0.0111111111111111,2
2005-10-29,Charlton,Bolton,0,1,A,9,19,46,-16,0.3157894736842105,15,9,6,0.6666666666666666,10,17,58,5,0.42105263157894735,12,11,1,0.5,0,0,0,0,0,0,0,0,0.4,0.6,2,-12,-21,-0.10526315789473684,0.16666666666666663,5
2005-10-29,Chelsea,Blackburn,4,2,H,10,28,95,57,0.7631578947368421,24,4,20,0.9,10,14,42,-11,0.2368421052631579,9,10,-1,0.4,0,0,0,0,0,0,0,0,0.8,0.6,14,53,68,0.5263157894736843,0.5,21
2005-10-29,Liverpool,West Ham,2,0,H,8,10,58,11,0.4473684210526316,5,8,-3,0.25,9,15,-1,-1,0.0,14,8,6,0.4444444444444444,0,0,0,0,0,0,0,0,0.2,0.4,-5,59,12,0.4473684210526316,-0.19444444444444442,-9
2005-10-29,Middlesbrough,Man United,4,1,H,10,12,55,7,0.3684210526315789,11,14,-3,0.3,9,18,77,32,0.5789473684210527,14,7,7,0.5555555555555556,0,0,0,0,0,0,0,0,0.2,0.4,-6,-22,-25,-0.21052631578947373,-0.2555555555555556,-10
2005-10-29,Sunderland,Portsmouth,1,4,A,10,5,-1,-1,0.0,9,17,-8,0.1,10,7,39,-16,0.2631578947368421,7,12,-5,0.1,0,0,0,0,0,0,0,0,0.2,0.0,-2,-40,15,-0.2631578947368421,0.0,-3
2005-10-29,Tottenham,Arsenal,1,1,D,10,19,52,6,0.3684210526315789,12,6,6,0.5,9,16,83,51,0.6578947368421053,12,6,6,0.5555555555555556,0,0,0,0,0,0,0,0,0.6,0.6,3,-31,-45,-0.2894736842105264,-0.05555555555555558,0
2005-10-29,Wigan,Fulham,1,0,H,9,19,-1,-1,0.0,10,5,5,0.6666666666666666,10,9,44,-8,0.3157894736842105,10,14,-4,0.2,1,0,0,0,0,0,0,0,0.8,0.2,10,-45,7,-0.3157894736842105,0.4666666666666666,9
2005-10-30,West Brom,Newcastle,0,3,A,10,8,34,-25,0.15789473684210525,9,18,-9,0.2,10,12,44,-10,0.2631578947368421,8,10,-2,0.3,0,0,0,0,0,0,0,0,0.2,0.6,-4,-10,-15,-0.10526315789473684,-0.09999999999999998,-7
2005-10-31,Man City,Aston Villa,3,1,H,10,17,52,8,0.34210526315789475,11,8,3,0.5,10,9,47,-7,0.3157894736842105,9,16,-7,0.2,0,0,0,0,0,0,0,0,0.4,0.2,8,5,15,0.026315789473684237,0.3,10
2005-11-05,Arsenal,Sunderland,3,1,H,10,17,83,51,0.6578947368421053,13,7,6,0.5,11,5,-1,-1,0.0,10,21,-11,0.09090909090909091,0,0,0,0,0,0,1,0,0.4,0.2,12,84,52,0.6578947368421053,0.40909090909090906,17
2005-11-05,Aston Villa,Liverpool,0,2,A,11,9,47,-7,0.3157894736842105,10,19,-9,0.18181818181818182,9,13,58,11,0.4473684210526316,7,8,-1,0.3333333333333333,0,0,0,0,0,0,0,0,0.2,0.4,-4,-11,-18,-0.13157894736842107,-0.1515151515151515,-8
2005-11-05,Blackburn,Charlton,4,1,H,11,14,42,-11,0.2368421052631579,11,14,-3,0.36363636363636365,10,19,46,-16,0.3157894736842105,15,10,5,0.6,0,0,0,0,0,0,0,0,0.6,0.4,-5,-4,5,-0.0789473684210526,-0.23636363636363633,-8
2005-11-05,Fulham,Man City,2,1,H,11,9,44,-8,0.3157894736842105,10,15,-5,0.18181818181818182,11,20,52,8,0.34210526315789475,14,9,5,0.5454545454545454,0,0,0,0,0,0,0,0,0.2,0.6,-11,-8,-16,-0.026315789473684237,-0.3636363636363636,-10
2005-11-05,Newcastle,Birmingham,1,0,H,11,15,44,-10,0.2631578947368421,11,10,1,0.36363636363636365,11,6,45,-6,0.2894736842105263,7,16,-9,0.09090909090909091,0,0,0,0,0,0,1,0,0.6,0.0,9,-1,-4,-0.026315789473684237,0.2727272727272727,10
2005-11-05,Portsmouth,Wigan,0,2,A,11,10,39,-16,0.2631578947368421,11,13,-2,0.18181818181818182,10,22,-1,-1,0.0,11,5,6,0.7,0,0,0,0,1,1,0,0,0.2,1.0,-12,40,-15,0.2631578947368421,-0.5181818181818181,-8
2005-11-05,West Ham,West Brom,1,0,H,10,15,-1,-1,0.0,14,10,4,0.4,11,8,34,-25,0.15789473684210525,9,21,-12,0.18181818181818182,0,0,0,0,0,0,0,0,0.2,0.2,7,-35,24,-0.15789473684210525,0.2181818181818182,16
2005-11-06,Everton,Middlesbrough,1,0,H,10,7,61,-1,0.4736842105263158,3,12,-9,0.2,11,15,55,7,0.3684210526315789,15,15,0,0.36363636363636365,0,0,0,0,0,0,0,0,0.2,0.4,-8,6,-8,0.10526315789473689,-0.16363636363636364,-9
2005-11-06,Man United,Chelsea,1,0,H,10,18,77,32,0.5789473684210527,15,11,4,0.5,11,31,95,57,0.7631578947368421,28,6,22,0.9090909090909091,0,0,0,0,0,0,0,0,0.4,0.8,-13,-18,-25,-0.1842105263157895,-0.40909090909090906,-18
2005-11-07,Bolton,Tottenham,1,0,H,11,20,58,5,0.42105263157894735,13,11,2,0.5454545454545454,11,20,52,6,0.3684210526315789,13,7,6,0.45454545454545453,0,0,0,0,0,0,0,0,0.6,0.6,0,6,-1,0.05263157894736842,0.09090909090909088,-4
2005-11-19,Charlton,Man United,1,3,A,11,19,46,-16,0.3157894736842105,16,14,2,0.5454545454545454,11,21,77,32,0.5789473684210527,16,11,5,0.5454545454545454,0,0,0,0,0,0,0,0,0.2,0.6,-2,-31,-48,-0.26315789473684215,0.0,-3
2005-11-19,Chelsea,Newcastle,3,0,H,12,31,95,57,0.7631578947368421,28,7,21,0.8333333333333334,12,18,44,-10,0.2631578947368421,12,10,2,0.4166666666666667,0,0,0,0,1,0,0,0,0.6,0.6,13,51,67,0.5,0.4166666666666667,19
2005-11-19,Liverpool,Portsmouth,3,0,H,10,16,58,11,0.4473684210526316,9,8,1,0.4,12,10,39,-16,0.2631578947368421,11,15,-4,0.16666666666666666,0,0,0,0,0,0,0,0,0.6,0.2,6,19,27,0.1842105263157895,0.23333333333333336,5
2005-11-19,Man City,Blackburn,0,0,D,12,20,52,8,0.34210526315789475,15,11,4,0.5,12,17,42,-11,0.2368421052631579,15,15,0,0.4166666666666667,0,0,0,0,0,0,0,0,0.6,0.6,3,10,19,0.10526315789473684,0.08333333333333331,4
2005-11-19,Sunderland,Aston Villa,1,3,A,12,5,-1,-1,0.0,11,24,-13,0.08333333333333333,12,9,47,-7,0.3157894736842105,10,21,-11,0.16666666666666666,0,0,1,0,0,0,1,0,0.0,0.2,-4,-48,6,-0.3157894736842105,-0.08333333333333333,-2
2005-11-19,West Brom,Everton,4,0,H,12,8,34,-25,0.15789473684210525,9,22,-13,0.16666666666666666,11,10,61,-1,0.4736842105263158,4,12,-8,0.2727272727272727,0,0,1,0,0,0,0,0,0.2,0.4,-2,-27,-24,-0.31578947368421056,-0.10606060606060605,-5
2005-11-19,Wigan,Arsenal,2,3,A,11,25,-1,-1,0.0,13,5,8,0.7272727272727273,11,20,83,51,0.6578947368421053,16,8,8,0.5454545454545454,1,1,0,0,0,0,0,0,1.0,0.6,5,-84,-52,-0.6578947368421053,0.18181818181818188,0
2005-11-20,Middlesbrough,Fulham,3,2,H,12,15,55,7,0.3684210526315789,15,16,-1,0.3333333333333333,12,12,44,-8,0.3157894736842105,12,16,-4,0.25,0,0,0,0,0,0,0,0,0.4,0.4,3,11,15,0.05263157894736842,0.08333333333333331,3
2005-11-20,Tottenham,West Ham,1,1,D,12,20,52,6,0.3684210526315789,13,8,5,0.4166666666666667,11,18,-1,-1,0.0,15,10,5,0.45454545454545453,0,0,0,0,0,0,0,0,0.4,0.4,2,53,7,0.3684210526315789,-0.037878787878787845,0
2005-11-26,Arsenal,Blackburn,3,0,H,12,23,83,51,0.6578947368421053,19,10,9,0.5833333333333334,13,18,42,-11,0.2368421052631579,15,15,0,0.38461538461538464,0,0,0,0,0,0,0,0,0.6,0.4,5,41,62,0.4210526315789474,0.19871794871794873,9
2005-11-26,Aston Villa,Charlton,1,0,H,13,12,47,-7,0.3157894736842105,13,22,-9,0.23076923076923078,12,19,46,-16,0.3157894736842105,17,17,0,0.5,0,0,0,0,0,0,1,0,0.4,0.2,-7,1,9,0.0,-0.2692307692307692,-9
2005-11-26,Man City,Liverpool,0,1,A,13,21,52,8,0.34210526315789475,15,11,4,0.46153846153846156,11,19,58,11,0.4473684210526316,12,8,4,0.45454545454545453,0,0,0,0,1,0,0,0,0.4,0.8,2,-6,-3,-0.10526315789473684,0.006993006993007034,0
2005-11-26,Portsmouth,Chelsea,0,2,A,13,10,39,-16,0.2631578947368421,11,18,-7,0.15384615384615385,13,34,95,57,0.7631578947368421,31,7,24,0.8461538461538461,0,0,0,0,0,0,0,0,0.2,0.6,-24,-56,-73,-0.5,-0.6923076923076923,-31
2005-11-26,Sunderland,Birmingham,0,1,A,13,5,-1,-1,0.0,12,27,-15,0.07692307692307693,12,6,45,-6,0.2894736842105263,7,17,-10,0.08333333333333333,0,0,1,1,0,0,1,1,0.0,0.0,-1,-46,5,-0.2894736842105263,-0.006410256410256401,-5
2005-11-26,Wigan,Tottenham,1,2,A,12,25,-1,-1,0.0,15,8,7,0.6666666666666666,13,21,52,6,0.3684210526315789,14,9,5,0.38461538461538464,0,0,0,0,0,0,0,0,0.8,0.2,4,-53,-7,-0.3684210526315789,0.282051282051282,2
2005-11-27,Everton,Newcastle,1,0,H,12,10,61,-1,0.4736842105263158,4,16,-12,0.25,13,18,44,-10,0.2631578947368421,12,13,-1,0.38461538461538464,0,0,0,0,0,0,0,0,0.4,0.6,-8,17,9,0.21052631578947373,-0.13461538461538464,-11
2005-11-27,Fulham,Bolton,2,1,H,13,12,44,-8,0.3157894736842105,14,19,-5,0.23076923076923078,12,23,58,5,0.42105263157894735,14,11,3,0.5833333333333334,0,0,0,0,1,0,0,0,0.4,0.6,-11,-14,-13,-0.10526315789473684,-0.3525641025641026,-8
2005-11-27,Middlesbrough,West Brom,2,2,D,13,18,55,7,0.3684210526315789,18,18,0,0.38461538461538464,13,11,34,-25,0.15789473684210525,13,22,-9,0.23076923076923078,0,0,0,0,0,0,0,0,0.4,0.4,7,21,32,0.21052631578947367,0.15384615384615385,9
2005-11-27,West Ham,Man United,1,2,A,12,19,-1,-1,0.0,16,11,5,0.4166666666666667,12,24,77,32,0.5789473684210527,19,12,7,0.5833333333333334,0,0,0,0,0,0,0,0,0.4,0.6,-5,-78,-33,-0.5789473684210527,-0.16666666666666669,-2
2005-11-30,Sunderland,Liverpool,0,2,A,14,5,-1,-1,0.0,12,28,-16,0.07142857142857142,12,22,58,11,0.4473684210526316,13,8,5,0.5,0,0,1,1,1,0,0,0,0.0,0.8,-17,-59,-12,-0.4473684210526316,-0.4285714285714286,-21
2005-12-03,Blackburn,Everton,0,2,A,14,18,42,-11,0.2368421052631579,15,18,-3,0.35714285714285715,13,13,61,-1,0.4736842105263158,5,16,-11,0.3076923076923077,0,0,0,0,0,0,0,0,0.4,0.6,5,-19,-10,-0.2368421052631579,0.04945054945054944,8
2005-12-03,Bolton,Arsenal,2,0,H,13,23,58,5,0.42105263157894735,15,13,2,0.5384615384615384,13,26,83,51,0.6578947368421053,22,10,12,0.6153846153846154,0,0,0,0,1,0,0,0,0.6,0.8,-3,-25,-46,-0.23684210526315796,-0.07692307692307698,-10
2005-12-03,Chelsea,Middlesbrough,1,0,H,14,37,95,57,0.7631578947368421,33,7,26,0.8571428571428571,14,19,55,7,0.3684210526315789,20,20,0,0.35714285714285715,0,0,0,0,0,0,0,0,0.6,0.4,18,40,50,0.3947368421052632,0.49999999999999994,26
2005-12-03,Liverpool,Wigan,3,0,H,13,25,58,11,0.4473684210526316,15,8,7,0.5384615384615384,13,25,-1,-1,0.0,16,10,6,0.6153846153846154,1,1,0,0,0,0,0,0,1.0,0.6,0,59,12,0.4473684210526316,-0.07692307692307698,1
2005-12-03,Man United,Portsmouth,3,0,H,13,27,77,32,0.5789473684210527,21,13,8,0.6153846153846154,14,10,39,-16,0.2631578947368421,11,20,-9,0.14285714285714285,1,0,0,0,0,0,1,0,0.6,0.2,17,38,48,0.31578947368421056,0.47252747252747257,17
2005-12-03,Newcastle,Aston Villa,1,1,D,14,18,44,-10,0.2631578947368421,12,14,-2,0.35714285714285715,14,15,47,-7,0.3157894736842105,14,22,-8,0.2857142857142857,0,0,0,0,0,0,0,0,0.6,0.4,3,-3,-3,-0.05263157894736842,0.07142857142857145,6
2005-12-03,Tottenham,Sunderland,3,2,H,14,24,52,6,0.3684210526315789,16,10,6,0.42857142857142855,15,5,-1,-1,0.0,12,30,-18,0.06666666666666667,0,0,0,0,0,0,1,1,0.2,0.0,19,53,7,0.3684210526315789,0.3619047619047619,24
2005-12-03,West Brom,Fulham,0,0,D,14,12,34,-25,0.15789473684210525,15,24,-9,0.21428571428571427,14,15,44,-8,0.3157894736842105,16,20,-4,0.2857142857142857,0,0,0,0,0,0,0,0,0.2,0.6,-3,-10,-17,-0.15789473684210525,-0.07142857142857142,-5
2005-12-04,Charlton,Man City,2,5,A,13,19,46,-16,0.3157894736842105,17,18,-1,0.46153846153846156,14,21,52,8,0.34210526315789475,15,12,3,0.42857142857142855,0,0,1,0,0,0,0,0,0.2,0.2,-2,-6,-24,-0.026315789473684237,0.032967032967033016,-4
2005-12-05,Birmingham,West Ham,1,2,A,13,9,45,-6,0.2894736842105263,8,17,-9,0.15384615384615385,13,19,-1,-1,0.0,17,13,4,0.38461538461538464,0,0,0,0,0,0,0,0,0.2,0.4,-10,46,-5,0.2894736842105263,-0.23076923076923078,-13
2005-12-10,Birmingham,Fulham,1,0,H,14,9,45,-6,0.2894736842105263,9,19,-10,0.14285714285714285,15,16,44,-8,0.3157894736842105,16,20,-4,0.26666666666666666,0,0,0,0,0,0,0,0,0.2,0.4,-7,1,2,-0.02631578947368418,-0.12380952380952381,-6
2005-12-10,Blackburn,West Ham,3,2,H,15,18,42,-11,0.2368421052631579,15,20,-5,0.3333333333333333,14,22,-1,-1,0.0,19,14,5,0.42857142857142855,0,0,0,0,0,0,0,0,0.2,0.4,-4,43,-10,0.2368421052631579,-0.09523809523809523,-10
2005-12-10,Bolton,Aston Villa,1,1,D,14,26,58,5,0.42105263157894735,17,13,4,0.5714285714285714,15,16,47,-7,0.3157894736842105,15,23,-8,0.26666666666666666,0,0,0,0,0,0,0,0,0.8,0.4,10,11,12,0.10526315789473684,0.30476190476190473,12
2005-12-10,Charlton,Sunderland,2,0,H,14,19,46,-16,0.3157894736842105,19,23,-4,0.42857142857142855,16,5,-1,-1,0.0,14,33,-19,0.0625,0,0,1,1,0,0,1,1,0.0,0.0,14,47,-15,0.3157894736842105,0.36607142857142855,15
2005-12-10,Chelsea,Wigan,1,0,H,15,40,95,57,0.7631578947368421,34,7,27,0.8666666666666667,14,25,-1,-1,0.0,16,13,3,0.5714285714285714,1,0,0,0,0,0,1,0,0.8,0.4,15,96,58,0.7631578947368421,0.2952380952380953,24
2005-12-10,Liverpool,Middlesbrough,2,0,H,14,28,58,11,0.4473684210526316,18,8,10,0.5714285714285714,15,19,55,7,0.3684210526315789,20,21,-1,0.3333333333333333,1,1,0,0,0,0,0,0,1.0,0.4,9,3,4,0.07894736842105265,0.23809523809523808,11
2005-12-10,Newcastle,Arsenal,1,0,H,15,19,44,-10,0.2631578947368421,13,15,-2,0.3333333333333333,14,26,83,51,0.6578947368421053,22,12,10,0.5714285714285714,0,0,0,0,0,0,0,0,0.4,0.6,-7,-39,-61,-0.3947368421052632,-0.23809523809523808,-12
2005-12-10,West Brom,Man City,2,0,H,15,13,34,-25,0.15789473684210525,15,24,-9,0.2,15,24,52,8,0.34210526315789475,20,14,6,0.4666666666666667,0,0,0,0,0,0,0,0,0.2,0.4,-11,-18,-33,-0.1842105263157895,-0.26666666666666666,-15
2005-12-11,Man United,Everton,1,1,D,14,30,77,32,0.5789473684210527,24,13,11,0.6428571428571429,14,16,61,-1,0.4736842105263158,7,16,-9,0.35714285714285715,1,0,0,0,0,0,0,0,0.8,0.8,14,16,33,0.10526315789473684,0.28571428571428575,20
2005-12-12,Tottenham,Portsmouth,3,1,H,15,27,52,6,0.3684210526315789,19,12,7,0.4666666666666667,15,10,39,-16,0.2631578947368421,11,23,-12,0.13333333333333333,0,0,0,0,0,0,1,0,0.4,0.2,17,13,22,0.10526315789473684,0.33333333333333337,19
2005-12-14,Everton,West Ham,1,2,A,15,17,61,-1,0.4736842105263158,8,17,-9,0.3333333333333333,15,22,-1,-1,0.0,21,17,4,0.4,0,0,0,0,0,0,0,0,0.6,0.4,-5,62,0,0.4736842105263158,-0.06666666666666671,-13
2005-12-14,Man United,Wigan,4,0,H,15,31,77,32,0.5789473684210527,25,14,11,0.6,15,25,-1,-1,0.0,16,14,2,0.5333333333333333,0,0,0,0,0,0,1,0,0.8,0.2,6,78,33,0.5789473684210527,0.06666666666666665,9
2005-12-17,Aston Villa,Man United,0,2,A,16,17,47,-7,0.3157894736842105,16,24,-8,0.25,16,34,77,32,0.5789473684210527,29,14,15,0.625,0,0,0,0,0,0,0,0,0.4,0.8,-17,-30,-39,-0.26315789473684215,-0.375,-23
2005-12-17,Everton,Bolton,0,4,A,16,17,61,-1,0.4736842105263158,9,19,-10,0.3125,15,27,58,5,0.42105263157894735,18,14,4,0.5333333333333333,0,0,0,0,0,0,0,0,0.4,0.6,-10,3,-6,0.052631578947368474,-0.22083333333333333,-14
2005-12-17,Fulham,Blackburn,2,1,H,16,16,44,-8,0.3157894736842105,16,21,-5,0.25,16,21,42,-11,0.2368421052631579,18,22,-4,0.375,0,0,0,0,0,0,0,0,0.4,0.4,-5,2,3,0.0789473684210526,-0.125,-1
2005-12-17,Man City,Birmingham,4,1,H,16,24,52,8,0.34210526315789475,20,16,4,0.4375,15,12,45,-6,0.2894736842105263,10,19,-9,0.2,0,0,0,0,0,0,0,0,0.2,0.4,12,7,14,0.05263157894736842,0.2375,13
2005-12-17,Portsmouth,West Brom,1,0,H,16,10,39,-16,0.2631578947368421,12,26,-14,0.125,16,16,34,-25,0.15789473684210525,17,24,-7,0.25,0,0,1,1,0,0,0,0,0.0,0.4,-6,5,9,0.10526315789473684,-0.125,-7
2005-12-17,West Ham,Newcastle,2,4,A,16,25,-1,-1,0.0,23,18,5,0.4375,16,22,44,-10,0.2631578947368421,14,15,-1,0.375,0,0,0,0,0,0,0,0,0.4,0.4,3,-45,9,-0.2631578947368421,0.0625,6
2005-12-17,Wigan,Charlton,3,0,H,16,25,-1,-1,0.0,16,18,-2,0.5,15,22,46,-16,0.3157894736842105,21,23,-2,0.4666666666666667,0,0,1,1,0,0,0,0,0.0,0.2,3,-47,15,-0.3157894736842105,0.033333333333333326,0
2005-12-18,Arsenal,Chelsea,0,2,A,15,26,83,51,0.6578947368421053,22,13,9,0.5333333333333333,16,43,95,57,0.7631578947368421,35,7,28,0.875,0,0,0,0,1,0,0,0,0.6,0.8,-17,-12,-6,-0.10526315789473684,-0.3416666666666667,-19
2005-12-18,Middlesbrough,Tottenham,3,3,D,16,19,55,7,0.3684210526315789,20,23,-3,0.3125,16,30,52,6,0.3684210526315789,22,13,9,0.5,0,0,0,0,1,0,0,0,0.2,0.6,-11,3,1,0.0,-0.1875,-12
2005-12-26,Aston Villa,Everton,4,0,H,17,17,47,-7,0.3157894736842105,16,26,-10,0.23529411764705882,17,17,61,-1,0.4736842105263158,9,23,-14,0.29411764705882354,0,0,0,0,0,0,0,0,0.4,0.4,0,-14,-6,-0.1578947368421053,-0.05882352941176472,4
2005-12-26,Charlton,Arsenal,0,1,A,16,22,46,-16,0.3157894736842105,21,26,-5,0.4375,16,26,83,51,0.6578947368421053,22,15,7,0.5,0,0,0,0,0,0,1,0,0.2,0.4,-4,-37,-67,-0.3421052631578948,-0.0625,-12
2005-12-26,Chelsea,Fulham,3,2,H,17,46,95,57,0.7631578947368421,37,7,30,0.8823529411764706,17,19,44,-8,0.3157894736842105,18,22,-4,0.29411764705882354,1,1,0,0,0,0,0,0,1.0,0.4,27,51,65,0.44736842105263164,0.588235294117647,34
2005-12-26,Liverpool,Newcastle,2,0,H,15,31,58,11,0.4473684210526316,20,8,12,0.6,17,25,44,-10,0.2631578947368421,18,17,1,0.4117647058823529,1,1,0,0,0,0,0,0,1.0,0.4,6,14,21,0.1842105263157895,0.18823529411764706,11
2005-12-26,Man United,West Brom,3,0,H,17,37,77,32,0.5789473684210527,31,14,17,0.6470588235294118,17,16,34,-25,0.15789473684210525,17,25,-8,0.23529411764705882,0,0,0,0,0,0,0,0,0.8,0.4,21,43,57,0.4210526315789474,0.411764705882353,25
2005-12-26,Middlesbrough,Blackburn,0,2,A,17,20,55,7,0.3684210526315789,23,26,-3,0.29411764705882354,17,21,42,-11,0.2368421052631579,19,24,-5,0.35294117647058826,0,0,0,0,0,0,0,0,0.2,0.2,-1,13,18,0.13157894736842102,-0.05882352941176472,2
2005-12-26,Portsmouth,West Ham,1,1,D,17,13,39,-16,0.2631578947368421,13,26,-13,0.17647058823529413,17,25,-1,-1,0.0,25,22,3,0.4117647058823529,0,0,0,0,0,0,0,0,0.2,0.4,-12,40,-15,0.2631578947368421,-0.2352941176470588,-16
2005-12-26,Sunderland,Bolton,0,0,D,17,5,-1,-1,0.0,14,35,-21,0.058823529411764705,16,30,58,5,0.42105263157894735,22,14,8,0.5625,0,0,1,1,0,0,0,0,0.0,0.6,-25,-59,-6,-0.42105263157894735,-0.5036764705882353,-29
2005-12-26,Tottenham,Birmingham,2,0,H,17,31,52,6,0.3684210526315789,25,16,9,0.47058823529411764,16,12,45,-6,0.2894736842105263,11,23,-12,0.1875,0,0,0,0,0,0,0,0,0.6,0.4,19,7,12,0.0789473684210526,0.28308823529411764,21
2005-12-26,Wigan,Man City,4,3,H,17,28,-1,-1,0.0,19,18,1,0.5294117647058824,17,27,52,8,0.34210526315789475,24,17,7,0.47058823529411764,0,0,0,0,0,0,0,0,0.2,0.4,1,-53,-9,-0.34210526315789475,0.05882352941176472,-6
2005-12-28,Arsenal,Portsmouth,4,0,H,17,29,83,51,0.6578947368421053,23,15,8,0.5294117647058824,18,14,39,-16,0.2631578947368421,14,27,-13,0.16666666666666666,0,0,0,0,0,0,0,0,0.4,0.2,15,44,67,0.3947368421052632,0.36274509803921573,21
2005-12-28,Birmingham,Man United,2,2,D,17,12,45,-6,0.2894736842105263,11,25,-14,0.17647058823529413,18,40,77,32,0.5789473684210527,34,14,20,0.6666666666666666,0,0,0,0,1,0,0,0,0.4,0.8,-28,-32,-38,-0.2894736842105263,-0.4901960784313725,-34
2005-12-28,Everton,Liverpool,1,3,A,18,17,61,-1,0.4736842105263158,9,27,-18,0.2777777777777778,16,34,58,11,0.4473684210526316,22,8,14,0.625,0,0,1,0,1,1,0,0,0.2,1.0,-17,3,-12,0.026315789473684237,-0.3472222222222222,-32
2005-12-28,Fulham,Aston Villa,3,3,D,18,19,44,-8,0.3157894736842105,20,25,-5,0.2777777777777778,18,20,47,-7,0.3157894736842105,20,26,-6,0.2777777777777778,0,0,0,0,0,0,0,0,0.4,0.4,-1,-3,-1,0.0,0.0,1
2005-12-28,Man City,Chelsea,0,1,A,18,27,52,8,0.34210526315789475,27,21,6,0.4444444444444444,18,49,95,57,0.7631578947368421,40,9,31,0.8888888888888888,0,0,0,0,1,1,0,0,0.4,1.0,-22,-43,-49,-0.4210526315789474,-0.4444444444444444,-25
2005-12-28,West Brom,Tottenham,2,0,H,18,16,34,-25,0.15789473684210525,17,28,-11,0.2222222222222222,18,34,52,6,0.3684210526315789,27,16,11,0.5,0,0,0,0,0,0,0,0,0.2,0.8,-18,-18,-31,-0.21052631578947367,-0.2777777777777778,-22
2005-12-28,West Ham,Wigan,0,2,A,18,26,-1,-1,0.0,26,23,3,0.3888888888888889,18,31,-1,-1,0.0,23,21,2,0.5555555555555556,0,0,0,0,0,0,0,0,0.4,0.4,-5,0,0,0.0,-0.16666666666666669,1
2005-12-31,Aston Villa,Arsenal,0,0,D,19,21,47,-7,0.3157894736842105,23,29,-6,0.2631578947368421,18,32,83,51,0.6578947368421053,27,15,12,0.5555555555555556,0,0,0,0,0,0,0,0,0.2,0.4,-11,-36,-58,-0.3421052631578948,-0.2923976608187135,-18
2005-12-31,Charlton,West Ham,2,0,H,17,22,46,-16,0.3157894736842105,21,27,-6,0.4117647058823529,19,26,-1,-1,0.0,26,25,1,0.3684210526315789,0,0,0,0,0,0,0,0,0.2,0.2,-4,47,-15,0.3157894736842105,0.043343653250773995,-7
2005-12-31,Chelsea,Birmingham,2,0,H,19,52,95,57,0.7631578947368421,41,9,32,0.8947368421052632,18,13,45,-6,0.2894736842105263,13,27,-14,0.16666666666666666,1,1,0,0,0,0,0,0,1.0,0.2,39,50,63,0.4736842105263158,0.7280701754385965,46
2005-12-31,Liverpool,West Brom,1,0,H,17,37,58,11,0.4473684210526316,25,9,16,0.6470588235294118,19,19,34,-25,0.15789473684210525,19,28,-9,0.2631578947368421,1,1,0,0,0,0,0,0,1.0,0.4,18,24,36,0.2894736842105263,0.3839009287925697,25
2005-12-31,Man United,Bolton,4,1,H,19,41,77,32,0.5789473684210527,36,16,20,0.631578947368421,17,31,58,5,0.42105263157894735,22,14,8,0.5294117647058824,0,0,0,0,0,0,0,0,0.6,0.4,10,19,27,0.1578947368421053,0.10216718266253866,12
2005-12-31,Middlesbrough,Man City,0,0,D,18,20,55,7,0.3684210526315789,23,28,-5,0.2777777777777778,19,27,52,8,0.34210526315789475,27,22,5,0.42105263157894735,0,0,0,0,0,0,0,0,0.0,0.4,-7,3,-1,0.02631578947368418,-0.14327485380116955,-10
2005-12-31,Portsmouth,Fulham,1,0,H,19,14,39,-16,0.2631578947368421,14,31,-17,0.15789473684210525,19,20,44,-8,0.3157894736842105,23,28,-5,0.2631578947368421,0,0,0,0,0,0,0,0,0.2,0.2,-6,-5,-8,-0.05263157894736842,-0.10526315789473684,-12
2005-12-31,Sunderland,Everton,0,1,A,18,6,-1,-1,0.0,14,35,-21,0.05555555555555555,19,17,61,-1,0.4736842105263158,10,30,-20,0.2631578947368421,0,0,0,0,0,0,1,0,0.0,0.0,-11,-62,0,-0.4736842105263158,-0.20760233918128654,-1
2005-12-31,Tottenham,Newcastle,2,0,H,19,34,52,6,0.3684210526315789,27,18,9,0.47368421052631576,18,25,44,-10,0.2631578947368421,18,19,-1,0.3888888888888889,0,0,0,0,0,0,0,0,0.6,0.4,9,8,16,0.10526315789473684,0.08479532163742687,10
2005-12-31,Wigan,Blackburn,0,3,A,19,34,-1,-1,0.0,25,21,4,0.5789473684210527,18,24,42,-11,0.2368421052631579,21,24,-3,0.3888888888888889,1,0,0,0,0,0,0,0,0.6,0.4,10,-43,10,-0.2368421052631579,0.19005847953216376,7
2006-01-02,Birmingham,Wigan,2,0,H,19,13,45,-6,0.2894736842105263,13,29,-16,0.15789473684210525,20,34,-1,-1,0.0,25,24,1,0.55,0,0,0,0,0,0,0,0,0.2,0.6,-21,46,-5,0.2894736842105263,-0.3921052631578948,-17
2006-01-02,Blackburn,Portsmouth,2,1,H,19,27,42,-11,0.2368421052631579,24,24,0,0.42105263157894735,20,17,39,-16,0.2631578947368421,15,31,-16,0.2,0,0,0,0,0,0,0,0,0.6,0.4,10,3,5,-0.02631578947368418,0.22105263157894733,16
2006-01-02,Bolton,Liverpool,2,2,D,18,31,58,5,0.42105263157894735,23,18,5,0.5,18,40,58,11,0.4473684210526316,26,9,17,0.6666666666666666,0,0,0,0,1,1,0,0,0.4,1.0,-9,0,-6,-0.026315789473684237,-0.16666666666666663,-12
2006-01-02,Everton,Charlton,3,1,H,20,20,61,-1,0.4736842105263158,11,30,-19,0.3,18,25,46,-16,0.3157894736842105,23,27,-4,0.4444444444444444,0,0,0,0,0,0,0,0,0.2,0.4,-5,15,15,0.1578947368421053,-0.14444444444444443,-15
2006-01-02,Fulham,Sunderland,2,1,H,20,20,44,-8,0.3157894736842105,23,29,-6,0.25,19,6,-1,-1,0.0,14,36,-22,0.05263157894736842,0,0,0,0,0,0,0,0,0.2,0.0,14,45,-7,0.3157894736842105,0.19736842105263158,16
2006-01-02,Newcastle,Middlesbrough,2,2,D,19,25,44,-10,0.2631578947368421,18,21,-3,0.3684210526315789,19,21,55,7,0.3684210526315789,23,28,-5,0.2631578947368421,0,0,0,0,0,0,0,0,0.4,0.0,4,-11,-17,-0.10526315789473684,0.10526315789473684,2
2006-01-02,West Brom,Aston Villa,1,2,A,20,19,34,-25,0.15789473684210525,19,29,-10,0.25,20,22,47,-7,0.3157894736842105,23,29,-6,0.25,0,0,0,0,0,0,0,0,0.4,0.2,-3,-13,-18,-0.15789473684210525,0.0,-4
2006-01-02,West Ham,Chelsea,1,3,A,20,26,-1,-1,0.0,26,27,-1,0.35,20,55,95,57,0.7631578947368421,43,9,34,0.9,0,0,0,0,1,1,0,0,0.2,1.0,-29,-96,-58,-0.7631578947368421,-0.55,-35
2006-01-03,Arsenal,Man United,0,0,D,19,33,83,51,0.6578947368421053,27,15,12,0.5263157894736842,20,44,77,32,0.5789473684210527,40,17,23,0.65,0,0,0,0,0,0,0,0,0.4,0.8,-11,6,19,0.07894736842105265,-0.12368421052631584,-11
2006-01-04,Man City,Tottenham,0,2,A,20,28,52,8,0.34210526315789475,27,22,5,0.4,20,37,52,6,0.3684210526315789,29,18,11,0.5,0,0,0,0,0,0,0,0,0.2,0.6,-9,0,2,-0.02631578947368418,-0.09999999999999998,-6
2006-01-14,Arsenal,Middlesbrough,7,0,H,20,34,83,51,0.6578947368421053,27,15,12,0.5,20,22,55,7,0.3684210526315789,25,30,-5,0.25,0,0,0,0,0,0,0,0,0.4,0.0,12,28,44,0.2894736842105264,0.25,17
2006-01-14,Aston Villa,West Ham,1,2,A,21,25,47,-7,0.3157894736842105,25,30,-5,0.2857142857142857,21,26,-1,-1,0.0,27,30,-3,0.3333333333333333,0,0,0,0,0,0,1,0,0.4,0.0,-1,48,-6,0.3157894736842105,-0.047619047619047616,-2
2006-01-14,Blackburn,Bolton,0,0,D,20,30,42,-11,0.2368421052631579,26,25,1,0.45,19,32,58,5,0.42105263157894735,25,20,5,0.47368421052631576,1,0,0,0,0,0,0,0,0.8,0.2,-2,-16,-16,-0.18421052631578944,-0.023684210526315752,-4
2006-01-14,Charlton,Birmingham,2,0,H,19,25,46,-16,0.3157894736842105,24,30,-6,0.42105263157894735,20,16,45,-6,0.2894736842105263,15,29,-14,0.2,0,0,0,0,0,0,0,0,0.4,0.2,9,1,-10,0.02631578947368418,0.22105263157894733,8
2006-01-14,Fulham,Newcastle,1,0,H,21,23,44,-8,0.3157894736842105,25,30,-5,0.2857142857142857,20,26,44,-10,0.2631578947368421,20,23,-3,0.35,0,0,0,0,0,0,0,0,0.4,0.4,-3,0,2,0.05263157894736842,-0.06428571428571428,-2
2006-01-14,Liverpool,Tottenham,1,0,H,19,41,58,11,0.4473684210526316,28,11,17,0.631578947368421,21,40,52,6,0.3684210526315789,31,18,13,0.5238095238095238,0,0,0,0,0,0,0,0,0.8,0.6,1,6,5,0.07894736842105265,0.10776942355889718,4
2006-01-14,Man City,Man United,3,1,H,21,28,52,8,0.34210526315789475,27,24,3,0.38095238095238093,21,45,77,32,0.5789473684210527,40,17,23,0.6190476190476191,0,0,0,0,0,0,0,0,0.2,0.6,-17,-25,-24,-0.2368421052631579,-0.23809523809523814,-20
2006-01-14,Portsmouth,Everton,0,1,A,21,17,39,-16,0.2631578947368421,16,33,-17,0.19047619047619047,21,23,61,-1,0.4736842105263158,14,31,-17,0.3333333333333333,0,0,0,0,0,0,0,0,0.4,0.4,-6,-22,-15,-0.21052631578947373,-0.14285714285714285,0
2006-01-15,Sunderland,Chelsea,1,2,A,20,6,-1,-1,0.0,15,38,-23,0.05,21,58,95,57,0.7631578947368421,46,10,36,0.9047619047619048,0,0,0,0,1,1,0,0,0.0,1.0,-52,-96,-58,-0.7631578947368421,-0.8547619047619047,-59
2006-01-15,Wigan,West Brom,0,1,A,21,34,-1,-1,0.0,25,26,-1,0.5238095238095238,21,19,34,-25,0.15789473684210525,20,31,-11,0.23809523809523808,0,0,0,0,0,0,0,0,0.6,0.2,15,-35,24,-0.15789473684210525,0.28571428571428575,10
2006-01-21,Birmingham,Portsmouth,5,0,H,21,16,45,-6,0.2894736842105263,15,31,-16,0.19047619047619047,22,17,39,-16,0.2631578947368421,16,34,-18,0.18181818181818182,0,0,0,0,0,0,0,0,0.2,0.2,-1,6,10,0.026315789473684237,0.008658008658008642,2
2006-01-21,Bolton,Man City,2,0,H,20,33,58,5,0.42105263157894735,25,20,5,0.45,22,31,52,8,0.34210526315789475,30,25,5,0.4090909090909091,0,0,0,0,0,0,0,0,0.2,0.2,2,6,-3,0.0789473684210526,0.040909090909090895,0
2006-01-21,Everton,Arsenal,1,0,H,22,26,61,-1,0.4736842105263158,15,31,-16,0.36363636363636365,21,37,83,51,0.6578947368421053,34,15,19,0.5238095238095238,1,0,0,0,0,0,0,0,0.6,0.6,-11,-22,-52,-0.1842105263157895,-0.1601731601731602,-35
2006-01-21,Middlesbrough,Wigan,2,3,A,21,22,55,7,0.3684210526315789,25,37,-12,0.23809523809523808,22,34,-1,-1,0.0,25,27,-2,0.5,0,0,0,0,0,0,1,0,0.0,0.4,-12,56,8,0.3684210526315789,-0.2619047619047619,-10
2006-01-21,Newcastle,Blackburn,0,1,A,21,26,44,-10,0.2631578947368421,20,24,-4,0.3333333333333333,21,31,42,-11,0.2368421052631579,26,25,1,0.42857142857142855,0,0,0,0,0,0,0,0,0.2,0.6,-5,2,1,0.02631578947368418,-0.09523809523809523,-5
2006-01-21,Tottenham,Aston Villa,0,0,D,22,40,52,6,0.3684210526315789,31,19,12,0.5,22,25,47,-7,0.3157894736842105,26,32,-6,0.2727272727272727,0,0,0,0,0,0,0,0,0.6,0.4,15,5,13,0.05263157894736842,0.2272727272727273,18
2006-01-21,West Brom,Sunderland,0,1,A,22,22,34,-25,0.15789473684210525,21,31,-10,0.2727272727272727,21,6,-1,-1,0.0,16,40,-24,0.047619047619047616,0,0,0,0,0,0,1,0,0.4,0.0,16,35,-24,0.15789473684210525,0.2251082251082251,14
2006-01-22,Chelsea,Charlton,1,1,D,22,61,95,57,0.7631578947368421,48,11,37,0.9090909090909091,20,28,46,-16,0.3157894736842105,26,30,-4,0.45,1,1,0,0,0,0,0,0,1.0,0.4,33,49,73,0.44736842105263164,0.45909090909090905,41
2006-01-22,Man United,Liverpool,1,0,H,22,45,77,32,0.5789473684210527,41,20,21,0.5909090909090909,20,44,58,11,0.4473684210526316,29,11,18,0.65,0,0,0,0,0,0,0,0,0.4,0.8,1,19,21,0.13157894736842107,-0.05909090909090908,3
2006-01-23,West Ham,Fulham,2,1,H,22,29,-1,-1,0.0,29,31,-2,0.36363636363636365,22,26,44,-8,0.3157894736842105,26,30,-4,0.3181818181818182,0,0,0,0,0,0,0,0,0.2,0.4,3,-45,7,-0.3157894736842105,0.04545454545454547,2
2006-01-31,Charlton,West Brom,0,0,D,21,29,46,-16,0.3157894736842105,27,31,-4,0.42857142857142855,23,22,34,-25,0.15789473684210525,21,32,-11,0.2608695652173913,0,0,0,0,0,0,0,0,0.4,0.4,7,12,9,0.15789473684210525,0.16770186335403725,7
2006-01-31,Fulham,Tottenham,1,0,H,23,26,44,-8,0.3157894736842105,27,32,-5,0.30434782608695654,23,41,52,6,0.3684210526315789,31,19,12,0.4782608695652174,0,0,0,0,0,0,0,0,0.4,0.4,-15,-8,-14,-0.05263157894736842,-0.17391304347826086,-17
2006-01-31,Sunderland,Middlesbrough,0,3,A,22,9,-1,-1,0.0,17,40,-23,0.09090909090909091,22,22,55,7,0.3684210526315789,27,40,-13,0.22727272727272727,0,0,0,0,0,0,0,0,0.2,0.0,-13,-56,-8,-0.3684210526315789,-0.13636363636363635,-10
2006-01-31,Wigan,Everton,1,1,D,23,37,-1,-1,0.0,28,29,-1,0.5217391304347826,23,29,61,-1,0.4736842105263158,16,31,-15,0.391304347826087,0,0,0,0,1,0,0,0,0.4,0.8,8,-62,0,-0.4736842105263158,0.13043478260869562,14
2006-02-01,Arsenal,West Ham,2,3,A,22,37,83,51,0.6578947368421053,34,16,18,0.5,23,32,-1,-1,0.0,31,32,-1,0.391304347826087,0,0,0,0,0,0,0,0,0.4,0.4,5,84,52,0.6578947368421053,0.10869565217391303,19
2006-02-01,Aston Villa,Chelsea,1,1,D,23,26,47,-7,0.3157894736842105,26,32,-6,0.2608695652173913,23,62,95,57,0.7631578947368421,49,12,37,0.8695652173913043,0,0,0,0,0,0,0,0,0.2,0.8,-36,-48,-64,-0.44736842105263164,-0.6086956521739131,-43
2006-02-01,Blackburn,Man United,4,3,H,22,34,42,-11,0.2368421052631579,27,25,2,0.45454545454545453,23,48,77,32,0.5789473684210527,42,20,22,0.6086956521739131,0,0,0,0,0,0,0,0,0.8,0.4,-14,-35,-43,-0.34210526315789475,-0.15415019762845855,-20
2006-02-01,Liverpool,Birmingham,1,1,D,21,44,58,11,0.4473684210526316,29,12,17,0.6190476190476191,22,19,45,-6,0.2894736842105263,20,31,-11,0.22727272727272727,0,0,0,0,0,0,0,0,0.6,0.4,25,13,17,0.15789473684210525,0.3917748917748918,28
2006-02-01,Man City,Newcastle,3,0,H,23,31,52,8,0.34210526315789475,30,27,3,0.391304347826087,22,26,44,-10,0.2631578947368421,20,25,-5,0.3181818181818182,0,0,0,0,0,0,0,0,0.2,0.0,5,8,18,0.07894736842105265,0.0731225296442688,8
2006-02-01,Portsmouth,Bolton,1,1,D,23,17,39,-16,0.2631578947368421,16,39,-23,0.17391304347826086,21,36,58,5,0.42105263157894735,27,20,7,0.47619047619047616,0,0,1,0,0,0,0,0,0.2,0.2,-19,-19,-21,-0.15789473684210525,-0.3022774327122153,-30
2006-02-04,Birmingham,Arsenal,0,2,A,23,20,45,-6,0.2894736842105263,21,32,-11,0.21739130434782608,23,37,83,51,0.6578947368421053,36,19,17,0.4782608695652174,0,0,0,0,0,0,0,0,0.4,0.2,-17,-38,-57,-0.368421052631579,-0.26086956521739135,-28
2006-02-04,Bolton,Wigan,1,1,D,22,37,58,5,0.42105263157894735,28,21,7,0.45454545454545453,24,38,-1,-1,0.0,29,30,-1,0.5,0,0,0,0,0,0,0,0,0.2,0.2,-1,59,6,0.42105263157894735,-0.04545454545454547,8
2006-02-04,Everton,Man City,1,0,H,24,30,61,-1,0.4736842105263158,17,32,-15,0.375,24,34,52,8,0.34210526315789475,33,27,6,0.4166666666666667,0,0,0,0,0,0,0,0,0.8,0.4,-4,9,-9,0.13157894736842107,-0.041666666666666685,-21
2006-02-04,Man United,Fulham,4,2,H,24,48,77,32,0.5789473684210527,45,24,21,0.5833333333333334,24,29,44,-8,0.3157894736842105,28,32,-4,0.3333333333333333,0,0,0,0,0,0,0,0,0.4,0.6,19,33,40,0.26315789473684215,0.25000000000000006,25
2006-02-04,Middlesbrough,Aston Villa,0,4,A,23,25,55,7,0.3684210526315789,30,40,-10,0.2608695652173913,24,27,47,-7,0.3157894736842105,27,33,-6,0.25,0,0,0,0,0,0,0,0,0.2,0.2,-2,8,14,0.05263157894736842,0.010869565217391297,-4
2006-02-04,Newcastle,Portsmouth,2,0,H,23,26,44,-10,0.2631578947368421,20,28,-8,0.30434782608695654,24,18,39,-16,0.2631578947368421,17,40,-23,0.16666666666666666,0,0,1,0,0,0,0,0,0.0,0.2,8,5,6,0.0,0.13768115942028988,15
2006-02-04,West Brom,Blackburn,2,0,H,24,23,34,-25,0.15789473684210525,21,32,-11,0.25,23,37,42,-11,0.2368421052631579,31,28,3,0.4782608695652174,0,0,0,0,0,0,0,0,0.2,0.8,-14,-8,-14,-0.07894736842105265,-0.2282608695652174,-14
2006-02-04,West Ham,Sunderland,2,0,H,24,35,-1,-1,0.0,34,34,0,0.4166666666666667,23,9,-1,-1,0.0,17,43,-26,0.08695652173913043,1,0,0,0,0,0,0,0,0.6,0.2,26,0,0,0.0,0.32971014492753625,26
2006-02-05,Chelsea,Liverpool,2,0,H,24,63,95,57,0.7631578947368421,50,13,37,0.8333333333333334,22,45,58,11,0.4473684210526316,30,13,17,0.5909090909090909,0,0,0,0,0,0,0,0,0.6,0.4,18,37,46,0.31578947368421056,0.24242424242424243,20
2006-02-05,Tottenham,Charlton,3,1,H,24,41,52,6,0.3684210526315789,31,20,11,0.4583333333333333,22,30,46,-16,0.3157894736842105,27,31,-4,0.4090909090909091,0,0,0,0,0,0,0,0,0.4,0.4,11,6,22,0.05263157894736842,0.0492424242424242,15
2006-02-08,Charlton,Liverpool,2,0,H,23,30,46,-16,0.3157894736842105,28,34,-6,0.391304347826087,23,45,58,11,0.4473684210526316,30,15,15,0.5652173913043478,0,0,0,0,0,0,0,0,0.2,0.2,-15,-12,-27,-0.13157894736842107,-0.1739130434782608,-21
2006-02-11,Arsenal,Bolton,1,1,D,24,40,83,51,0.6578947368421053,38,19,19,0.5,23,38,58,5,0.42105263157894735,29,22,7,0.43478260869565216,0,0,0,0,0,0,0,0,0.4,0.2,2,25,46,0.23684210526315796,0.06521739130434784,12
2006-02-11,Aston Villa,Newcastle,1,2,A,25,30,47,-7,0.3157894736842105,31,33,-2,0.28,24,29,44,-10,0.2631578947368421,22,28,-6,0.3333333333333333,0,0,0,0,0,0,0,0,0.4,0.2,1,3,3,0.05263157894736842,-0.05333333333333329,4
2006-02-11,Everton,Blackburn,1,0,H,25,33,61,-1,0.4736842105263158,18,32,-14,0.4,24,37,42,-11,0.2368421052631579,31,30,1,0.4583333333333333,0,0,0,0,0,0,0,0,0.8,0.6,-4,19,10,0.2368421052631579,-0.05833333333333329,-15
2006-02-11,Fulham,West Brom,6,1,H,25,29,44,-8,0.3157894736842105,30,36,-6,0.32,25,26,34,-25,0.15789473684210525,23,32,-9,0.28,0,0,0,0,0,0,0,0,0.6,0.4,3,10,17,0.15789473684210525,0.03999999999999998,3
2006-02-11,Middlesbrough,Chelsea,3,0,H,24,25,55,7,0.3684210526315789,30,44,-14,0.25,25,66,95,57,0.7631578947368421,52,13,39,0.84,0,0,0,0,0,0,0,0,0.2,0.6,-41,-40,-50,-0.3947368421052632,-0.59,-53
2006-02-11,Portsmouth,Man United,1,3,A,25,18,39,-16,0.2631578947368421,17,42,-25,0.16,25,51,77,32,0.5789473684210527,49,26,23,0.6,0,0,0,0,0,0,0,0,0.0,0.4,-33,-38,-48,-0.31578947368421056,-0.43999999999999995,-48
2006-02-11,Wigan,Liverpool,0,1,A,25,39,-1,-1,0.0,30,31,-1,0.48,24,45,58,11,0.4473684210526316,30,17,13,0.5416666666666666,0,0,0,0,0,0,0,0,0.2,0.2,-6,-59,-12,-0.4473684210526316,-0.06166666666666665,-14
2006-02-12,Man City,Charlton,3,2,H,25,34,52,8,0.34210526315789475,33,28,5,0.4,24,33,46,-16,0.3157894736842105,30,34,-4,0.4166666666666667,0,0,0,0,0,0,0,0,0.4,0.4,1,6,24,0.026315789473684237,-0.016666666666666663,9
2006-02-12,Sunderland,Tottenham,1,1,D,24,9,-1,-1,0.0,17,45,-28,0.08333333333333333,25,44,52,6,0.3684210526315789,34,21,13,0.48,0,0,0,0,0,0,0,0,0.2,0.4,-35,-53,-7,-0.3684210526315789,-0.39666666666666667,-41
2006-02-13,West Ham,Birmingham,3,0,H,25,38,-1,-1,0.0,36,34,2,0.44,24,20,45,-6,0.2894736842105263,21,34,-13,0.20833333333333334,1,0,0,0,0,0,0,0,0.8,0.4,18,-46,5,-0.2894736842105263,0.23166666666666666,15
2006-02-14,Liverpool,Arsenal,1,0,H,25,48,58,11,0.4473684210526316,31,17,14,0.56,25,41,83,51,0.6578947368421053,39,20,19,0.48,0,0,0,0,0,0,0,0,0.2,0.4,7,-25,-40,-0.21052631578947373,0.08000000000000007,-5
2006-02-15,Blackburn,Sunderland,2,0,H,25,37,42,-11,0.2368421052631579,31,31,0,0.44,25,10,-1,-1,0.0,18,46,-28,0.08,0,0,0,0,0,0,0,0,0.4,0.2,27,43,-10,0.2368421052631579,0.36,28
2006-02-19,Tottenham,Wigan,2,2,D,26,45,52,6,0.3684210526315789,35,22,13,0.46153846153846156,26,39,-1,-1,0.0,30,32,-2,0.46153846153846156,0,0,0,0,0,0,0,0,0.2,0.2,6,53,7,0.3684210526315789,0.0,15
2006-02-22,Newcastle,Charlton,0,0,D,25,32,44,-10,0.2631578947368421,24,29,-5,0.36,25,33,46,-16,0.3157894736842105,32,37,-5,0.4,0,0,0,0,0,0,0,0,0.4,0.2,-1,-2,6,-0.05263157894736842,-0.040000000000000036,0
2006-02-25,Birmingham,Sunderland,1,0,H,25,20,45,-6,0.2894736842105263,21,37,-16,0.2,26,10,-1,-1,0.0,18,48,-30,0.07692307692307693,0,0,0,0,0,0,0,0,0.2,0.2,10,46,-5,0.2894736842105263,0.12307692307692308,14
2006-02-25,Blackburn,Arsenal,1,0,H,26,40,42,-11,0.2368421052631579,33,31,2,0.46153846153846156,26,41,83,51,0.6578947368421053,39,21,18,0.46153846153846156,0,0,0,0,0,0,0,0,0.6,0.2,-1,-41,-62,-0.4210526315789474,0.0,-16
2006-02-25,Charlton,Aston Villa,0,0,D,26,34,46,-16,0.3157894736842105,32,37,-5,0.38461538461538464,26,30,47,-7,0.3157894736842105,32,35,-3,0.2692307692307692,0,0,0,0,0,0,0,0,0.2,0.2,4,-1,-9,0.0,0.11538461538461542,-2
2006-02-25,Chelsea,Portsmouth,2,0,H,26,66,95,57,0.7631578947368421,52,16,36,0.8076923076923077,26,18,39,-16,0.2631578947368421,18,45,-27,0.15384615384615385,0,0,0,0,0,0,0,0,0.4,0.0,48,56,73,0.5,0.6538461538461539,63
2006-02-25,Newcastle,Everton,2,0,H,26,33,44,-10,0.2631578947368421,24,29,-5,0.34615384615384615,26,36,61,-1,0.4736842105263158,19,32,-13,0.4230769230769231,0,0,0,0,0,0,0,0,0.4,0.8,-3,-17,-9,-0.21052631578947373,-0.07692307692307693,8
2006-02-26,Bolton,Fulham,2,1,H,24,39,58,5,0.42105263157894735,30,23,7,0.4166666666666667,26,32,44,-8,0.3157894736842105,36,37,-1,0.34615384615384615,0,0,0,0,0,0,0,0,0.2,0.6,7,14,13,0.10526315789473684,0.07051282051282054,8
2006-02-26,Liverpool,Man City,1,0,H,26,51,58,11,0.4473684210526316,32,17,15,0.5769230769230769,26,37,52,8,0.34210526315789475,36,30,6,0.4230769230769231,0,0,0,0,0,0,0,0,0.4,0.6,14,6,3,0.10526315789473684,0.1538461538461538,9
2006-02-26,West Brom,Middlesbrough,0,2,A,26,26,34,-25,0.15789473684210525,24,38,-14,0.2692307692307692,25,28,55,7,0.3684210526315789,33,44,-11,0.28,0,0,0,0,0,0,0,0,0.4,0.4,-2,-21,-32,-0.21052631578947367,-0.010769230769230809,-3
2006-03-04,Aston Villa,Portsmouth,1,0,H,27,31,47,-7,0.3157894736842105,32,35,-3,0.25925925925925924,27,18,39,-16,0.2631578947368421,18,47,-29,0.14814814814814814,0,0,0,0,0,0,1,0,0.2,0.0,13,8,9,0.05263157894736842,0.1111111111111111,26
2006-03-04,Fulham,Arsenal,0,4,A,27,32,44,-8,0.3157894736842105,37,39,-2,0.3333333333333333,27,41,83,51,0.6578947368421053,39,22,17,0.4444444444444444,0,0,0,0,0,0,0,0,0.4,0.2,-9,-39,-59,-0.3421052631578948,-0.1111111111111111,-19
2006-03-04,Liverpool,Charlton,0,0,D,27,54,58,11,0.4473684210526316,33,17,16,0.5925925925925926,27,35,46,-16,0.3157894736842105,32,37,-5,0.37037037037037035,1,0,0,0,0,0,0,0,0.6,0.2,19,12,27,0.13157894736842107,0.2222222222222222,21
2006-03-04,Middlesbrough,Birmingham,1,0,H,26,31,55,7,0.3684210526315789,35,44,-9,0.3076923076923077,26,23,45,-6,0.2894736842105263,22,37,-15,0.23076923076923078,0,0,0,0,0,0,0,0,0.6,0.4,8,10,13,0.0789473684210526,0.07692307692307693,6
2006-03-04,Newcastle,Bolton,3,1,H,27,36,44,-10,0.2631578947368421,26,29,-3,0.37037037037037035,25,42,58,5,0.42105263157894735,32,24,8,0.44,0,0,0,0,0,0,0,0,0.6,0.4,-6,-14,-15,-0.15789473684210525,-0.06962962962962965,-11
2006-03-04,West Brom,Chelsea,1,2,A,27,26,34,-25,0.15789473684210525,24,40,-16,0.25925925925925924,27,69,95,57,0.7631578947368421,54,16,38,0.8148148148148148,0,0,0,0,0,0,0,0,0.2,0.4,-43,-61,-82,-0.605263157894737,-0.5555555555555556,-54
2006-03-04,West Ham,Everton,2,2,D,26,41,-1,-1,0.0,39,34,5,0.46153846153846156,27,36,61,-1,0.4736842105263158,19,34,-15,0.4074074074074074,1,1,0,0,0,0,0,0,1.0,0.6,5,-62,0,-0.4736842105263158,0.05413105413105418,20
2006-03-05,Man City,Sunderland,2,1,H,27,37,52,8,0.34210526315789475,36,31,5,0.4074074074074074,27,10,-1,-1,0.0,18,49,-31,0.07407407407407407,0,0,0,0,0,0,0,0,0.4,0.0,27,53,9,0.34210526315789475,0.3333333333333333,36
2006-03-05,Tottenham,Blackburn,3,2,H,27,46,52,6,0.3684210526315789,37,24,13,0.4444444444444444,27,43,42,-11,0.2368421052631579,34,31,3,0.48148148148148145,0,0,0,0,0,0,0,0,0.2,0.6,3,10,17,0.13157894736842102,-0.037037037037037035,10
2006-03-06,Wigan,Man United,1,2,A,27,40,-1,-1,0.0,32,34,-2,0.4444444444444444,26,54,77,32,0.5789473684210527,52,27,25,0.6153846153846154,0,0,0,0,0,0,0,0,0.2,0.6,-14,-78,-33,-0.5789473684210527,-0.170940170940171,-27
2006-03-11,Birmingham,West Brom,1,1,D,27,23,45,-6,0.2894736842105263,22,38,-16,0.2222222222222222,28,26,34,-25,0.15789473684210525,25,42,-17,0.25,0,0,0,0,0,0,1,0,0.2,0.2,-3,11,19,0.13157894736842107,-0.02777777777777779,1
2006-03-11,Blackburn,Aston Villa,2,0,H,28,43,42,-11,0.2368421052631579,36,34,2,0.4642857142857143,28,34,47,-7,0.3157894736842105,33,35,-2,0.2857142857142857,0,0,0,0,0,0,0,0,0.4,0.4,9,-5,-4,-0.0789473684210526,0.1785714285714286,4
2006-03-11,Bolton,West Ham,4,1,H,26,42,58,5,0.42105263157894735,33,27,6,0.4230769230769231,27,42,-1,-1,0.0,41,36,5,0.4444444444444444,0,0,0,0,0,0,0,0,0.2,0.8,0,59,6,0.42105263157894735,-0.021367521367521347,1
2006-03-11,Chelsea,Tottenham,2,1,H,28,72,95,57,0.7631578947368421,56,17,39,0.8214285714285714,28,49,52,6,0.3684210526315789,40,26,14,0.4642857142857143,0,0,0,0,0,0,0,0,0.6,0.4,23,43,51,0.3947368421052632,0.3571428571428571,25
2006-03-11,Everton,Fulham,3,1,H,28,37,61,-1,0.4736842105263158,21,36,-15,0.39285714285714285,28,32,44,-8,0.3157894736842105,37,43,-6,0.32142857142857145,0,0,0,0,0,0,0,0,0.4,0.4,5,17,7,0.1578947368421053,0.0714285714285714,-9
2006-03-11,Portsmouth,Man City,2,1,H,28,18,39,-16,0.2631578947368421,18,48,-30,0.14285714285714285,28,40,52,8,0.34210526315789475,38,32,6,0.42857142857142855,0,0,1,0,0,0,0,0,0.0,0.6,-22,-13,-24,-0.07894736842105265,-0.2857142857142857,-36
2006-03-11,Sunderland,Wigan,0,1,A,28,10,-1,-1,0.0,19,51,-32,0.07142857142857142,28,40,-1,-1,0.0,33,36,-3,0.42857142857142855,0,0,1,0,0,0,0,0,0.0,0.0,-30,0,0,0.0,-0.3571428571428571,-29
2006-03-12,Arsenal,Liverpool,2,1,H,28,44,83,51,0.6578947368421053,43,22,21,0.4642857142857143,28,55,58,11,0.4473684210526316,33,17,16,0.5714285714285714,0,0,0,0,0,0,0,0,0.4,0.6,-11,25,40,0.21052631578947373,-0.1071428571428571,5
2006-03-12,Charlton,Middlesbrough,2,1,H,28,36,46,-16,0.3157894736842105,32,37,-5,0.35714285714285715,27,34,55,7,0.3684210526315789,36,44,-8,0.3333333333333333,0,0,0,0,1,0,0,0,0.2,0.8,2,-9,-23,-0.05263157894736842,0.023809523809523836,3
2006-03-12,Man United,Newcastle,2,0,H,27,57,77,32,0.5789473684210527,54,28,26,0.6296296296296297,28,39,44,-10,0.2631578947368421,29,30,-1,0.39285714285714285,1,0,0,0,0,0,0,0,0.8,0.8,18,33,42,0.31578947368421056,0.2367724867724868,27
2006-03-15,Liverpool,Fulham,5,1,H,29,55,58,11,0.4473684210526316,34,19,15,0.5517241379310345,29,32,44,-8,0.3157894736842105,38,46,-8,0.3103448275862069,0,0,0,0,0,0,1,0,0.6,0.2,23,14,19,0.13157894736842107,0.24137931034482757,23
2006-03-18,Arsenal,Charlton,3,0,H,29,47,83,51,0.6578947368421053,45,23,22,0.4827586206896552,29,39,46,-16,0.3157894736842105,34,38,-4,0.3793103448275862,0,0,0,0,0,0,0,0,0.4,0.2,8,37,67,0.3421052631578948,0.103448275862069,26
2006-03-18,Birmingham,Tottenham,0,2,A,28,24,45,-6,0.2894736842105263,23,39,-16,0.21428571428571427,29,49,52,6,0.3684210526315789,41,28,13,0.4482758620689655,0,0,0,0,0,0,0,0,0.2,0.4,-25,-7,-12,-0.0789473684210526,-0.23399014778325125,-29
2006-03-18,Blackburn,Middlesbrough,3,2,H,29,46,42,-11,0.2368421052631579,38,34,4,0.4827586206896552,28,34,55,7,0.3684210526315789,37,46,-9,0.32142857142857145,0,0,0,0,0,0,0,0,0.6,0.6,12,-13,-18,-0.13157894736842102,0.16133004926108374,13
2006-03-18,Bolton,Sunderland,2,0,H,27,45,58,5,0.42105263157894735,37,28,9,0.4444444444444444,29,10,-1,-1,0.0,19,52,-33,0.06896551724137931,0,0,0,0,0,0,1,0,0.4,0.0,35,59,6,0.42105263157894735,0.3754789272030651,42
2006-03-18,Everton,Aston Villa,4,1,H,29,40,61,-1,0.4736842105263158,24,37,-13,0.41379310344827586,29,34,47,-7,0.3157894736842105,33,37,-4,0.27586206896551724,0,0,0,0,0,0,0,0,0.6,0.4,6,14,6,0.1578947368421053,0.13793103448275862,-9
2006-03-18,Man City,Wigan,0,1,A,29,40,52,8,0.34210526315789475,39,34,5,0.41379310344827586,29,43,-1,-1,0.0,34,36,-2,0.4482758620689655,0,0,0,0,0,0,0,0,0.4,0.2,-3,53,9,0.34210526315789475,-0.03448275862068967,7
2006-03-18,West Brom,Man United,1,2,A,29,27,34,-25,0.15789473684210525,26,43,-17,0.2413793103448276,28,60,77,32,0.5789473684210527,56,28,28,0.6428571428571429,0,0,0,0,1,0,0,0,0.2,0.8,-33,-43,-57,-0.4210526315789474,-0.4014778325123153,-45
2006-03-18,West Ham,Portsmouth,2,4,A,28,42,-1,-1,0.0,42,40,2,0.42857142857142855,29,21,39,-16,0.2631578947368421,20,49,-29,0.1724137931034483,0,0,0,0,0,0,0,0,0.6,0.2,21,-40,15,-0.2631578947368421,0.25615763546798026,31
2006-03-19,Fulham,Chelsea,1,0,H,30,32,44,-8,0.3157894736842105,39,51,-12,0.3,29,75,95,57,0.7631578947368421,58,18,40,0.8275862068965517,0,0,1,0,1,0,0,0,0.2,0.8,-43,-51,-65,-0.44736842105263164,-0.5275862068965518,-52
2006-03-19,Newcastle,Liverpool,1,3,A,29,39,44,-10,0.2631578947368421,29,32,-3,0.3793103448275862,30,58,58,11,0.4473684210526316,39,20,19,0.5666666666666667,0,0,0,0,0,0,0,0,0.6,0.6,-19,-14,-21,-0.1842105263157895,-0.18735632183908046,-22
2006-03-25,Aston Villa,Fulham,0,0,D,30,34,47,-7,0.3157894736842105,34,41,-7,0.26666666666666666,31,35,44,-8,0.3157894736842105,40,51,-11,0.3225806451612903,0,0,0,0,0,0,0,0,0.2,0.2,-1,3,1,0.0,-0.05591397849462365,4
2006-03-25,Chelsea,Man City,2,0,H,30,75,95,57,0.7631578947368421,58,19,39,0.8,30,40,52,8,0.34210526315789475,39,35,4,0.4,0,0,0,0,0,0,0,0,0.6,0.4,35,43,49,0.4210526315789474,0.4,35
2006-03-25,Liverpool,Everton,3,1,H,31,61,58,11,0.4473684210526316,42,21,21,0.5806451612903226,30,43,61,-1,0.4736842105263158,28,38,-10,0.43333333333333335,0,0,0,0,0,0,0,0,0.6,0.6,18,-3,12,-0.026315789473684237,0.14731182795698927,31
2006-03-25,Sunderland,Blackburn,0,1,A,30,10,-1,-1,0.0,19,54,-35,0.06666666666666667,30,49,42,-11,0.2368421052631579,41,36,5,0.5,0,0,1,1,0,0,0,0,0.0,0.8,-39,-43,10,-0.2368421052631579,-0.43333333333333335,-40
2006-03-25,Wigan,West Ham,1,2,A,30,46,-1,-1,0.0,35,36,-1,0.4666666666666667,29,42,-1,-1,0.0,44,44,0,0.41379310344827586,0,0,0,0,0,0,0,0,0.4,0.4,4,0,0,0.0,0.05287356321839082,-1
2006-03-26,Charlton,Newcastle,3,1,H,30,39,46,-16,0.3157894736842105,34,41,-7,0.36666666666666664,30,39,44,-10,0.2631578947368421,30,35,-5,0.36666666666666664,0,0,0,0,0,0,0,0,0.2,0.4,0,2,-6,0.05263157894736842,0.0,-2
2006-03-26,Man United,Birmingham,3,0,H,29,63,77,32,0.5789473684210527,58,29,29,0.6551724137931034,29,24,45,-6,0.2894736842105263,23,41,-18,0.20689655172413793,1,1,0,0,0,0,0,0,1.0,0.2,39,32,38,0.2894736842105263,0.4482758620689655,47
2006-03-26,Middlesbrough,Bolton,4,3,H,29,34,55,7,0.3684210526315789,39,49,-10,0.3103448275862069,28,48,58,5,0.42105263157894735,39,28,11,0.4642857142857143,0,0,0,0,0,0,0,0,0.6,0.6,-14,-3,2,-0.05263157894736842,-0.1539408866995074,-21
2006-03-27,Tottenham,West Brom,2,1,H,30,52,52,6,0.3684210526315789,43,28,15,0.4666666666666667,30,27,34,-25,0.15789473684210525,27,45,-18,0.23333333333333334,0,0,0,0,0,0,0,0,0.4,0.0,25,18,31,0.21052631578947367,0.23333333333333334,33
2006-03-29,Man United,West Ham,1,0,H,30,66,77,32,0.5789473684210527,61,29,32,0.6666666666666666,30,45,-1,-1,0.0,46,45,1,0.43333333333333335,1,1,0,0,0,0,0,0,1.0,0.4,21,78,33,0.5789473684210527,0.23333333333333328,31
2006-04-01,Arsenal,Aston Villa,5,0,H,30,50,83,51,0.6578947368421053,48,23,25,0.5,31,35,47,-7,0.3157894736842105,34,41,-7,0.25806451612903225,1,0,0,0,0,0,0,0,0.6,0.2,15,36,58,0.3421052631578948,0.24193548387096775,32
2006-04-01,Birmingham,Chelsea,0,0,D,30,24,45,-6,0.2894736842105263,23,44,-21,0.2,31,78,95,57,0.7631578947368421,60,19,41,0.8064516129032258,0,0,0,0,0,0,0,0,0.2,0.8,-54,-50,-63,-0.4736842105263158,-0.6064516129032258,-62
2006-04-01,Bolton,Man United,1,2,A,29,48,58,5,0.42105263157894735,42,32,10,0.4482758620689655,31,69,77,32,0.5789473684210527,62,29,33,0.6774193548387096,0,0,0,0,1,1,0,0,0.6,1.0,-21,-19,-27,-0.1578947368421053,-0.2291434927697441,-23
2006-04-01,Everton,Sunderland,2,2,D,31,43,61,-1,0.4736842105263158,29,41,-12,0.41935483870967744,31,10,-1,-1,0.0,19,55,-36,0.06451612903225806,0,0,0,0,0,0,1,1,0.4,0.0,33,62,0,0.4736842105263158,0.3548387096774194,24
2006-04-01,Fulham,Portsmouth,1,3,A,32,36,44,-8,0.3157894736842105,40,51,-11,0.3125,30,24,39,-16,0.2631578947368421,24,51,-27,0.2,0,0,0,0,0,0,0,0,0.2,0.4,12,5,8,0.05263157894736842,0.11249999999999999,16
2006-04-01,Newcastle,Tottenham,3,1,H,31,39,44,-10,0.2631578947368421,31,38,-7,0.3548387096774194,31,55,52,6,0.3684210526315789,45,29,16,0.4838709677419355,0,0,1,0,0,0,0,0,0.4,0.6,-16,-8,-16,-0.10526315789473684,-0.12903225806451613,-23
2006-04-01,West Brom,Liverpool,0,2,A,31,27,34,-25,0.15789473684210525,28,47,-19,0.22580645161290322,32,64,58,11,0.4473684210526316,45,22,23,0.59375,0,0,0,0,1,0,0,0,0.0,0.6,-37,-24,-36,-0.2894736842105263,-0.36794354838709675,-42
2006-04-02,Man City,Middlesbrough,0,1,A,31,40,52,8,0.34210526315789475,39,37,2,0.3870967741935484,30,37,55,7,0.3684210526315789,43,52,-9,0.3333333333333333,0,0,1,0,0,0,0,0,0.2,0.6,3,-3,1,-0.02631578947368418,0.05376344086021506,11
2006-04-02,West Ham,Charlton,0,0,D,31,45,-1,-1,0.0,46,46,0,0.41935483870967744,31,42,46,-16,0.3157894736842105,37,42,-5,0.3870967741935484,0,0,0,0,0,0,0,0,0.2,0.4,3,-47,15,-0.3157894736842105,0.03225806451612906,5
2006-04-03,Blackburn,Wigan,1,1,D,31,52,42,-11,0.2368421052631579,42,36,6,0.5161290322580645,31,46,-1,-1,0.0,36,38,-2,0.45161290322580644,1,0,0,0,0,0,0,0,0.8,0.4,6,43,-10,0.2368421052631579,0.06451612903225806,8
2006-04-04,Birmingham,Bolton,1,0,H,31,25,45,-6,0.2894736842105263,23,44,-21,0.1935483870967742,30,48,58,5,0.42105263157894735,43,34,9,0.43333333333333335,0,0,0,0,0,0,0,0,0.0,0.4,-23,-13,-11,-0.13157894736842102,-0.23978494623655916,-30
2006-04-08,Charlton,Everton,0,0,D,32,43,46,-16,0.3157894736842105,37,42,-5,0.375,32,44,61,-1,0.4736842105263158,31,43,-12,0.40625,0,0,0,0,0,0,0,0,0.4,0.4,-1,-15,-15,-0.1578947368421053,-0.03125,7
2006-04-08,Portsmouth,Blackburn,2,2,D,31,27,39,-16,0.2631578947368421,27,52,-25,0.22580645161290322,32,53,42,-11,0.2368421052631579,43,37,6,0.5,1,0,0,0,0,0,0,0,0.6,0.6,-26,-3,-5,0.02631578947368418,-0.27419354838709675,-31
2006-04-08,Tottenham,Man City,2,1,H,32,55,52,6,0.3684210526315789,46,32,14,0.46875,32,40,52,8,0.34210526315789475,39,38,1,0.375,0,0,0,0,0,0,1,0,0.6,0.2,15,0,-2,0.02631578947368418,0.09375,13
2006-04-08,Wigan,Birmingham,1,1,D,32,47,-1,-1,0.0,37,39,-2,0.4375,32,28,45,-6,0.2894736842105263,24,44,-20,0.21875,0,0,0,0,0,0,0,0,0.4,0.2,19,-46,5,-0.2894736842105263,0.21875,18
2006-04-09,Aston Villa,West Brom,0,0,D,32,35,47,-7,0.3157894736842105,34,46,-12,0.25,32,27,34,-25,0.15789473684210525,28,49,-21,0.21875,0,0,0,0,0,0,1,0,0.2,0.0,8,13,18,0.15789473684210525,0.03125,9
2006-04-09,Chelsea,West Ham,4,1,H,32,79,95,57,0.7631578947368421,60,19,41,0.78125,32,46,-1,-1,0.0,46,46,0,0.40625,0,0,0,0,0,0,0,0,0.6,0.2,33,96,58,0.7631578947368421,0.375,41
2006-04-09,Liverpool,Bolton,1,0,H,33,67,58,11,0.4473684210526316,47,22,25,0.6060606060606061,31,48,58,5,0.42105263157894735,43,35,8,0.41935483870967744,1,0,0,0,0,0,1,0,0.8,0.4,19,0,6,0.026315789473684237,0.18670576735092864,17
2006-04-09,Man United,Arsenal,2,0,H,32,72,77,32,0.5789473684210527,64,30,34,0.6875,31,53,83,51,0.6578947368421053,53,23,30,0.5161290322580645,1,1,0,0,1,0,0,0,1.0,0.8,19,-6,-19,-0.07894736842105265,0.1713709677419355,4
2006-04-09,Middlesbrough,Newcastle,1,2,A,31,40,55,7,0.3684210526315789,44,52,-8,0.3548387096774194,32,42,44,-10,0.2631578947368421,34,39,-5,0.375,0,0,0,0,0,0,0,0,0.6,0.4,-2,11,17,0.10526315789473684,-0.020161290322580627,-3
2006-04-12,Portsmouth,Arsenal,1,1,D,32,28,39,-16,0.2631578947368421,29,54,-25,0.21875,32,53,83,51,0.6578947368421053,53,25,28,0.5,0,0,0,0,0,0,0,0,0.6,0.8,-25,-44,-67,-0.3947368421052632,-0.28125,-53
2006-04-14,Man United,Sunderland,0,0,D,33,75,77,32,0.5789473684210527,66,30,36,0.696969696969697,32,11,-1,-1,0.0,21,57,-36,0.0625,1,1,0,0,0,0,0,0,1.0,0.0,64,78,33,0.5789473684210527,0.634469696969697,72
2006-04-15,Arsenal,West Brom,3,1,H,33,54,83,51,0.6578947368421053,54,26,28,0.48484848484848486,33,28,34,-25,0.15789473684210525,28,49,-21,0.21212121212121213,0,0,0,0,0,0,0,0,0.6,0.0,26,49,76,0.5,0.2727272727272727,49
2006-04-15,Bolton,Chelsea,0,2,A,32,48,58,5,0.42105263157894735,43,36,7,0.40625,33,82,95,57,0.7631578947368421,64,20,44,0.7878787878787878,0,0,1,0,0,0,0,0,0.2,0.6,-34,-37,-52,-0.3421052631578948,-0.38162878787878785,-37
2006-04-15,Everton,Tottenham,0,1,A,33,45,61,-1,0.4736842105263158,31,43,-12,0.3939393939393939,33,58,52,6,0.3684210526315789,48,33,15,0.48484848484848486,0,0,0,0,0,0,0,0,0.4,0.6,-13,9,-7,0.10526315789473689,-0.09090909090909094,-27
2006-04-15,Fulham,Charlton,2,1,H,33,36,44,-8,0.3157894736842105,41,54,-13,0.30303030303030304,33,44,46,-16,0.3157894736842105,37,42,-5,0.36363636363636365,0,0,0,0,0,0,0,0,0.2,0.4,-8,-2,8,0.0,-0.06060606060606061,-8
2006-04-15,Newcastle,Wigan,3,1,H,33,45,44,-10,0.2631578947368421,36,40,-4,0.3939393939393939,33,48,-1,-1,0.0,38,40,-2,0.42424242424242425,0,0,0,0,0,0,0,0,0.4,0.4,-3,45,-9,0.2631578947368421,-0.03030303030303033,-2
2006-04-15,Portsmouth,Middlesbrough,1,0,H,33,29,39,-16,0.2631578947368421,30,55,-25,0.21212121212121213,32,40,55,7,0.3684210526315789,45,54,-9,0.34375,0,0,0,0,0,0,0,0,0.6,0.4,-11,-16,-23,-0.10526315789473684,-0.13162878787878787,-16
2006-04-15,West Ham,Man City,1,0,H,33,46,-1,-1,0.0,47,50,-3,0.3939393939393939,33,40,52,8,0.34210526315789475,40,40,0,0.36363636363636365,0,0,0,0,0,0,1,1,0.2,0.0,6,-53,-9,-0.34210526315789475,0.030303030303030276,-3
2006-04-16,Aston Villa,Birmingham,3,1,H,33,36,47,-7,0.3157894736842105,34,46,-12,0.24242424242424243,33,29,45,-6,0.2894736842105263,25,45,-20,0.21212121212121213,0,0,0,0,0,0,0,0,0.0,0.2,7,2,-1,0.02631578947368418,0.030303030303030304,8
2006-04-16,Blackburn,Liverpool,0,1,A,33,54,42,-11,0.2368421052631579,45,39,6,0.48484848484848486,34,70,58,11,0.4473684210526316,48,22,26,0.6176470588235294,0,0,0,0,1,1,0,0,0.6,1.0,-16,-16,-22,-0.21052631578947367,-0.13279857397504458,-20
2006-04-17,Charlton,Portsmouth,2,1,H,34,44,46,-16,0.3157894736842105,38,44,-6,0.35294117647058826,34,32,39,-16,0.2631578947368421,31,55,-24,0.23529411764705882,0,0,0,0,0,0,0,0,0.2,0.6,12,7,0,0.05263157894736842,0.11764705882352944,18
2006-04-17,Chelsea,Everton,3,0,H,34,85,95,57,0.7631578947368421,66,20,46,0.7941176470588235,34,45,61,-1,0.4736842105263158,31,44,-13,0.38235294117647056,0,0,0,0,0,0,0,0,0.6,0.2,40,34,58,0.2894736842105263,0.4117647058823529,59
2006-04-17,Middlesbrough,West Ham,2,0,H,33,40,55,7,0.3684210526315789,45,55,-10,0.3333333333333333,34,49,-1,-1,0.0,48,50,-2,0.4117647058823529,0,0,0,0,0,0,0,0,0.4,0.4,-9,56,8,0.3684210526315789,-0.0784313725490196,-8
2006-04-17,Sunderland,Newcastle,1,4,A,33,12,-1,-1,0.0,21,57,-36,0.06060606060606061,34,48,44,-10,0.2631578947368421,39,41,-2,0.4117647058823529,0,0,0,0,1,0,0,0,0.0,0.6,-36,-45,9,-0.2631578947368421,-0.3511586452762923,-34
2006-04-17,Tottenham,Man United,1,2,A,34,61,52,6,0.3684210526315789,49,33,16,0.5,34,76,77,32,0.5789473684210527,66,30,36,0.6764705882352942,0,0,0,0,0,0,0,0,0.8,0.8,-15,-25,-26,-0.21052631578947373,-0.17647058823529416,-20
2006-04-17,West Brom,Bolton,0,0,D,34,28,34,-25,0.15789473684210525,29,52,-23,0.20588235294117646,33,48,58,5,0.42105263157894735,43,38,5,0.3939393939393939,0,0,0,0,0,0,1,1,0.0,0.0,-20,-24,-30,-0.2631578947368421,-0.18805704099821746,-28
2006-04-18,Wigan,Aston Villa,3,2,H,34,48,-1,-1,0.0,39,43,-4,0.4117647058823529,34,39,47,-7,0.3157894736842105,37,47,-10,0.2647058823529412,0,0,0,0,0,0,0,0,0.2,0.2,9,-48,6,-0.3157894736842105,0.14705882352941174,6
2006-04-19,Birmingham,Blackburn,2,1,H,34,29,45,-6,0.2894736842105263,26,48,-22,0.20588235294117646,34,54,42,-11,0.2368421052631579,45,40,5,0.47058823529411764,0,0,0,0,0,0,0,0,0.2,0.4,-25,3,5,0.05263157894736842,-0.2647058823529412,-27
2006-04-22,Arsenal,Tottenham,1,1,D,34,57,83,51,0.6578947368421053,57,27,30,0.5,35,61,52,6,0.3684210526315789,50,35,15,0.4857142857142857,0,0,0,0,0,0,0,0,0.6,0.6,-4,31,45,0.2894736842105264,0.01428571428571429,15
2006-04-22,Bolton,Charlton,4,1,H,34,49,58,5,0.42105263157894735,43,38,5,0.38235294117647056,35,47,46,-16,0.3157894736842105,40,45,-5,0.37142857142857144,0,0,0,0,0,0,0,0,0.0,0.4,2,12,21,0.10526315789473684,0.01092436974789912,10
2006-04-22,Everton,Birmingham,0,0,D,35,45,61,-1,0.4736842105263158,31,47,-16,0.37142857142857144,35,32,45,-6,0.2894736842105263,28,49,-21,0.22857142857142856,0,0,0,0,0,0,0,0,0.0,0.4,13,16,5,0.1842105263157895,0.14285714285714288,5
2006-04-22,Newcastle,West Brom,3,0,H,35,51,44,-10,0.2631578947368421,43,42,1,0.42857142857142855,35,29,34,-25,0.15789473684210525,29,52,-23,0.2,1,0,0,0,0,0,0,0,0.8,0.0,22,10,15,0.10526315789473684,0.22857142857142854,24
2006-04-22,Portsmouth,Sunderland,2,1,H,35,32,39,-16,0.2631578947368421,32,57,-25,0.22857142857142856,34,12,-1,-1,0.0,22,61,-39,0.058823529411764705,0,0,0,0,0,0,0,0,0.4,0.0,20,40,-15,0.2631578947368421,0.16974789915966387,14
2006-04-24,Fulham,Wigan,1,0,H,34,39,44,-8,0.3157894736842105,43,55,-12,0.3235294117647059,35,51,-1,-1,0.0,42,45,-3,0.42857142857142855,0,0,0,0,0,0,0,0,0.4,0.2,-12,45,-7,0.3157894736842105,-0.10504201680672265,-9
2006-04-25,Aston Villa,Man City,0,1,A,35,39,47,-7,0.3157894736842105,39,50,-11,0.2571428571428571,34,40,52,8,0.34210526315789475,40,41,-1,0.35294117647058826,0,0,0,0,0,0,1,1,0.2,0.0,-1,-5,-15,-0.026315789473684237,-0.09579831932773114,-10
2006-04-26,West Ham,Liverpool,1,2,A,35,49,-1,-1,0.0,48,52,-4,0.4,35,73,58,11,0.4473684210526316,49,22,27,0.6285714285714286,0,0,0,0,1,1,0,0,0.2,1.0,-24,-59,-12,-0.4473684210526316,-0.22857142857142854,-31
2006-04-29,Birmingham,Newcastle,0,0,D,36,33,45,-6,0.2894736842105263,28,49,-21,0.2222222222222222,36,54,44,-10,0.2631578947368421,46,42,4,0.4444444444444444,0,0,0,0,1,1,0,0,0.4,1.0,-21,1,4,0.026315789473684237,-0.2222222222222222,-25
2006-04-29,Charlton,Blackburn,0,2,A,36,47,46,-16,0.3157894736842105,41,49,-8,0.3611111111111111,35,54,42,-11,0.2368421052631579,46,42,4,0.45714285714285713,0,0,0,0,0,0,0,0,0.2,0.2,-7,4,-5,0.0789473684210526,-0.09603174603174602,-12
2006-04-29,Chelsea,Man United,3,0,H,35,88,95,57,0.7631578947368421,69,20,49,0.8,35,79,77,32,0.5789473684210527,68,31,37,0.6857142857142857,1,0,0,0,0,0,0,0,0.8,0.8,9,18,25,0.1842105263157895,0.11428571428571432,12
2006-04-29,Liverpool,Aston Villa,3,1,H,36,76,58,11,0.4473684210526316,51,23,28,0.6388888888888888,36,39,47,-7,0.3157894736842105,39,51,-12,0.25,1,1,0,0,0,0,0,0,1.0,0.2,37,11,18,0.13157894736842107,0.38888888888888884,40
2006-04-29,Man City,Fulham,1,2,A,35,43,52,8,0.34210526315789475,41,41,0,0.37142857142857144,35,42,44,-8,0.3157894736842105,44,55,-11,0.34285714285714286,0,0,0,0,0,0,0,0,0.2,0.6,1,8,16,0.026315789473684237,0.02857142857142858,11
2006-04-29,Middlesbrough,Everton,0,1,A,34,43,55,7,0.3684210526315789,47,55,-8,0.35294117647058826,36,46,61,-1,0.4736842105263158,31,47,-16,0.3611111111111111,0,0,0,0,0,0,0,0,0.6,0.0,-3,-6,8,-0.10526315789473689,-0.008169934640522847,8
2006-04-29,Wigan,Portsmouth,1,2,A,36,51,-1,-1,0.0,42,46,-4,0.4166666666666667,36,35,39,-16,0.2631578947368421,34,58,-24,0.25,0,0,0,0,0,0,0,0,0.2,0.4,16,-40,15,-0.2631578947368421,0.16666666666666669,20
2006-04-30,Tottenham,Bolton,1,0,H,36,62,52,6,0.3684210526315789,51,36,15,0.4722222222222222,35,52,58,5,0.42105263157894735,47,39,8,0.4,0,0,0,0,0,0,0,0,0.4,0.2,10,-6,1,-0.05263157894736842,0.07222222222222219,7
2006-05-01,Man United,Middlesbrough,0,0,D,36,79,77,32,0.5789473684210527,68,34,34,0.6666666666666666,35,43,55,7,0.3684210526315789,47,56,-9,0.34285714285714286,0,0,0,0,0,0,0,0,0.6,0.4,36,22,25,0.21052631578947373,0.32380952380952377,43
2006-05-01,Sunderland,Arsenal,0,3,A,35,12,-1,-1,0.0,23,63,-40,0.05714285714285714,35,58,83,51,0.6578947368421053,58,28,30,0.4857142857142857,0,0,0,0,0,0,0,0,0.0,0.4,-46,-84,-52,-0.6578947368421053,-0.42857142857142855,-70
2006-05-01,West Brom,West Ham,0,1,A,36,29,34,-25,0.15789473684210525,29,55,-26,0.19444444444444445,36,49,-1,-1,0.0,49,54,-5,0.3888888888888889,0,0,0,0,0,0,0,0,0.0,0.2,-20,35,-24,0.15789473684210525,-0.19444444444444445,-21
2006-05-02,Blackburn,Chelsea,1,0,H,36,57,42,-11,0.2368421052631579,48,42,6,0.4722222222222222,36,91,95,57,0.7631578947368421,72,20,52,0.8055555555555556,0,0,0,0,1,0,0,0,0.2,0.8,-34,-53,-68,-0.5263157894736843,-0.33333333333333337,-46
2006-05-03,Bolton,Middlesbrough,1,1,D,36,52,58,5,0.42105263157894735,47,40,7,0.3888888888888889,36,44,55,7,0.3684210526315789,47,56,-9,0.3333333333333333,0,0,0,0,0,0,0,0,0.2,0.2,8,3,-2,0.05263157894736842,0.05555555555555558,16
2006-05-04,Man City,Arsenal,1,3,A,36,43,52,8,0.34210526315789475,42,43,-1,0.3611111111111111,36,61,83,51,0.6578947368421053,61,28,33,0.5,0,0,0,0,0,0,0,0,0.2,0.4,-18,-31,-43,-0.31578947368421056,-0.1388888888888889,-34
2006-05-04,Sunderland,Fulham,2,1,H,36,12,-1,-1,0.0,23,66,-43,0.05555555555555555,36,45,44,-8,0.3157894736842105,46,56,-10,0.3611111111111111,0,0,1,0,1,0,0,0,0.0,0.6,-33,-45,7,-0.3157894736842105,-0.3055555555555556,-33
2006-05-07,Arsenal,Wigan,4,2,H,37,64,83,51,0.6578947368421053,64,29,35,0.5135135135135135,37,51,-1,-1,0.0,43,48,-5,0.40540540540540543,0,0,0,0,0,0,0,0,0.6,0.2,13,84,52,0.6578947368421053,0.10810810810810806,40
2006-05-07,Aston Villa,Sunderland,2,1,H,37,39,47,-7,0.3157894736842105,40,54,-14,0.24324324324324326,37,15,-1,-1,0.0,25,67,-42,0.08108108108108109,0,0,1,0,0,0,0,0,0.2,0.2,24,48,-6,0.3157894736842105,0.16216216216216217,28
2006-05-07,Blackburn,Man City,2,0,H,37,60,42,-11,0.2368421052631579,49,42,7,0.4864864864864865,37,43,52,8,0.34210526315789475,43,46,-3,0.35135135135135137,0,0,0,0,0,0,0,0,0.4,0.2,17,-10,-19,-0.10526315789473684,0.13513513513513514,10
2006-05-07,Bolton,Birmingham,1,0,H,37,53,58,5,0.42105263157894735,48,41,7,0.3783783783783784,37,34,45,-6,0.2894736842105263,28,49,-21,0.21621621621621623,0,0,0,0,0,0,0,0,0.2,0.2,19,13,11,0.13157894736842102,0.16216216216216217,28
2006-05-07,Everton,West Brom,2,2,D,37,49,61,-1,0.4736842105263158,32,47,-15,0.3783783783783784,37,29,34,-25,0.15789473684210525,29,56,-27,0.1891891891891892,0,0,0,0,0,0,0,0,0.2,0.0,20,27,24,0.31578947368421056,0.1891891891891892,12
2006-05-07,Fulham,Middlesbrough,1,0,H,37,45,44,-8,0.3157894736842105,47,58,-11,0.35135135135135137,37,45,55,7,0.3684210526315789,48,57,-9,0.32432432432432434,0,0,0,0,0,0,0,0,0.6,0.2,0,-11,-15,-0.05263157894736842,0.02702702702702703,-2
2006-05-07,Man United,Charlton,4,0,H,37,80,77,32,0.5789473684210527,68,34,34,0.6486486486486487,37,47,46,-16,0.3157894736842105,41,51,-10,0.35135135135135137,0,0,0,0,0,0,0,0,0.4,0.2,33,31,48,0.26315789473684215,0.2972972972972973,44
2006-05-07,Newcastle,Chelsea,1,0,H,37,55,44,-10,0.2631578947368421,46,42,4,0.43243243243243246,37,91,95,57,0.7631578947368421,72,21,51,0.7837837837837838,0,0,0,0,0,0,0,0,0.8,0.8,-36,-51,-67,-0.5,-0.3513513513513513,-47
2006-05-07,Portsmouth,Liverpool,1,3,A,37,38,39,-16,0.2631578947368421,36,59,-23,0.2702702702702703,37,79,58,11,0.4473684210526316,54,24,30,0.6486486486486487,0,0,0,0,1,1,0,0,0.6,1.0,-41,-19,-27,-0.1842105263157895,-0.3783783783783784,-53
2006-05-07,West Ham,Tottenham,2,1,H,37,52,-1,-1,0.0,50,54,-4,0.40540540540540543,37,65,52,6,0.3684210526315789,52,36,16,0.4864864864864865,0,0,0,0,0,0,0,0,0.4,0.6,-13,-53,-7,-0.3684210526315789,-0.08108108108108109,-20
